_id,escopo_autuacao,mes,ano,uf,amparo_legal,descricao_infracao,quantidade_autos,month_num,year_month,cumulative_tickets,previous_tickets,diff_by_period
6407641b305a576376e6f33d,CMT - Capacidade Máxima de Tração,JANEIRO,2021,MG,"Lei 9503/97 Lei 10561/02 Res. CONTRAN nº 210/06, 211/06 e 258/07 e alterações Portaria DENATRAN 63/09 e 59/07 e alterações ",Transitar com o veículo excedendo a CMT acima de 1000 kg,2,1,202101,2,0,2
6407641b305a576376e6f349,Excesso de Peso,JANEIRO,2021,MG,"Lei 9503/97 Lei 10561/02 Res. CONTRAN nº 210/06, 211/06 e 258/07 e alterações Portaria DENATRAN 63/09 e 59/07 e alterações ",Transitar com o veículo com excesso de peso - PBT/PBTC,57,1,202101,30711,30654,57
6407641b305a576376e6f350,Excesso de Peso,JANEIRO,2021,PR,"Lei 9503/97 Lei 10561/02 Res. CONTRAN nº 210/06, 211/06 e 258/07 e alterações Portaria DENATRAN 63/09 e 59/07 e alterações ",Transitar com o veículo com excesso de peso - PBT/PBTC e Por Eixo,58,1,202101,30769,30711,58
6407641b305a576376e6f357,Excesso de Peso,JANEIRO,2021,RS,"Lei 9503/97 Lei 10561/02 Res. CONTRAN nº 210/06, 211/06 e 258/07 e alterações Portaria DENATRAN 63/09 e 59/07 e alterações ",Transitar com o veículo com excesso de peso - PBT/PBTC e Por Eixo,17,1,202101,30786,30769,17
6407641b305a576376e6f358,Excesso de Peso,JANEIRO,2021,RS,"Lei 9503/97 Lei 10561/02 Res. CONTRAN nº 210/06, 211/06 e 258/07 e alterações Portaria DENATRAN 63/09 e 59/07 e alterações ",Transitar com o veículo com excesso de peso - Por Eixo,154,1,202101,30940,30786,154
6407641b305a576376e6f35a,Excesso de Peso,JANEIRO,2021,SC,"Lei 9503/97 Lei 10561/02 Res. CONTRAN nº 210/06, 211/06 e 258/07 e alterações Portaria DENATRAN 63/09 e 59/07 e alterações ",Transitar com o veículo com excesso de peso - PBT/PBTC e Por Eixo,113,1,202101,31053,30940,113
6407641b305a576376e6f35d,Excesso de Peso,JANEIRO,2021,SP,"Lei 9503/97 Lei 10561/02 Res. CONTRAN nº 210/06, 211/06 e 258/07 e alterações Portaria DENATRAN 63/09 e 59/07 e alterações ",Transitar com o veículo com excesso de peso - PBT/PBTC e Por Eixo,66,1,202101,31119,31053,66
6407641b305a576376e6f342,CMT - Capacidade Máxima de Tração,JANEIRO,2021,SC,"Lei 9503/97 Lei 10561/02 Res. CONTRAN nº 210/06, 211/06 e 258/07 e alterações Portaria DENATRAN 63/09 e 59/07 e alterações ",Transitar com o veículo excedendo a CMT acima de 1000 kg,3,1,202101,102863,102860,3
6407641b305a576376e6f359,Excesso de Peso,JANEIRO,2021,SC,"Lei 9503/97 Lei 10561/02 Res. CONTRAN nº 210/06, 211/06 e 258/07 e alterações Portaria DENATRAN 63/09 e 59/07 e alterações ",Transitar com o veículo com excesso de peso - PBT/PBTC,51,1,202101,162919,162868,51
6407641b305a576376e6f353,Excesso de Peso,JANEIRO,2021,RJ,"Lei 9503/97 Lei 10561/02 Res. CONTRAN nº 210/06, 211/06 e 258/07 e alterações Portaria DENATRAN 63/09 e 59/07 e alterações ",Transitar com o veículo com excesso de peso - PBT/PBTC,307,1,202101,162868,162561,307
6407641b305a576376e6f346,Excesso de Peso,JANEIRO,2021,ES,"Lei 9503/97 Lei 10561/02 Res. CONTRAN nº 210/06, 211/06 e 258/07 e alterações Portaria DENATRAN 63/09 e 59/07 e alterações ",Transitar com o veículo com excesso de peso - PBT/PBTC,69,1,202101,30654,30585,69
6407641b305a576376e6f352,Excesso de Peso,JANEIRO,2021,RJ,,Transitar com o veículo com excesso de peso - Por Eixo,1,1,202101,162561,162560,1
6407641b305a576376e6f348,Excesso de Peso,JANEIRO,2021,ES,"Lei 9503/97 Lei 10561/02 Res. CONTRAN nº 210/06, 211/06 e 258/07 e alterações Portaria DENATRAN 63/09 e 59/07 e alterações ",Transitar com o veículo com excesso de peso - Por Eixo,939,1,202101,162477,161538,939
6407641b305a576376e6f347,Excesso de Peso,JANEIRO,2021,ES,"Lei 9503/97 Lei 10561/02 Res. CONTRAN nº 210/06, 211/06 e 258/07 e alterações Portaria DENATRAN 63/09 e 59/07 e alterações ",Transitar com o veículo com excesso de peso - PBT/PBTC e Por Eixo,95,1,202101,161538,161443,95
6407641b305a576376e6f33c,CMT - Capacidade Máxima de Tração,JANEIRO,2021,ES,"Lei 9503/97 Lei 10561/02 Res. CONTRAN nº 210/06, 211/06 e 258/07 e alterações Portaria DENATRAN 63/09 e 59/07 e alterações ",Transitar com o veículo excedendo a CMT em até 600 kg,1,1,202101,161443,161442,1
6407641b305a576376e6f35e,Excesso de Peso,JANEIRO,2021,SP,"Lei 9503/97 Lei 10561/02 Res. CONTRAN nº 210/06, 211/06 e 258/07 e alterações Portaria DENATRAN 63/09 e 59/07 e alterações ",Transitar com o veículo com excesso de peso - Por Eixo,443,1,202101,104076,103633,443
6407641b305a576376e6f35c,Excesso de Peso,JANEIRO,2021,SP,"Lei 9503/97 Lei 10561/02 Res. CONTRAN nº 210/06, 211/06 e 258/07 e alterações Portaria DENATRAN 63/09 e 59/07 e alterações ",Transitar com o veículo com excesso de peso - PBT/PBTC,46,1,202101,103633,103587,46
6407641b305a576376e6f35b,Excesso de Peso,JANEIRO,2021,SC,"Lei 9503/97 Lei 10561/02 Res. CONTRAN nº 210/06, 211/06 e 258/07 e alterações Portaria DENATRAN 63/09 e 59/07 e alterações ",Transitar com o veículo com excesso de peso - Por Eixo,478,1,202101,103587,103109,478
6407641b305a576376e6f34f,Excesso de Peso,JANEIRO,2021,PR,"Lei 9503/97 Lei 10561/02 Res. CONTRAN nº 210/06, 211/06 e 258/07 e alterações Portaria DENATRAN 63/09 e 59/07 e alterações ",Transitar com o veículo com excesso de peso - PBT/PBTC,33,1,202101,103109,103076,33
6407641b305a576376e6f34a,Excesso de Peso,JANEIRO,2021,MG,"Lei 9503/97 Lei 10561/02 Res. CONTRAN nº 210/06, 211/06 e 258/07 e alterações Portaria DENATRAN 63/09 e 59/07 e alterações ",Transitar com o veículo com excesso de peso - PBT/PBTC e Por Eixo,172,1,202101,103076,102904,172
6407641b305a576376e6f343,Evasão de Balança,JANEIRO,2021,ES,"Lei 9503 DE 23/09/1997 Transpor, sem autorização, bloqueio viário com ou sem sinalização ou dispositivos auxiliares, deixar de adentrar às áreas destinadas à pesagem de veículos ou evadir-se para não efetuar o pagamento do pedágio.",Art. 209 Deixar de adentrar as áreas destinadas à pesagem de veículos,41,1,202101,102904,102863,41
6407641b305a576376e6f34e,Excesso de Peso,JANEIRO,2021,MS,"Lei 9503/97 Lei 10561/02 Res. CONTRAN nº 210/06, 211/06 e 258/07 e alterações Portaria DENATRAN 63/09 e 59/07 e alterações ",Transitar com o veículo com excesso de peso - Por Eixo,83,1,202101,162560,162477,83
6407641b305a576376e6f345,Evasão de Balança,JANEIRO,2021,SP,"Lei 9503 DE 23/09/1997 Transpor, sem autorização, bloqueio viário com ou sem sinalização ou dispositivos auxiliares, deixar de adentrar às áreas destinadas à pesagem de veículos ou evadir-se para não efetuar o pagamento do pedágio.",Art. 209 Deixar de adentrar as áreas destinadas à pesagem de veículos,422,1,202101,30585,30163,422
6407641b305a576376e6f33f,CMT - Capacidade Máxima de Tração,JANEIRO,2021,RJ,"Lei 9503/97 Lei 10561/02 Res. CONTRAN nº 210/06, 211/06 e 258/07 e alterações Portaria DENATRAN 63/09 e 59/07 e alterações ",Transitar com o veículo excedendo a CMT entre 601 e 1000 kg,2,1,202101,102860,102858,2
6407641b305a576376e6f351,Excesso de Peso,JANEIRO,2021,PR,"Lei 9503/97 Lei 10561/02 Res. CONTRAN nº 210/06, 211/06 e 258/07 e alterações Portaria DENATRAN 63/09 e 59/07 e alterações ",Transitar com o veículo com excesso de peso - Por Eixo,364,1,202101,7562,7198,364
6407641b305a576376e6f34c,Excesso de Peso,JANEIRO,2021,MS,"Lei 9503/97 Lei 10561/02 Res. CONTRAN nº 210/06, 211/06 e 258/07 e alterações Portaria DENATRAN 63/09 e 59/07 e alterações ",Transitar com o veículo com excesso de peso - PBT/PBTC,7,1,202101,7157,7150,7
6407641b305a576376e6f34b,Excesso de Peso,JANEIRO,2021,MG,"Lei 9503/97 Lei 10561/02 Res. CONTRAN nº 210/06, 211/06 e 258/07 e alterações Portaria DENATRAN 63/09 e 59/07 e alterações ",Transitar com o veículo com excesso de peso - Por Eixo,809,1,202101,7150,6341,809
6407641b305a576376e6f344,Evasão de Balança,JANEIRO,2021,RJ,"Lei 9503 DE 23/09/1997 Transpor, sem autorização, bloqueio viário com ou sem sinalização ou dispositivos auxiliares, deixar de adentrar às áreas destinadas à pesagem de veículos ou evadir-se para não efetuar o pagamento do pedágio.",Art. 209 Deixar de adentrar as áreas destinadas à pesagem de veículos,6330,1,202101,6341,11,6330
6407641b305a576376e6f341,CMT - Capacidade Máxima de Tração,JANEIRO,2021,RJ,"Lei 9503/97 Lei 10561/02 Res. CONTRAN nº 210/06, 211/06 e 258/07 e alterações Portaria DENATRAN 63/09 e 59/07 e alterações ",Transitar com o veículo excedendo a CMT em até 600 kg,5,1,202101,11,6,5
6407641b305a576376e6f33e,CMT - Capacidade Máxima de Tração,JANEIRO,2021,MS,"Lei 9503/97 Lei 10561/02 Res. CONTRAN nº 210/06, 211/06 e 258/07 e alterações Portaria DENATRAN 63/09 e 59/07 e alterações ",Transitar com o veículo excedendo a CMT acima de 1000 kg,1,1,202101,6,5,1
6407641b305a576376e6f340,CMT - Capacidade Máxima de Tração,JANEIRO,2021,RJ,"Lei 9503/97 Lei 10561/02 Res. CONTRAN nº 210/06, 211/06 e 258/07 e alterações Portaria DENATRAN 63/09 e 59/07 e alterações ",Transitar com o veículo excedendo a CMT acima de 1000 kg,3,1,202101,5,2,3
6407641b305a576376e6f356,Excesso de Peso,JANEIRO,2021,RS,"Lei 9503/97 Lei 10561/02 Res. CONTRAN nº 210/06, 211/06 e 258/07 e alterações Portaria DENATRAN 63/09 e 59/07 e alterações ",Transitar com o veículo com excesso de peso - PBT/PBTC,10,1,202101,10998,10988,10
6407641b305a576376e6f355,Excesso de Peso,JANEIRO,2021,RJ,"Lei 9503/97 Lei 10561/02 Res. CONTRAN nº 210/06, 211/06 e 258/07 e alterações Portaria DENATRAN 63/09 e 59/07 e alterações ",Transitar com o veículo com excesso de peso - Por Eixo,2991,1,202101,10988,7997,2991
6407641b305a576376e6f354,Excesso de Peso,JANEIRO,2021,RJ,"Lei 9503/97 Lei 10561/02 Res. CONTRAN nº 210/06, 211/06 e 258/07 e alterações Portaria DENATRAN 63/09 e 59/07 e alterações ",Transitar com o veículo com excesso de peso - PBT/PBTC e Por Eixo,435,1,202101,7997,7562,435
6407641b305a576376e6f34d,Excesso de Peso,JANEIRO,2021,MS,"Lei 9503/97 Lei 10561/02 Res. CONTRAN nº 210/06, 211/06 e 258/07 e alterações Portaria DENATRAN 63/09 e 59/07 e alterações ",Transitar com o veículo com excesso de peso - PBT/PBTC e Por Eixo,41,1,202101,7198,7157,41
6407641b305a576376e6f375,Excesso de Peso,FEVEREIRO,2021,RS,"Lei 9503/97 Lei 10561/02 Res. CONTRAN nº 210/06, 211/06 e 258/07 e alterações Portaria DENATRAN 63/09 e 59/07 e alterações ",Transitar com o veículo com excesso de peso - PBT/PBTC e Por Eixo,33,2,202102,114288,114255,33
6407641b305a576376e6f379,Excesso de Peso,FEVEREIRO,2021,SC,"Lei 9503/97 Lei 10561/02 Res. CONTRAN nº 210/06, 211/06 e 258/07 e alterações Portaria DENATRAN 63/09 e 59/07 e alterações ",Transitar com o veículo com excesso de peso - Por Eixo,626,2,202102,114914,114288,626
6407641b305a576376e6f37a,Excesso de Peso,FEVEREIRO,2021,SP,"Lei 9503/97 Lei 10561/02 Res. CONTRAN nº 210/06, 211/06 e 258/07 e alterações Portaria DENATRAN 63/09 e 59/07 e alterações ",Transitar com o veículo com excesso de peso - PBT/PBTC e Por Eixo,50,2,202102,114964,114914,50
6407641b305a576376e6f37c,Excesso de Peso,FEVEREIRO,2021,SP,"Lei 9503/97 Lei 10561/02 Res. CONTRAN nº 210/06, 211/06 e 258/07 e alterações Portaria DENATRAN 63/09 e 59/07 e alterações ",Transitar com o veículo com excesso de peso - Por Eixo,386,2,202102,115350,114964,386
6407641b305a576376e6f371,Excesso de Peso,FEVEREIRO,2021,RJ,"Lei 9503/97 Lei 10561/02 Res. CONTRAN nº 210/06, 211/06 e 258/07 e alterações Portaria DENATRAN 63/09 e 59/07 e alterações ",Transitar com o veículo com excesso de peso - PBT/PBTC,276,2,202102,110980,110704,276
6407641b305a576376e6f37b,Excesso de Peso,FEVEREIRO,2021,SP,"Lei 9503/97 Lei 10561/02 Res. CONTRAN nº 210/06, 211/06 e 258/07 e alterações Portaria DENATRAN 63/09 e 59/07 e alterações ",Transitar com o veículo com excesso de peso - PBT/PBTC,55,2,202102,32472,32417,55
6407641b305a576376e6f378,Excesso de Peso,FEVEREIRO,2021,SC,"Lei 9503/97 Lei 10561/02 Res. CONTRAN nº 210/06, 211/06 e 258/07 e alterações Portaria DENATRAN 63/09 e 59/07 e alterações ",Transitar com o veículo com excesso de peso - PBT/PBTC e Por Eixo,154,2,202102,32417,32263,154
6407641b305a576376e6f374,Excesso de Peso,FEVEREIRO,2021,RS,"Lei 9503/97 Lei 10561/02 Res. CONTRAN nº 210/06, 211/06 e 258/07 e alterações Portaria DENATRAN 63/09 e 59/07 e alterações ",Transitar com o veículo com excesso de peso - PBT/PBTC,17,2,202102,11666,11649,17
6407641b305a576376e6f372,Excesso de Peso,FEVEREIRO,2021,RJ,"Lei 9503/97 Lei 10561/02 Res. CONTRAN nº 210/06, 211/06 e 258/07 e alterações Portaria DENATRAN 63/09 e 59/07 e alterações ",Transitar com o veículo com excesso de peso - PBT/PBTC e Por Eixo,400,2,202102,11649,11249,400
6407641b305a576376e6f36e,Excesso de Peso,FEVEREIRO,2021,PR,"Lei 9503/97 Lei 10561/02 Res. CONTRAN nº 210/06, 211/06 e 258/07 e alterações Portaria DENATRAN 63/09 e 59/07 e alterações ",Transitar com o veículo com excesso de peso - PBT/PBTC,51,2,202102,11249,11198,51
6407641b305a576376e6f368,Excesso de Peso,FEVEREIRO,2021,ES,"Lei 9503/97 Lei 10561/02 Res. CONTRAN nº 210/06, 211/06 e 258/07 e alterações Portaria DENATRAN 63/09 e 59/07 e alterações ",Transitar com o veículo com excesso de peso - PBT/PBTC e Por Eixo,106,2,202102,11198,11092,106
6407641b305a576376e6f363,CMT - Capacidade Máxima de Tração,FEVEREIRO,2021,SP,"Lei 9503/97 Lei 10561/02 Res. CONTRAN nº 210/06, 211/06 e 258/07 e alterações Portaria DENATRAN 63/09 e 59/07 e alterações ",Transitar com o veículo excedendo a CMT acima de 1000 kg,2,2,202102,31121,31119,2
6407641b305a576376e6f366,Evasão de Balança,FEVEREIRO,2021,SP,"Lei 9503 DE 23/09/1997 Transpor, sem autorização, bloqueio viário com ou sem sinalização ou dispositivos auxiliares, deixar de adentrar às áreas destinadas à pesagem de veículos ou evadir-se para não efetuar o pagamento do pedágio.",Art. 209 Deixar de adentrar as áreas destinadas à pesagem de veículos,395,2,202102,31516,31121,395
6407641b305a576376e6f36d,Excesso de Peso,FEVEREIRO,2021,MG,"Lei 9503/97 Lei 10561/02 Res. CONTRAN nº 210/06, 211/06 e 258/07 e alterações Portaria DENATRAN 63/09 e 59/07 e alterações ",Transitar com o veículo com excesso de peso - Por Eixo,347,2,202102,31863,31516,347
6407641b305a576376e6f373,Excesso de Peso,FEVEREIRO,2021,RJ,"Lei 9503/97 Lei 10561/02 Res. CONTRAN nº 210/06, 211/06 e 258/07 e alterações Portaria DENATRAN 63/09 e 59/07 e alterações ",Transitar com o veículo com excesso de peso - Por Eixo,3275,2,202102,114255,110980,3275
6407641b305a576376e6f376,Excesso de Peso,FEVEREIRO,2021,RS,"Lei 9503/97 Lei 10561/02 Res. CONTRAN nº 210/06, 211/06 e 258/07 e alterações Portaria DENATRAN 63/09 e 59/07 e alterações ",Transitar com o veículo com excesso de peso - Por Eixo,339,2,202102,32202,31863,339
6407641b305a576376e6f377,Excesso de Peso,FEVEREIRO,2021,SC,"Lei 9503/97 Lei 10561/02 Res. CONTRAN nº 210/06, 211/06 e 258/07 e alterações Portaria DENATRAN 63/09 e 59/07 e alterações ",Transitar com o veículo com excesso de peso - PBT/PBTC,61,2,202102,32263,32202,61
6407641b305a576376e6f36b,Excesso de Peso,FEVEREIRO,2021,MG,"Lei 9503/97 Lei 10561/02 Res. CONTRAN nº 210/06, 211/06 e 258/07 e alterações Portaria DENATRAN 63/09 e 59/07 e alterações ",Transitar com o veículo com excesso de peso - PBT/PBTC,32,2,202102,110620,110588,32
6407641b305a576376e6f365,Evasão de Balança,FEVEREIRO,2021,RJ,"Lei 9503 DE 23/09/1997 Transpor, sem autorização, bloqueio viário com ou sem sinalização ou dispositivos auxiliares, deixar de adentrar às áreas destinadas à pesagem de veículos ou evadir-se para não efetuar o pagamento do pedágio.",Art. 209 Deixar de adentrar as áreas destinadas à pesagem de veículos,6508,2,202102,110588,104080,6508
6407641b305a576376e6f361,CMT - Capacidade Máxima de Tração,FEVEREIRO,2021,RJ,"Lei 9503/97 Lei 10561/02 Res. CONTRAN nº 210/06, 211/06 e 258/07 e alterações Portaria DENATRAN 63/09 e 59/07 e alterações ",Transitar com o veículo excedendo a CMT acima de 1000 kg,3,2,202102,104080,104077,3
6407641b305a576376e6f360,CMT - Capacidade Máxima de Tração,FEVEREIRO,2021,RJ,"Lei 9503/97 Lei 10561/02 Res. CONTRAN nº 210/06, 211/06 e 258/07 e alterações Portaria DENATRAN 63/09 e 59/07 e alterações ",Transitar com o veículo excedendo a CMT entre 601 e 1000 kg,1,2,202102,104077,104076,1
6407641b305a576376e6f367,Excesso de Peso,FEVEREIRO,2021,ES,"Lei 9503/97 Lei 10561/02 Res. CONTRAN nº 210/06, 211/06 e 258/07 e alterações Portaria DENATRAN 63/09 e 59/07 e alterações ",Transitar com o veículo com excesso de peso - PBT/PBTC,89,2,202102,11092,11003,89
6407641b305a576376e6f370,Excesso de Peso,FEVEREIRO,2021,PR,"Lei 9503/97 Lei 10561/02 Res. CONTRAN nº 210/06, 211/06 e 258/07 e alterações Portaria DENATRAN 63/09 e 59/07 e alterações ",Transitar com o veículo com excesso de peso - Por Eixo,414,2,202102,164993,164579,414
6407641b305a576376e6f36f,Excesso de Peso,FEVEREIRO,2021,PR,"Lei 9503/97 Lei 10561/02 Res. CONTRAN nº 210/06, 211/06 e 258/07 e alterações Portaria DENATRAN 63/09 e 59/07 e alterações ",Transitar com o veículo com excesso de peso - PBT/PBTC e Por Eixo,81,2,202102,164579,164498,81
6407641b305a576376e6f36a,Excesso de Peso,FEVEREIRO,2021,GO,"Lei 9503/97 Lei 10561/02 Res. CONTRAN nº 210/06, 211/06 e 258/07 e alterações Portaria DENATRAN 63/09 e 59/07 e alterações ",Transitar com o veículo com excesso de peso - Por Eixo,1,2,202102,164498,164497,1
6407641b305a576376e6f369,Excesso de Peso,FEVEREIRO,2021,ES,"Lei 9503/97 Lei 10561/02 Res. CONTRAN nº 210/06, 211/06 e 258/07 e alterações Portaria DENATRAN 63/09 e 59/07 e alterações ",Transitar com o veículo com excesso de peso - Por Eixo,816,2,202102,164497,163681,816
6407641b305a576376e6f364,Evasão de Balança,FEVEREIRO,2021,ES,"Lei 9503 DE 23/09/1997 Transpor, sem autorização, bloqueio viário com ou sem sinalização ou dispositivos auxiliares, deixar de adentrar às áreas destinadas à pesagem de veículos ou evadir-se para não efetuar o pagamento do pedágio.",Art. 209 Deixar de adentrar as áreas destinadas à pesagem de veículos,762,2,202102,163681,162919,762
6407641b305a576376e6f362,CMT - Capacidade Máxima de Tração,FEVEREIRO,2021,RJ,"Lei 9503/97 Lei 10561/02 Res. CONTRAN nº 210/06, 211/06 e 258/07 e alterações Portaria DENATRAN 63/09 e 59/07 e alterações ",Transitar com o veículo excedendo a CMT em até 600 kg,4,2,202102,11003,10999,4
6407641b305a576376e6f36c,Excesso de Peso,FEVEREIRO,2021,MG,"Lei 9503/97 Lei 10561/02 Res. CONTRAN nº 210/06, 211/06 e 258/07 e alterações Portaria DENATRAN 63/09 e 59/07 e alterações ",Transitar com o veículo com excesso de peso - PBT/PBTC e Por Eixo,84,2,202102,110704,110620,84
6407641b305a576376e6f35f,CMT - Capacidade Máxima de Tração,FEVEREIRO,2021,PR,"Lei 9503/97 Lei 10561/02 Res. CONTRAN nº 210/06, 211/06 e 258/07 e alterações Portaria DENATRAN 63/09 e 59/07 e alterações ",Transitar com o veículo excedendo a CMT acima de 1000 kg,1,2,202102,10999,10998,1
6407641b305a576376e6f382,CMT - Capacidade Máxima de Tração,MARÇO,2021,SP,"Lei 9503/97 Lei 10561/02 Res. CONTRAN nº 210/06, 211/06 e 258/07 e alterações Portaria DENATRAN 63/09 e 59/07 e alterações ",Transitar com o veículo excedendo a CMT acima de 1000 kg,2,3,202103,164995,164993,2
6407641b305a576376e6f390,Excesso de Peso,MARÇO,2021,RJ,"Lei 9503/97 Lei 10561/02 Res. CONTRAN nº 210/06, 211/06 e 258/07 e alterações Portaria DENATRAN 63/09 e 59/07 e alterações ",Transitar com o veículo com excesso de peso - PBT/PBTC e Por Eixo,453,3,202103,13654,13201,453
6407641b305a576376e6f381,CMT - Capacidade Máxima de Tração,MARÇO,2021,SC,"Lei 9503/97 Lei 10561/02 Res. CONTRAN nº 210/06, 211/06 e 258/07 e alterações Portaria DENATRAN 63/09 e 59/07 e alterações ",Transitar com o veículo excedendo a CMT acima de 1000 kg,1,3,202103,32476,32475,1
6407641b305a576376e6f37f,CMT - Capacidade Máxima de Tração,MARÇO,2021,RJ,"Lei 9503/97 Lei 10561/02 Res. CONTRAN nº 210/06, 211/06 e 258/07 e alterações Portaria DENATRAN 63/09 e 59/07 e alterações ",Transitar com o veículo excedendo a CMT em até 600 kg,2,3,202103,32475,32473,2
6407641b305a576376e6f39a,Excesso de Peso,MARÇO,2021,SP,"Lei 9503/97 Lei 10561/02 Res. CONTRAN nº 210/06, 211/06 e 258/07 e alterações Portaria DENATRAN 63/09 e 59/07 e alterações ",Transitar com o veículo com excesso de peso - Por Eixo,488,3,202103,172426,171938,488
6407641b305a576376e6f38c,Excesso de Peso,MARÇO,2021,PR,"Lei 9503/97 Lei 10561/02 Res. CONTRAN nº 210/06, 211/06 e 258/07 e alterações Portaria DENATRAN 63/09 e 59/07 e alterações ",Transitar com o veículo com excesso de peso - PBT/PBTC,31,3,202103,32610,32579,31
6407641b305a576376e6f392,Excesso de Peso,MARÇO,2021,RS,"Lei 9503/97 Lei 10561/02 Res. CONTRAN nº 210/06, 211/06 e 258/07 e alterações Portaria DENATRAN 63/09 e 59/07 e alterações ",Transitar com o veículo com excesso de peso - PBT/PBTC,12,3,202103,32622,32610,12
6407641b305a576376e6f396,Excesso de Peso,MARÇO,2021,SC,"Lei 9503/97 Lei 10561/02 Res. CONTRAN nº 210/06, 211/06 e 258/07 e alterações Portaria DENATRAN 63/09 e 59/07 e alterações ",Transitar com o veículo com excesso de peso - PBT/PBTC e Por Eixo,207,3,202103,32829,32622,207
6407641b305a576376e6f399,Excesso de Peso,MARÇO,2021,SP,"Lei 9503/97 Lei 10561/02 Res. CONTRAN nº 210/06, 211/06 e 258/07 e alterações Portaria DENATRAN 63/09 e 59/07 e alterações ",Transitar com o veículo com excesso de peso - PBT/PBTC e Por Eixo,74,3,202103,32903,32829,74
6407641b305a576376e6f393,Excesso de Peso,MARÇO,2021,RS,"Lei 9503/97 Lei 10561/02 Res. CONTRAN nº 210/06, 211/06 e 258/07 e alterações Portaria DENATRAN 63/09 e 59/07 e alterações ",Transitar com o veículo com excesso de peso - PBT/PBTC e Por Eixo,26,3,202103,121701,121675,26
6407641b305a576376e6f395,Excesso de Peso,MARÇO,2021,SC,"Lei 9503/97 Lei 10561/02 Res. CONTRAN nº 210/06, 211/06 e 258/07 e alterações Portaria DENATRAN 63/09 e 59/07 e alterações ",Transitar com o veículo com excesso de peso - PBT/PBTC,81,3,202103,121782,121701,81
6407641b305a576376e6f398,Excesso de Peso,MARÇO,2021,SP,"Lei 9503/97 Lei 10561/02 Res. CONTRAN nº 210/06, 211/06 e 258/07 e alterações Portaria DENATRAN 63/09 e 59/07 e alterações ",Transitar com o veículo com excesso de peso - PBT/PBTC,46,3,202103,121828,121782,46
6407641b305a576376e6f37e,CMT - Capacidade Máxima de Tração,MARÇO,2021,RJ,"Lei 9503/97 Lei 10561/02 Res. CONTRAN nº 210/06, 211/06 e 258/07 e alterações Portaria DENATRAN 63/09 e 59/07 e alterações ",Transitar com o veículo excedendo a CMT acima de 1000 kg,1,3,202103,32473,32472,1
6407641b305a576376e6f394,Excesso de Peso,MARÇO,2021,RS,"Lei 9503/97 Lei 10561/02 Res. CONTRAN nº 210/06, 211/06 e 258/07 e alterações Portaria DENATRAN 63/09 e 59/07 e alterações ",Transitar com o veículo com excesso de peso - Por Eixo,418,3,202103,14072,13654,418
6407641b305a576376e6f386,Excesso de Peso,MARÇO,2021,ES,"Lei 9503/97 Lei 10561/02 Res. CONTRAN nº 210/06, 211/06 e 258/07 e alterações Portaria DENATRAN 63/09 e 59/07 e alterações ",Transitar com o veículo com excesso de peso - PBT/PBTC,103,3,202103,32579,32476,103
6407641b305a576376e6f383,Evasão de Balança,MARÇO,2021,ES,"Lei 9503 DE 23/09/1997 Transpor, sem autorização, bloqueio viário com ou sem sinalização ou dispositivos auxiliares, deixar de adentrar às áreas destinadas à pesagem de veículos ou evadir-se para não efetuar o pagamento do pedágio.",Art. 209 Deixar de adentrar as áreas destinadas à pesagem de veículos,631,3,202103,12300,11669,631
6407641b305a576376e6f397,Excesso de Peso,MARÇO,2021,SC,"Lei 9503/97 Lei 10561/02 Res. CONTRAN nº 210/06, 211/06 e 258/07 e alterações Portaria DENATRAN 63/09 e 59/07 e alterações ",Transitar com o veículo com excesso de peso - Por Eixo,839,3,202103,14911,14072,839
6407641b305a576376e6f380,CMT - Capacidade Máxima de Tração,MARÇO,2021,RJ,"Lei 9503/97 Lei 10561/02 Res. CONTRAN nº 210/06, 211/06 e 258/07 e alterações Portaria DENATRAN 63/09 e 59/07 e alterações ",Transitar com o veículo excedendo a CMT entre 601 e 1000 kg,3,3,202103,11669,11666,3
6407641b305a576376e6f37d,CMT - Capacidade Máxima de Tração,MARÇO,2021,ES,"Lei 9503/97 Lei 10561/02 Res. CONTRAN nº 210/06, 211/06 e 258/07 e alterações Portaria DENATRAN 63/09 e 59/07 e alterações ",Transitar com o veículo excedendo a CMT acima de 1000 kg,1,3,202103,115351,115350,1
6407641b305a576376e6f385,Evasão de Balança,MARÇO,2021,SP,"Lei 9503 DE 23/09/1997 Transpor, sem autorização, bloqueio viário com ou sem sinalização ou dispositivos auxiliares, deixar de adentrar às áreas destinadas à pesagem de veículos ou evadir-se para não efetuar o pagamento do pedágio.",Art. 209 Deixar de adentrar as áreas destinadas à pesagem de veículos,1074,3,202103,116425,115351,1074
6407641b305a576376e6f387,Excesso de Peso,MARÇO,2021,ES,"Lei 9503/97 Lei 10561/02 Res. CONTRAN nº 210/06, 211/06 e 258/07 e alterações Portaria DENATRAN 63/09 e 59/07 e alterações ",Transitar com o veículo com excesso de peso - PBT/PBTC e Por Eixo,125,3,202103,116550,116425,125
6407641b305a576376e6f388,Excesso de Peso,MARÇO,2021,ES,"Lei 9503/97 Lei 10561/02 Res. CONTRAN nº 210/06, 211/06 e 258/07 e alterações Portaria DENATRAN 63/09 e 59/07 e alterações ",Transitar com o veículo com excesso de peso - Por Eixo,1155,3,202103,117705,116550,1155
6407641b305a576376e6f384,Evasão de Balança,MARÇO,2021,RJ,"Lei 9503 DE 23/09/1997 Transpor, sem autorização, bloqueio viário com ou sem sinalização ou dispositivos auxiliares, deixar de adentrar às áreas destinadas à pesagem de veículos ou evadir-se para não efetuar o pagamento do pedágio.",Art. 209 Deixar de adentrar as áreas destinadas à pesagem de veículos,6943,3,202103,171938,164995,6943
6407641b305a576376e6f38a,Excesso de Peso,MARÇO,2021,MG,"Lei 9503/97 Lei 10561/02 Res. CONTRAN nº 210/06, 211/06 e 258/07 e alterações Portaria DENATRAN 63/09 e 59/07 e alterações ",Transitar com o veículo com excesso de peso - PBT/PBTC e Por Eixo,78,3,202103,117816,117738,78
6407641b305a576376e6f389,Excesso de Peso,MARÇO,2021,MG,"Lei 9503/97 Lei 10561/02 Res. CONTRAN nº 210/06, 211/06 e 258/07 e alterações Portaria DENATRAN 63/09 e 59/07 e alterações ",Transitar com o veículo com excesso de peso - PBT/PBTC,33,3,202103,117738,117705,33
6407641b305a576376e6f38f,Excesso de Peso,MARÇO,2021,RJ,"Lei 9503/97 Lei 10561/02 Res. CONTRAN nº 210/06, 211/06 e 258/07 e alterações Portaria DENATRAN 63/09 e 59/07 e alterações ",Transitar com o veículo com excesso de peso - PBT/PBTC,406,3,202103,13201,12795,406
6407641b305a576376e6f391,Excesso de Peso,MARÇO,2021,RJ,"Lei 9503/97 Lei 10561/02 Res. CONTRAN nº 210/06, 211/06 e 258/07 e alterações Portaria DENATRAN 63/09 e 59/07 e alterações ",Transitar com o veículo com excesso de peso - Por Eixo,3437,3,202103,121675,118238,3437
6407641b305a576376e6f38e,Excesso de Peso,MARÇO,2021,PR,"Lei 9503/97 Lei 10561/02 Res. CONTRAN nº 210/06, 211/06 e 258/07 e alterações Portaria DENATRAN 63/09 e 59/07 e alterações ",Transitar com o veículo com excesso de peso - Por Eixo,363,3,202103,118238,117875,363
6407641b305a576376e6f38d,Excesso de Peso,MARÇO,2021,PR,"Lei 9503/97 Lei 10561/02 Res. CONTRAN nº 210/06, 211/06 e 258/07 e alterações Portaria DENATRAN 63/09 e 59/07 e alterações ",Transitar com o veículo com excesso de peso - PBT/PBTC e Por Eixo,59,3,202103,117875,117816,59
6407641b305a576376e6f38b,Excesso de Peso,MARÇO,2021,MG,"Lei 9503/97 Lei 10561/02 Res. CONTRAN nº 210/06, 211/06 e 258/07 e alterações Portaria DENATRAN 63/09 e 59/07 e alterações ",Transitar com o veículo com excesso de peso - Por Eixo,495,3,202103,12795,12300,495
6407641b305a576376e6f3b4,Excesso de Peso,ABRIL,2021,PR,"Lei 9503/97 Lei 10561/02 Res. CONTRAN nº 210/06, 211/06 e 258/07 e alterações Portaria DENATRAN 63/09 e 59/07 e alterações ",Transitar com o veículo com excesso de peso - PBT/PBTC,73,4,202104,34098,34025,73
6407641b305a576376e6f3c0,Excesso de Peso,ABRIL,2021,SP,"Lei 9503/97 Lei 10561/02 Res. CONTRAN nº 210/06, 211/06 e 258/07 e alterações Portaria DENATRAN 63/09 e 59/07 e alterações ",Transitar com o veículo com excesso de peso - PBT/PBTC,65,4,202104,23123,23058,65
6407641b305a576376e6f3ba,Excesso de Peso,ABRIL,2021,RS,"Lei 9503/97 Lei 10561/02 Res. CONTRAN nº 210/06, 211/06 e 258/07 e alterações Portaria DENATRAN 63/09 e 59/07 e alterações ",Transitar com o veículo com excesso de peso - PBT/PBTC,40,4,202104,176476,176436,40
6407641b305a576376e6f3bb,Excesso de Peso,ABRIL,2021,RS,"Lei 9503/97 Lei 10561/02 Res. CONTRAN nº 210/06, 211/06 e 258/07 e alterações Portaria DENATRAN 63/09 e 59/07 e alterações ",Transitar com o veículo com excesso de peso - PBT/PBTC e Por Eixo,65,4,202104,176541,176476,65
6407641b305a576376e6f3bf,Excesso de Peso,ABRIL,2021,SC,"Lei 9503/97 Lei 10561/02 Res. CONTRAN nº 210/06, 211/06 e 258/07 e alterações Portaria DENATRAN 63/09 e 59/07 e alterações ",Transitar com o veículo com excesso de peso - Por Eixo,1013,4,202104,177554,176541,1013
6407641b305a576376e6f3bd,Excesso de Peso,ABRIL,2021,SC,"Lei 9503/97 Lei 10561/02 Res. CONTRAN nº 210/06, 211/06 e 258/07 e alterações Portaria DENATRAN 63/09 e 59/07 e alterações ",Transitar com o veículo com excesso de peso - PBT/PBTC,119,4,202104,23058,22939,119
6407641b305a576376e6f3b8,Excesso de Peso,ABRIL,2021,RJ,"Lei 9503/97 Lei 10561/02 Res. CONTRAN nº 210/06, 211/06 e 258/07 e alterações Portaria DENATRAN 63/09 e 59/07 e alterações ",Transitar com o veículo com excesso de peso - PBT/PBTC e Por Eixo,469,4,202104,22939,22470,469
6407641b305a576376e6f3b7,Excesso de Peso,ABRIL,2021,RJ,"Lei 9503/97 Lei 10561/02 Res. CONTRAN nº 210/06, 211/06 e 258/07 e alterações Portaria DENATRAN 63/09 e 59/07 e alterações ",Transitar com o veículo com excesso de peso - PBT/PBTC,353,4,202104,22470,22117,353
6407641b305a576376e6f39e,CMT - Capacidade Máxima de Tração,ABRIL,2021,RJ,"Lei 9503/97 Lei 10561/02 Res. CONTRAN nº 210/06, 211/06 e 258/07 e alterações Portaria DENATRAN 63/09 e 59/07 e alterações ",Transitar com o veículo excedendo a CMT em até 600 kg,1,4,202104,32904,32903,1
6407641b305a576376e6f3b6,Excesso de Peso,ABRIL,2021,PR,"Lei 9503/97 Lei 10561/02 Res. CONTRAN nº 210/06, 211/06 e 258/07 e alterações Portaria DENATRAN 63/09 e 59/07 e alterações ",Transitar com o veículo com excesso de peso - Por Eixo,750,4,202104,22117,21367,750
6407641b305a576376e6f3b1,Excesso de Peso,ABRIL,2021,MS,"Lei 9503/97 Lei 10561/02 Res. CONTRAN nº 210/06, 211/06 e 258/07 e alterações Portaria DENATRAN 63/09 e 59/07 e alterações ",Transitar com o veículo com excesso de peso - PBT/PBTC,6,4,202104,21264,21258,6
6407641b305a576376e6f3ad,Excesso de Peso,ABRIL,2021,GO,"Lei 9503/97 Lei 10561/02 Res. CONTRAN nº 210/06, 211/06 e 258/07 e alterações Portaria DENATRAN 63/09 e 59/07 e alterações ",Transitar com o veículo com excesso de peso - Por Eixo,248,4,202104,21258,21010,248
6407641b305a576376e6f3aa,Excesso de Peso,ABRIL,2021,ES,"Lei 9503/97 Lei 10561/02 Res. CONTRAN nº 210/06, 211/06 e 258/07 e alterações Portaria DENATRAN 63/09 e 59/07 e alterações ",Transitar com o veículo com excesso de peso - Por Eixo,930,4,202104,21010,20080,930
6407641b305a576376e6f3a9,Excesso de Peso,ABRIL,2021,ES,"Lei 9503/97 Lei 10561/02 Res. CONTRAN nº 210/06, 211/06 e 258/07 e alterações Portaria DENATRAN 63/09 e 59/07 e alterações ",Transitar com o veículo com excesso de peso - PBT/PBTC e Por Eixo,100,4,202104,20080,19980,100
6407641b305a576376e6f3a7,Evasão de Balança,ABRIL,2021,SP,"Lei 9503 DE 23/09/1997 Transpor, sem autorização, bloqueio viário com ou sem sinalização ou dispositivos auxiliares, deixar de adentrar às áreas destinadas à pesagem de veículos ou evadir-se para não efetuar o pagamento do pedágio.",Art. 209 Deixar de adentrar as áreas destinadas à pesagem de veículos,531,4,202104,19980,19449,531
6407641b305a576376e6f3a6,Evasão de Balança,ABRIL,2021,RJ,"Lei 9503 DE 23/09/1997 Transpor, sem autorização, bloqueio viário com ou sem sinalização ou dispositivos auxiliares, deixar de adentrar às áreas destinadas à pesagem de veículos ou evadir-se para não efetuar o pagamento do pedágio.",Art. 209 Deixar de adentrar as áreas destinadas à pesagem de veículos,4152,4,202104,19449,15297,4152
6407641b305a576376e6f3a3,Evasão de Balança,ABRIL,2021,ES,"Lei 9503 DE 23/09/1997 Transpor, sem autorização, bloqueio viário com ou sem sinalização ou dispositivos auxiliares, deixar de adentrar às áreas destinadas à pesagem de veículos ou evadir-se para não efetuar o pagamento do pedágio.",Art. 209 Deixar de adentrar as áreas destinadas à pesagem de veículos,385,4,202104,15297,14912,385
6407641b305a576376e6f3b3,Excesso de Peso,ABRIL,2021,MS,"Lei 9503/97 Lei 10561/02 Res. CONTRAN nº 210/06, 211/06 e 258/07 e alterações Portaria DENATRAN 63/09 e 59/07 e alterações ",Transitar com o veículo com excesso de peso - Por Eixo,103,4,202104,21367,21264,103
6407641b305a576376e6f3b9,Excesso de Peso,ABRIL,2021,RJ,"Lei 9503/97 Lei 10561/02 Res. CONTRAN nº 210/06, 211/06 e 258/07 e alterações Portaria DENATRAN 63/09 e 59/07 e alterações ",Transitar com o veículo com excesso de peso - Por Eixo,3512,4,202104,176436,172924,3512
6407641b305a576376e6f3b2,Excesso de Peso,ABRIL,2021,MS,"Lei 9503/97 Lei 10561/02 Res. CONTRAN nº 210/06, 211/06 e 258/07 e alterações Portaria DENATRAN 63/09 e 59/07 e alterações ",Transitar com o veículo com excesso de peso - PBT/PBTC e Por Eixo,37,4,202104,172924,172887,37
6407641b305a576376e6f3ac,Excesso de Peso,ABRIL,2021,GO,"Lei 9503/97 Lei 10561/02 Res. CONTRAN nº 210/06, 211/06 e 258/07 e alterações Portaria DENATRAN 63/09 e 59/07 e alterações ",Transitar com o veículo com excesso de peso - PBT/PBTC e Por Eixo,35,4,202104,172887,172852,35
6407641b305a576376e6f3b5,Excesso de Peso,ABRIL,2021,PR,"Lei 9503/97 Lei 10561/02 Res. CONTRAN nº 210/06, 211/06 e 258/07 e alterações Portaria DENATRAN 63/09 e 59/07 e alterações ",Transitar com o veículo com excesso de peso - PBT/PBTC e Por Eixo,98,4,202104,34196,34098,98
6407641b305a576376e6f3bc,Excesso de Peso,ABRIL,2021,RS,"Lei 9503/97 Lei 10561/02 Res. CONTRAN nº 210/06, 211/06 e 258/07 e alterações Portaria DENATRAN 63/09 e 59/07 e alterações ",Transitar com o veículo com excesso de peso - Por Eixo,792,4,202104,34988,34196,792
6407641b305a576376e6f3c2,Excesso de Peso,ABRIL,2021,SP,"Lei 9503/97 Lei 10561/02 Res. CONTRAN nº 210/06, 211/06 e 258/07 e alterações Portaria DENATRAN 63/09 e 59/07 e alterações ",Transitar com o veículo com excesso de peso - Por Eixo,535,4,202104,35523,34988,535
6407641b305a576376e6f3af,Excesso de Peso,ABRIL,2021,MG,"Lei 9503/97 Lei 10561/02 Res. CONTRAN nº 210/06, 211/06 e 258/07 e alterações Portaria DENATRAN 63/09 e 59/07 e alterações ",Transitar com o veículo com excesso de peso - PBT/PBTC e Por Eixo,164,4,202104,33077,32913,164
6407641b305a576376e6f3ab,Excesso de Peso,ABRIL,2021,GO,"Lei 9503/97 Lei 10561/02 Res. CONTRAN nº 210/06, 211/06 e 258/07 e alterações Portaria DENATRAN 63/09 e 59/07 e alterações ",Transitar com o veículo com excesso de peso - PBT/PBTC,7,4,202104,32913,32906,7
6407641b305a576376e6f3a1,CMT - Capacidade Máxima de Tração,ABRIL,2021,RS,"Lei 9503/97 Lei 10561/02 Res. CONTRAN nº 210/06, 211/06 e 258/07 e alterações Portaria DENATRAN 63/09 e 59/07 e alterações ",Transitar com o veículo excedendo a CMT acima de 1000 kg,1,4,202104,32906,32905,1
6407641b305a576376e6f39b,CMT - Capacidade Máxima de Tração,ABRIL,2021,MG,"Lei 9503/97 Lei 10561/02 Res. CONTRAN nº 210/06, 211/06 e 258/07 e alterações Portaria DENATRAN 63/09 e 59/07 e alterações ",Transitar com o veículo excedendo a CMT acima de 1000 kg,3,4,202104,121831,121828,3
6407641b305a576376e6f39d,CMT - Capacidade Máxima de Tração,ABRIL,2021,MS,"Lei 9503/97 Lei 10561/02 Res. CONTRAN nº 210/06, 211/06 e 258/07 e alterações Portaria DENATRAN 63/09 e 59/07 e alterações ",Transitar com o veículo excedendo a CMT acima de 1000 kg,1,4,202104,121832,121831,1
6407641b305a576376e6f3a2,CMT - Capacidade Máxima de Tração,ABRIL,2021,SC,"Lei 9503/97 Lei 10561/02 Res. CONTRAN nº 210/06, 211/06 e 258/07 e alterações Portaria DENATRAN 63/09 e 59/07 e alterações ",Transitar com o veículo excedendo a CMT acima de 1000 kg,2,4,202104,121834,121832,2
6407641b305a576376e6f3a5,Evasão de Balança,ABRIL,2021,MG,"Lei 9503 DE 23/09/1997 Transpor, sem autorização, bloqueio viário com ou sem sinalização ou dispositivos auxiliares, deixar de adentrar às áreas destinadas à pesagem de veículos ou evadir-se para não efetuar o pagamento do pedágio.",Art. 209 Deixar de adentrar as áreas destinadas à pesagem de veículos,233,4,202104,122067,121834,233
6407641b305a576376e6f3ae,Excesso de Peso,ABRIL,2021,MG,"Lei 9503/97 Lei 10561/02 Res. CONTRAN nº 210/06, 211/06 e 258/07 e alterações Portaria DENATRAN 63/09 e 59/07 e alterações ",Transitar com o veículo com excesso de peso - PBT/PBTC,37,4,202104,122104,122067,37
6407641b305a576376e6f3be,Excesso de Peso,ABRIL,2021,SC,"Lei 9503/97 Lei 10561/02 Res. CONTRAN nº 210/06, 211/06 e 258/07 e alterações Portaria DENATRAN 63/09 e 59/07 e alterações ",Transitar com o veículo com excesso de peso - PBT/PBTC e Por Eixo,238,4,202104,122342,122104,238
6407641b305a576376e6f3c1,Excesso de Peso,ABRIL,2021,SP,"Lei 9503/97 Lei 10561/02 Res. CONTRAN nº 210/06, 211/06 e 258/07 e alterações Portaria DENATRAN 63/09 e 59/07 e alterações ",Transitar com o veículo com excesso de peso - PBT/PBTC e Por Eixo,66,4,202104,122408,122342,66
6407641b305a576376e6f39f,CMT - Capacidade Máxima de Tração,ABRIL,2021,RJ,"Lei 9503/97 Lei 10561/02 Res. CONTRAN nº 210/06, 211/06 e 258/07 e alterações Portaria DENATRAN 63/09 e 59/07 e alterações ",Transitar com o veículo excedendo a CMT acima de 1000 kg,1,4,202104,172427,172426,1
6407641b305a576376e6f3a4,Evasão de Balança,ABRIL,2021,GO,"Lei 9503 DE 23/09/1997 Transpor, sem autorização, bloqueio viário com ou sem sinalização ou dispositivos auxiliares, deixar de adentrar às áreas destinadas à pesagem de veículos ou evadir-se para não efetuar o pagamento do pedágio.",Art. 209 Deixar de adentrar as áreas destinadas à pesagem de veículos,347,4,202104,172774,172427,347
6407641b305a576376e6f39c,CMT - Capacidade Máxima de Tração,ABRIL,2021,MS,"Lei 9503/97 Lei 10561/02 Res. CONTRAN nº 210/06, 211/06 e 258/07 e alterações Portaria DENATRAN 63/09 e 59/07 e alterações ",Transitar com o veículo excedendo a CMT entre 601 e 1000 kg,1,4,202104,14912,14911,1
6407641b305a576376e6f3a0,CMT - Capacidade Máxima de Tração,ABRIL,2021,RJ,"Lei 9503/97 Lei 10561/02 Res. CONTRAN nº 210/06, 211/06 e 258/07 e alterações Portaria DENATRAN 63/09 e 59/07 e alterações ",Transitar com o veículo excedendo a CMT entre 601 e 1000 kg,1,4,202104,32905,32904,1
6407641b305a576376e6f3b0,Excesso de Peso,ABRIL,2021,MG,"Lei 9503/97 Lei 10561/02 Res. CONTRAN nº 210/06, 211/06 e 258/07 e alterações Portaria DENATRAN 63/09 e 59/07 e alterações ",Transitar com o veículo com excesso de peso - Por Eixo,948,4,202104,34025,33077,948
6407641b305a576376e6f3a8,Excesso de Peso,ABRIL,2021,ES,"Lei 9503/97 Lei 10561/02 Res. CONTRAN nº 210/06, 211/06 e 258/07 e alterações Portaria DENATRAN 63/09 e 59/07 e alterações ",Transitar com o veículo com excesso de peso - PBT/PBTC,78,4,202104,172852,172774,78
6407641b305a576376e6f3d6,Excesso de Peso,MAIO,2021,GO,"Lei 9503/97 Lei 10561/02 Res. CONTRAN nº 210/06, 211/06 e 258/07 e alterações Portaria DENATRAN 63/09 e 59/07 e alterações ",Transitar com o veículo com excesso de peso - Por Eixo,562,5,202105,127685,127123,562
6407641b305a576376e6f3db,Excesso de Peso,MAIO,2021,MS,"Lei 9503/97 Lei 10561/02 Res. CONTRAN nº 210/06, 211/06 e 258/07 e alterações Portaria DENATRAN 63/09 e 59/07 e alterações ",Transitar com o veículo com excesso de peso - PBT/PBTC,9,5,202105,127792,127783,9
6407641b305a576376e6f3d8,Excesso de Peso,MAIO,2021,MG,"Lei 9503/97 Lei 10561/02 Res. CONTRAN nº 210/06, 211/06 e 258/07 e alterações Portaria DENATRAN 63/09 e 59/07 e alterações ",Transitar com o veículo com excesso de peso - PBT/PBTC,98,5,202105,127783,127685,98
6407641b305a576376e6f3d5,Excesso de Peso,MAIO,2021,GO,"Lei 9503/97 Lei 10561/02 Res. CONTRAN nº 210/06, 211/06 e 258/07 e alterações Portaria DENATRAN 63/09 e 59/07 e alterações ",Transitar com o veículo com excesso de peso - PBT/PBTC e Por Eixo,99,5,202105,127123,127024,99
6407641b305a576376e6f3d3,Excesso de Peso,MAIO,2021,GO,,"Realizar transporte permissionado de passageiros, sem a emissão de bilhete.",3,5,202105,127024,127021,3
6407641b305a576376e6f3d0,Excesso de Peso,MAIO,2021,ES,"Lei 9503/97 Lei 10561/02 Res. CONTRAN nº 210/06, 211/06 e 258/07 e alterações Portaria DENATRAN 63/09 e 59/07 e alterações ",Transitar com o veículo com excesso de peso - PBT/PBTC e Por Eixo,135,5,202105,127021,126886,135
6407641b305a576376e6f3cb,Evasão de Balança,MAIO,2021,GO,"Lei 9503 DE 23/09/1997 Transpor, sem autorização, bloqueio viário com ou sem sinalização ou dispositivos auxiliares, deixar de adentrar às áreas destinadas à pesagem de veículos ou evadir-se para não efetuar o pagamento do pedágio.",Art. 209 Deixar de adentrar as áreas destinadas à pesagem de veículos,798,5,202105,123422,122624,798
6407641b305a576376e6f3ca,Evasão de Balança,MAIO,2021,ES,"Lei 9503 DE 23/09/1997 Transpor, sem autorização, bloqueio viário com ou sem sinalização ou dispositivos auxiliares, deixar de adentrar às áreas destinadas à pesagem de veículos ou evadir-se para não efetuar o pagamento do pedágio.",Art. 209 Deixar de adentrar as áreas destinadas à pesagem de veículos,215,5,202105,122624,122409,215
6407641b305a576376e6f3c6,CMT - Capacidade Máxima de Tração,MAIO,2021,RJ,"Lei 9503/97 Lei 10561/02 Res. CONTRAN nº 210/06, 211/06 e 258/07 e alterações Portaria DENATRAN 63/09 e 59/07 e alterações ",Transitar com o veículo excedendo a CMT entre 601 e 1000 kg,1,5,202105,122409,122408,1
6407641b305a576376e6f3df,Excesso de Peso,MAIO,2021,PR,"Lei 9503/97 Lei 10561/02 Res. CONTRAN nº 210/06, 211/06 e 258/07 e alterações Portaria DENATRAN 63/09 e 59/07 e alterações ",Transitar com o veículo com excesso de peso - PBT/PBTC e Por Eixo,107,5,202105,127899,127792,107
6407641b305a576376e6f3cd,Evasão de Balança,MAIO,2021,RJ,"Lei 9503 DE 23/09/1997 Transpor, sem autorização, bloqueio viário com ou sem sinalização ou dispositivos auxiliares, deixar de adentrar às áreas destinadas à pesagem de veículos ou evadir-se para não efetuar o pagamento do pedágio.",Art. 209 Deixar de adentrar as áreas destinadas à pesagem de veículos,3464,5,202105,126886,123422,3464
6407641b305a576376e6f3de,Excesso de Peso,MAIO,2021,PR,"Lei 9503/97 Lei 10561/02 Res. CONTRAN nº 210/06, 211/06 e 258/07 e alterações Portaria DENATRAN 63/09 e 59/07 e alterações ",Transitar com o veículo com excesso de peso - PBT/PBTC,65,5,202105,181311,181246,65
6407641b305a576376e6f3c8,CMT - Capacidade Máxima de Tração,MAIO,2021,RJ,"Lei 9503/97 Lei 10561/02 Res. CONTRAN nº 210/06, 211/06 e 258/07 e alterações Portaria DENATRAN 63/09 e 59/07 e alterações ",Transitar com o veículo excedendo a CMT acima de 1000 kg,4,5,202105,177561,177557,4
6407641b305a576376e6f3c7,CMT - Capacidade Máxima de Tração,MAIO,2021,RJ,"Lei 9503/97 Lei 10561/02 Res. CONTRAN nº 210/06, 211/06 e 258/07 e alterações Portaria DENATRAN 63/09 e 59/07 e alterações ",Transitar com o veículo excedendo a CMT em até 600 kg,3,5,202105,177557,177554,3
6407641b305a576376e6f3eb,Excesso de Peso,MAIO,2021,SP,"Lei 9503/97 Lei 10561/02 Res. CONTRAN nº 210/06, 211/06 e 258/07 e alterações Portaria DENATRAN 63/09 e 59/07 e alterações ",Transitar com o veículo com excesso de peso - PBT/PBTC,55,5,202105,37227,37172,55
6407641b305a576376e6f3e9,Excesso de Peso,MAIO,2021,SC,"Lei 9503/97 Lei 10561/02 Res. CONTRAN nº 210/06, 211/06 e 258/07 e alterações Portaria DENATRAN 63/09 e 59/07 e alterações ",Transitar com o veículo com excesso de peso - Por Eixo,794,5,202105,37172,36378,794
6407641b305a576376e6f3e0,Excesso de Peso,MAIO,2021,PR,"Lei 9503/97 Lei 10561/02 Res. CONTRAN nº 210/06, 211/06 e 258/07 e alterações Portaria DENATRAN 63/09 e 59/07 e alterações ",Transitar com o veículo com excesso de peso - Por Eixo,540,5,202105,36378,35838,540
6407641b305a576376e6f3dc,Excesso de Peso,MAIO,2021,MS,"Lei 9503/97 Lei 10561/02 Res. CONTRAN nº 210/06, 211/06 e 258/07 e alterações Portaria DENATRAN 63/09 e 59/07 e alterações ",Transitar com o veículo com excesso de peso - PBT/PBTC e Por Eixo,32,5,202105,35838,35806,32
6407641b305a576376e6f3d9,Excesso de Peso,MAIO,2021,MG,"Lei 9503/97 Lei 10561/02 Res. CONTRAN nº 210/06, 211/06 e 258/07 e alterações Portaria DENATRAN 63/09 e 59/07 e alterações ",Transitar com o veículo com excesso de peso - PBT/PBTC e Por Eixo,282,5,202105,35806,35524,282
6407641b305a576376e6f3c3,CMT - Capacidade Máxima de Tração,MAIO,2021,MG,"Lei 9503/97 Lei 10561/02 Res. CONTRAN nº 210/06, 211/06 e 258/07 e alterações Portaria DENATRAN 63/09 e 59/07 e alterações ",Transitar com o veículo excedendo a CMT entre 601 e 1000 kg,1,5,202105,35524,35523,1
6407641b305a576376e6f3e7,Excesso de Peso,MAIO,2021,SC,"Lei 9503/97 Lei 10561/02 Res. CONTRAN nº 210/06, 211/06 e 258/07 e alterações Portaria DENATRAN 63/09 e 59/07 e alterações ",Transitar com o veículo com excesso de peso - PBT/PBTC,119,5,202105,29300,29181,119
6407641b305a576376e6f3e6,Excesso de Peso,MAIO,2021,RS,"Lei 9503/97 Lei 10561/02 Res. CONTRAN nº 210/06, 211/06 e 258/07 e alterações Portaria DENATRAN 63/09 e 59/07 e alterações ",Transitar com o veículo com excesso de peso - Por Eixo,568,5,202105,29181,28613,568
6407641b305a576376e6f3e5,Excesso de Peso,MAIO,2021,RS,"Lei 9503/97 Lei 10561/02 Res. CONTRAN nº 210/06, 211/06 e 258/07 e alterações Portaria DENATRAN 63/09 e 59/07 e alterações ",Transitar com o veículo com excesso de peso - PBT/PBTC e Por Eixo,72,5,202105,28613,28541,72
6407641b305a576376e6f3e4,Excesso de Peso,MAIO,2021,RS,"Lei 9503/97 Lei 10561/02 Res. CONTRAN nº 210/06, 211/06 e 258/07 e alterações Portaria DENATRAN 63/09 e 59/07 e alterações ",Transitar com o veículo com excesso de peso - PBT/PBTC,47,5,202105,28541,28494,47
6407641b305a576376e6f3e3,Excesso de Peso,MAIO,2021,RJ,"Lei 9503/97 Lei 10561/02 Res. CONTRAN nº 210/06, 211/06 e 258/07 e alterações Portaria DENATRAN 63/09 e 59/07 e alterações ",Transitar com o veículo com excesso de peso - Por Eixo,3110,5,202105,28494,25384,3110
6407641b305a576376e6f3e2,Excesso de Peso,MAIO,2021,RJ,"Lei 9503/97 Lei 10561/02 Res. CONTRAN nº 210/06, 211/06 e 258/07 e alterações Portaria DENATRAN 63/09 e 59/07 e alterações ",Transitar com o veículo com excesso de peso - PBT/PBTC e Por Eixo,445,5,202105,25384,24939,445
6407641b305a576376e6f3e1,Excesso de Peso,MAIO,2021,RJ,"Lei 9503/97 Lei 10561/02 Res. CONTRAN nº 210/06, 211/06 e 258/07 e alterações Portaria DENATRAN 63/09 e 59/07 e alterações ",Transitar com o veículo com excesso de peso - PBT/PBTC,365,5,202105,24939,24574,365
6407641b305a576376e6f3ea,Excesso de Peso,MAIO,2021,SP,"Lei 9503/97 Lei 10561/02 Res. CONTRAN nº 210/06, 211/06 e 258/07 e alterações Portaria DENATRAN 63/09 e 59/07 e alterações ",Transitar com o veículo com excesso de peso - PBT/PBTC e Por Eixo,45,5,202105,29345,29300,45
6407641b305a576376e6f3d7,Excesso de Peso,MAIO,2021,MG,,"Realizar transporte permissionado de passageiros, sem a emissão de bilhete.",1,5,202105,24483,24482,1
6407641b305a576376e6f3ec,Excesso de Peso,MAIO,2021,SP,"Lei 9503/97 Lei 10561/02 Res. CONTRAN nº 210/06, 211/06 e 258/07 e alterações Portaria DENATRAN 63/09 e 59/07 e alterações ",Transitar com o veículo com excesso de peso - Por Eixo,384,5,202105,181906,181522,384
6407641b305a576376e6f3c4,CMT - Capacidade Máxima de Tração,MAIO,2021,MG,"Lei 9503/97 Lei 10561/02 Res. CONTRAN nº 210/06, 211/06 e 258/07 e alterações Portaria DENATRAN 63/09 e 59/07 e alterações ",Transitar com o veículo excedendo a CMT acima de 1000 kg,5,5,202105,23128,23123,5
6407641b305a576376e6f3c5,CMT - Capacidade Máxima de Tração,MAIO,2021,PR,"Lei 9503/97 Lei 10561/02 Res. CONTRAN nº 210/06, 211/06 e 258/07 e alterações Portaria DENATRAN 63/09 e 59/07 e alterações ",Transitar com o veículo excedendo a CMT acima de 1000 kg,1,5,202105,23129,23128,1
6407641b305a576376e6f3dd,Excesso de Peso,MAIO,2021,MS,"Lei 9503/97 Lei 10561/02 Res. CONTRAN nº 210/06, 211/06 e 258/07 e alterações Portaria DENATRAN 63/09 e 59/07 e alterações ",Transitar com o veículo com excesso de peso - Por Eixo,91,5,202105,24574,24483,91
6407641b305a576376e6f3ce,Evasão de Balança,MAIO,2021,SP,"Lei 9503 DE 23/09/1997 Transpor, sem autorização, bloqueio viário com ou sem sinalização ou dispositivos auxiliares, deixar de adentrar às áreas destinadas à pesagem de veículos ou evadir-se para não efetuar o pagamento do pedágio.",Art. 209 Deixar de adentrar as áreas destinadas à pesagem de veículos,1305,5,202105,179907,178602,1305
6407641b305a576376e6f3e8,Excesso de Peso,MAIO,2021,SC,"Lei 9503/97 Lei 10561/02 Res. CONTRAN nº 210/06, 211/06 e 258/07 e alterações Portaria DENATRAN 63/09 e 59/07 e alterações ",Transitar com o veículo com excesso de peso - PBT/PBTC e Por Eixo,211,5,202105,181522,181311,211
6407641b305a576376e6f3da,Excesso de Peso,MAIO,2021,MG,"Lei 9503/97 Lei 10561/02 Res. CONTRAN nº 210/06, 211/06 e 258/07 e alterações Portaria DENATRAN 63/09 e 59/07 e alterações ",Transitar com o veículo com excesso de peso - Por Eixo,1339,5,202105,181246,179907,1339
6407641b305a576376e6f3cc,Evasão de Balança,MAIO,2021,MG,"Lei 9503 DE 23/09/1997 Transpor, sem autorização, bloqueio viário com ou sem sinalização ou dispositivos auxiliares, deixar de adentrar às áreas destinadas à pesagem de veículos ou evadir-se para não efetuar o pagamento do pedágio.",Art. 209 Deixar de adentrar as áreas destinadas à pesagem de veículos,1041,5,202105,178602,177561,1041
6407641b305a576376e6f3c9,CMT - Capacidade Máxima de Tração,MAIO,2021,SC,"Lei 9503/97 Lei 10561/02 Res. CONTRAN nº 210/06, 211/06 e 258/07 e alterações Portaria DENATRAN 63/09 e 59/07 e alterações ",Transitar com o veículo excedendo a CMT acima de 1000 kg,1,5,202105,23130,23129,1
6407641b305a576376e6f3cf,Excesso de Peso,MAIO,2021,BA,"Lei 9503/97 Lei 10561/02 Res. CONTRAN nº 210/06, 211/06 e 258/07 e alterações Portaria DENATRAN 63/09 e 59/07 e alterações ",Transitar com o veículo com excesso de peso - PBT/PBTC,6,5,202105,23136,23130,6
6407641b305a576376e6f3d1,Excesso de Peso,MAIO,2021,ES,"Lei 9503/97 Lei 10561/02 Res. CONTRAN nº 210/06, 211/06 e 258/07 e alterações Portaria DENATRAN 63/09 e 59/07 e alterações ",Transitar com o veículo com excesso de peso - PBT/PBTC,157,5,202105,23293,23136,157
6407641b305a576376e6f3d2,Excesso de Peso,MAIO,2021,ES,"Lei 9503/97 Lei 10561/02 Res. CONTRAN nº 210/06, 211/06 e 258/07 e alterações Portaria DENATRAN 63/09 e 59/07 e alterações ",Transitar com o veículo com excesso de peso - Por Eixo,1170,5,202105,24463,23293,1170
6407641b305a576376e6f3d4,Excesso de Peso,MAIO,2021,GO,"Lei 9503/97 Lei 10561/02 Res. CONTRAN nº 210/06, 211/06 e 258/07 e alterações Portaria DENATRAN 63/09 e 59/07 e alterações ",Transitar com o veículo com excesso de peso - PBT/PBTC,19,5,202105,24482,24463,19
6407641b305a576376e6f3f6,Evasão de Balança,JUNHO,2021,RJ,"Lei 9503 DE 23/09/1997 Transpor, sem autorização, bloqueio viário com ou sem sinalização ou dispositivos auxiliares, deixar de adentrar às áreas destinadas à pesagem de veículos ou evadir-se para não efetuar o pagamento do pedágio.",Art. 209 Deixar de adentrar as áreas destinadas à pesagem de veículos,4073,6,202106,41312,37239,4073
6407641b305a576376e6f3f1,CMT - Capacidade Máxima de Tração,JUNHO,2021,RJ,"Lei 9503/97 Lei 10561/02 Res. CONTRAN nº 210/06, 211/06 e 258/07 e alterações Portaria DENATRAN 63/09 e 59/07 e alterações ",Transitar com o veículo excedendo a CMT acima de 1000 kg,5,6,202106,37237,37232,5
6407641b305a576376e6f3ef,CMT - Capacidade Máxima de Tração,JUNHO,2021,MG,"Lei 9503/97 Lei 10561/02 Res. CONTRAN nº 210/06, 211/06 e 258/07 e alterações Portaria DENATRAN 63/09 e 59/07 e alterações ",Transitar com o veículo excedendo a CMT acima de 1000 kg,3,6,202106,37232,37229,3
6407641b305a576376e6f3ee,CMT - Capacidade Máxima de Tração,JUNHO,2021,MG,"Lei 9503/97 Lei 10561/02 Res. CONTRAN nº 210/06, 211/06 e 258/07 e alterações Portaria DENATRAN 63/09 e 59/07 e alterações ",Transitar com o veículo excedendo a CMT entre 601 e 1000 kg,2,6,202106,37229,37227,2
6407641b305a576376e6f3fd,Excesso de Peso,JUNHO,2021,GO,"Lei 9503/97 Lei 10561/02 Res. CONTRAN nº 210/06, 211/06 e 258/07 e alterações Portaria DENATRAN 63/09 e 59/07 e alterações ",Transitar com o veículo com excesso de peso - PBT/PBTC,14,6,202106,41326,41312,14
6407641b305a576376e6f3f2,CMT - Capacidade Máxima de Tração,JUNHO,2021,SP,"Lei 9503/97 Lei 10561/02 Res. CONTRAN nº 210/06, 211/06 e 258/07 e alterações Portaria DENATRAN 63/09 e 59/07 e alterações ",Transitar com o veículo excedendo a CMT acima de 1000 kg,2,6,202106,37239,37237,2
6407641b305a576376e6f413,Excesso de Peso,JUNHO,2021,SP,"Lei 9503/97 Lei 10561/02 Res. CONTRAN nº 210/06, 211/06 e 258/07 e alterações Portaria DENATRAN 63/09 e 59/07 e alterações ",Transitar com o veículo com excesso de peso - PBT/PBTC e Por Eixo,115,6,202106,30162,30047,115
6407641b305a576376e6f40a,Excesso de Peso,JUNHO,2021,RJ,"Lei 9503/97 Lei 10561/02 Res. CONTRAN nº 210/06, 211/06 e 258/07 e alterações Portaria DENATRAN 63/09 e 59/07 e alterações ",Transitar com o veículo com excesso de peso - PBT/PBTC e Por Eixo,353,6,202106,29882,29529,353
6407641b305a576376e6f3fe,Excesso de Peso,JUNHO,2021,GO,"Lei 9503/97 Lei 10561/02 Res. CONTRAN nº 210/06, 211/06 e 258/07 e alterações Portaria DENATRAN 63/09 e 59/07 e alterações ",Transitar com o veículo com excesso de peso - Por Eixo,92,6,202106,29529,29437,92
6407641b305a576376e6f3fc,Excesso de Peso,JUNHO,2021,GO,,"Realizar transporte permissionado de passageiros, sem a emissão de bilhete.",5,6,202106,29437,29432,5
6407641b305a576376e6f3f9,Excesso de Peso,JUNHO,2021,ES,"Lei 9503/97 Lei 10561/02 Res. CONTRAN nº 210/06, 211/06 e 258/07 e alterações Portaria DENATRAN 63/09 e 59/07 e alterações ",Transitar com o veículo com excesso de peso - PBT/PBTC e Por Eixo,84,6,202106,29432,29348,84
6407641b305a576376e6f3f8,Excesso de Peso,JUNHO,2021,BA,"Lei 9503/97 Lei 10561/02 Res. CONTRAN nº 210/06, 211/06 e 258/07 e alterações Portaria DENATRAN 63/09 e 59/07 e alterações ",Transitar com o veículo com excesso de peso - PBT/PBTC,1,6,202106,29348,29347,1
6407641b305a576376e6f3ed,CMT - Capacidade Máxima de Tração,JUNHO,2021,ES,"Lei 9503/97 Lei 10561/02 Res. CONTRAN nº 210/06, 211/06 e 258/07 e alterações Portaria DENATRAN 63/09 e 59/07 e alterações ",Transitar com o veículo excedendo a CMT acima de 1000 kg,2,6,202106,29347,29345,2
6407641b305a576376e6f400,Excesso de Peso,JUNHO,2021,MG,,"Realizar transporte permissionado de passageiros, sem a emissão de bilhete.",3,6,202106,41329,41326,3
6407641b305a576376e6f410,Excesso de Peso,JUNHO,2021,SC,"Lei 9503/97 Lei 10561/02 Res. CONTRAN nº 210/06, 211/06 e 258/07 e alterações Portaria DENATRAN 63/09 e 59/07 e alterações ",Transitar com o veículo com excesso de peso - PBT/PBTC e Por Eixo,165,6,202106,30047,29882,165
6407641b305a576376e6f402,Excesso de Peso,JUNHO,2021,MG,"Lei 9503/97 Lei 10561/02 Res. CONTRAN nº 210/06, 211/06 e 258/07 e alterações Portaria DENATRAN 63/09 e 59/07 e alterações ",Transitar com o veículo com excesso de peso - PBT/PBTC e Por Eixo,653,6,202106,41982,41329,653
6407641b305a576376e6f40c,Excesso de Peso,JUNHO,2021,RJ,"Lei 9503/97 Lei 10561/02 Res. CONTRAN nº 210/06, 211/06 e 258/07 e alterações Portaria DENATRAN 63/09 e 59/07 e alterações ",Transitar com o veículo com excesso de peso - Por Eixo,2117,6,202106,45008,42891,2117
6407641b305a576376e6f408,Excesso de Peso,JUNHO,2021,PR,"Lei 9503/97 Lei 10561/02 Res. CONTRAN nº 210/06, 211/06 e 258/07 e alterações Portaria DENATRAN 63/09 e 59/07 e alterações ",Transitar com o veículo com excesso de peso - PBT/PBTC e Por Eixo,128,6,202106,42891,42763,128
6407641b305a576376e6f3f0,CMT - Capacidade Máxima de Tração,JUNHO,2021,RJ,"Lei 9503/97 Lei 10561/02 Res. CONTRAN nº 210/06, 211/06 e 258/07 e alterações Portaria DENATRAN 63/09 e 59/07 e alterações ",Transitar com o veículo excedendo a CMT em até 600 kg,4,6,202106,181910,181906,4
6407641b305a576376e6f3fa,Excesso de Peso,JUNHO,2021,ES,"Lei 9503/97 Lei 10561/02 Res. CONTRAN nº 210/06, 211/06 e 258/07 e alterações Portaria DENATRAN 63/09 e 59/07 e alterações ",Transitar com o veículo com excesso de peso - PBT/PBTC,135,6,202106,182045,181910,135
6407641b305a576376e6f404,Excesso de Peso,JUNHO,2021,MS,"Lei 9503/97 Lei 10561/02 Res. CONTRAN nº 210/06, 211/06 e 258/07 e alterações Portaria DENATRAN 63/09 e 59/07 e alterações ",Transitar com o veículo com excesso de peso - PBT/PBTC,11,6,202106,182056,182045,11
6407641b305a576376e6f405,Excesso de Peso,JUNHO,2021,MS,"Lei 9503/97 Lei 10561/02 Res. CONTRAN nº 210/06, 211/06 e 258/07 e alterações Portaria DENATRAN 63/09 e 59/07 e alterações ",Transitar com o veículo com excesso de peso - PBT/PBTC e Por Eixo,22,6,202106,182078,182056,22
6407641b305a576376e6f409,Excesso de Peso,JUNHO,2021,PR,"Lei 9503/97 Lei 10561/02 Res. CONTRAN nº 210/06, 211/06 e 258/07 e alterações Portaria DENATRAN 63/09 e 59/07 e alterações ",Transitar com o veículo com excesso de peso - Por Eixo,444,6,202106,182522,182078,444
6407641b305a576376e6f40d,Excesso de Peso,JUNHO,2021,RS,"Lei 9503/97 Lei 10561/02 Res. CONTRAN nº 210/06, 211/06 e 258/07 e alterações Portaria DENATRAN 63/09 e 59/07 e alterações ",Transitar com o veículo com excesso de peso - PBT/PBTC e Por Eixo,24,6,202106,182546,182522,24
6407641b305a576376e6f403,Excesso de Peso,JUNHO,2021,MG,"Lei 9503/97 Lei 10561/02 Res. CONTRAN nº 210/06, 211/06 e 258/07 e alterações Portaria DENATRAN 63/09 e 59/07 e alterações ",Transitar com o veículo com excesso de peso - Por Eixo,781,6,202106,42763,41982,781
6407641b305a576376e6f40e,Excesso de Peso,JUNHO,2021,RS,"Lei 9503/97 Lei 10561/02 Res. CONTRAN nº 210/06, 211/06 e 258/07 e alterações Portaria DENATRAN 63/09 e 59/07 e alterações ",Transitar com o veículo com excesso de peso - PBT/PBTC,50,6,202106,133516,133466,50
6407641b305a576376e6f40b,Excesso de Peso,JUNHO,2021,RJ,"Lei 9503/97 Lei 10561/02 Res. CONTRAN nº 210/06, 211/06 e 258/07 e alterações Portaria DENATRAN 63/09 e 59/07 e alterações ",Transitar com o veículo com excesso de peso - PBT/PBTC,442,6,202106,133466,133024,442
6407641b305a576376e6f407,Excesso de Peso,JUNHO,2021,PR,"Lei 9503/97 Lei 10561/02 Res. CONTRAN nº 210/06, 211/06 e 258/07 e alterações Portaria DENATRAN 63/09 e 59/07 e alterações ",Transitar com o veículo com excesso de peso - PBT/PBTC,125,6,202106,133024,132899,125
6407641b305a576376e6f406,Excesso de Peso,JUNHO,2021,MS,"Lei 9503/97 Lei 10561/02 Res. CONTRAN nº 210/06, 211/06 e 258/07 e alterações Portaria DENATRAN 63/09 e 59/07 e alterações ",Transitar com o veículo com excesso de peso - Por Eixo,52,6,202106,132899,132847,52
6407641b305a576376e6f411,Excesso de Peso,JUNHO,2021,SC,"Lei 9503/97 Lei 10561/02 Res. CONTRAN nº 210/06, 211/06 e 258/07 e alterações Portaria DENATRAN 63/09 e 59/07 e alterações ",Transitar com o veículo com excesso de peso - PBT/PBTC,189,6,202106,45279,45090,189
6407641b305a576376e6f3ff,Excesso de Peso,JUNHO,2021,GO,"Lei 9503/97 Lei 10561/02 Res. CONTRAN nº 210/06, 211/06 e 258/07 e alterações Portaria DENATRAN 63/09 e 59/07 e alterações ",Transitar com o veículo com excesso de peso - PBT/PBTC e Por Eixo,256,6,202106,132673,132417,256
6407641b305a576376e6f3fb,Excesso de Peso,JUNHO,2021,ES,"Lei 9503/97 Lei 10561/02 Res. CONTRAN nº 210/06, 211/06 e 258/07 e alterações Portaria DENATRAN 63/09 e 59/07 e alterações ",Transitar com o veículo com excesso de peso - Por Eixo,593,6,202106,132417,131824,593
6407641b305a576376e6f3f7,Evasão de Balança,JUNHO,2021,SP,"Lei 9503 DE 23/09/1997 Transpor, sem autorização, bloqueio viário com ou sem sinalização ou dispositivos auxiliares, deixar de adentrar às áreas destinadas à pesagem de veículos ou evadir-se para não efetuar o pagamento do pedágio.",Art. 209 Deixar de adentrar as áreas destinadas à pesagem de veículos,804,6,202106,131824,131020,804
6407641b305a576376e6f40f,Excesso de Peso,JUNHO,2021,RS,"Lei 9503/97 Lei 10561/02 Res. CONTRAN nº 210/06, 211/06 e 258/07 e alterações Portaria DENATRAN 63/09 e 59/07 e alterações ",Transitar com o veículo com excesso de peso - Por Eixo,82,6,202106,45090,45008,82
6407641b305a576376e6f414,Excesso de Peso,JUNHO,2021,SP,"Lei 9503/97 Lei 10561/02 Res. CONTRAN nº 210/06, 211/06 e 258/07 e alterações Portaria DENATRAN 63/09 e 59/07 e alterações ",Transitar com o veículo com excesso de peso - PBT/PBTC,138,6,202106,45417,45279,138
6407641b305a576376e6f415,Excesso de Peso,JUNHO,2021,SP,"Lei 9503/97 Lei 10561/02 Res. CONTRAN nº 210/06, 211/06 e 258/07 e alterações Portaria DENATRAN 63/09 e 59/07 e alterações ",Transitar com o veículo com excesso de peso - Por Eixo,536,6,202106,45953,45417,536
6407641b305a576376e6f3f5,Evasão de Balança,JUNHO,2021,MG,"Lei 9503 DE 23/09/1997 Transpor, sem autorização, bloqueio viário com ou sem sinalização ou dispositivos auxiliares, deixar de adentrar às áreas destinadas à pesagem de veículos ou evadir-se para não efetuar o pagamento do pedágio.",Art. 209 Deixar de adentrar as áreas destinadas à pesagem de veículos,1744,6,202106,131020,129276,1744
6407641b305a576376e6f412,Excesso de Peso,JUNHO,2021,SC,"Lei 9503/97 Lei 10561/02 Res. CONTRAN nº 210/06, 211/06 e 258/07 e alterações Portaria DENATRAN 63/09 e 59/07 e alterações ",Transitar com o veículo com excesso de peso - Por Eixo,702,6,202106,183248,182546,702
6407641b305a576376e6f3f3,Evasão de Balança,JUNHO,2021,ES,"Lei 9503 DE 23/09/1997 Transpor, sem autorização, bloqueio viário com ou sem sinalização ou dispositivos auxiliares, deixar de adentrar às áreas destinadas à pesagem de veículos ou evadir-se para não efetuar o pagamento do pedágio.",Art. 209 Deixar de adentrar as áreas destinadas à pesagem de veículos,415,6,202106,128314,127899,415
6407641b305a576376e6f3f4,Evasão de Balança,JUNHO,2021,GO,"Lei 9503 DE 23/09/1997 Transpor, sem autorização, bloqueio viário com ou sem sinalização ou dispositivos auxiliares, deixar de adentrar às áreas destinadas à pesagem de veículos ou evadir-se para não efetuar o pagamento do pedágio.",Art. 209 Deixar de adentrar as áreas destinadas à pesagem de veículos,962,6,202106,129276,128314,962
6407641b305a576376e6f401,Excesso de Peso,JUNHO,2021,MG,"Lei 9503/97 Lei 10561/02 Res. CONTRAN nº 210/06, 211/06 e 258/07 e alterações Portaria DENATRAN 63/09 e 59/07 e alterações ",Transitar com o veículo com excesso de peso - PBT/PBTC,174,6,202106,132847,132673,174
6407641b305a576376e6f416,CMT - Capacidade Máxima de Tração,JULHO,2021,MG,"Lei 9503/97 Lei 10561/02 Res. CONTRAN nº 210/06, 211/06 e 258/07 e alterações Portaria DENATRAN 63/09 e 59/07 e alterações ",Transitar com o veículo excedendo a CMT em até 600 kg,2,7,202107,183250,183248,2
6407641b305a576376e6f42f,Excesso de Peso,JULHO,2021,MS,"Lei 9503/97 Lei 10561/02 Res. CONTRAN nº 210/06, 211/06 e 258/07 e alterações Portaria DENATRAN 63/09 e 59/07 e alterações ",Transitar com o veículo com excesso de peso - Por Eixo,14,7,202107,183595,183581,14
6407641b305a576376e6f431,Excesso de Peso,JULHO,2021,PR,"Lei 9503/97 Lei 10561/02 Res. CONTRAN nº 210/06, 211/06 e 258/07 e alterações Portaria DENATRAN 63/09 e 59/07 e alterações ",Transitar com o veículo com excesso de peso - PBT/PBTC,161,7,202107,183756,183595,161
6407641b305a576376e6f434,Excesso de Peso,JULHO,2021,RJ,"Lei 9503/97 Lei 10561/02 Res. CONTRAN nº 210/06, 211/06 e 258/07 e alterações Portaria DENATRAN 63/09 e 59/07 e alterações ",Transitar com o veículo com excesso de peso - PBT/PBTC,425,7,202107,184181,183756,425
6407641b305a576376e6f435,Excesso de Peso,JULHO,2021,RJ,"Lei 9503/97 Lei 10561/02 Res. CONTRAN nº 210/06, 211/06 e 258/07 e alterações Portaria DENATRAN 63/09 e 59/07 e alterações ",Transitar com o veículo com excesso de peso - Por Eixo,2077,7,202107,186258,184181,2077
6407641b305a576376e6f43c,Excesso de Peso,JULHO,2021,SP,"Lei 9503/97 Lei 10561/02 Res. CONTRAN nº 210/06, 211/06 e 258/07 e alterações Portaria DENATRAN 63/09 e 59/07 e alterações ",Transitar com o veículo com excesso de peso - PBT/PBTC,108,7,202107,135434,135326,108
6407641b305a576376e6f43e,Excesso de Peso,JULHO,2021,SP,"Lei 9503/97 Lei 10561/02 Res. CONTRAN nº 210/06, 211/06 e 258/07 e alterações Portaria DENATRAN 63/09 e 59/07 e alterações ",Transitar com o veículo com excesso de peso - Por Eixo,561,7,202107,187617,187056,561
6407641b305a576376e6f438,Excesso de Peso,JULHO,2021,RS,"Lei 9503/97 Lei 10561/02 Res. CONTRAN nº 210/06, 211/06 e 258/07 e alterações Portaria DENATRAN 63/09 e 59/07 e alterações ",Transitar com o veículo com excesso de peso - Por Eixo,223,7,202107,135326,135103,223
6407641b305a576376e6f42e,Excesso de Peso,JULHO,2021,MS,"Lei 9503/97 Lei 10561/02 Res. CONTRAN nº 210/06, 211/06 e 258/07 e alterações Portaria DENATRAN 63/09 e 59/07 e alterações ",Transitar com o veículo com excesso de peso - PBT/PBTC e Por Eixo,4,7,202107,135103,135099,4
6407641b305a576376e6f42a,Excesso de Peso,JULHO,2021,MG,"Lei 9503/97 Lei 10561/02 Res. CONTRAN nº 210/06, 211/06 e 258/07 e alterações Portaria DENATRAN 63/09 e 59/07 e alterações ",Transitar com o veículo com excesso de peso - PBT/PBTC,254,7,202107,135099,134845,254
6407641b305a576376e6f428,Excesso de Peso,JULHO,2021,GO,"Lei 9503/97 Lei 10561/02 Res. CONTRAN nº 210/06, 211/06 e 258/07 e alterações Portaria DENATRAN 63/09 e 59/07 e alterações ",Transitar com o veículo com excesso de peso - Por Eixo,317,7,202107,134845,134528,317
6407641b305a576376e6f423,Excesso de Peso,JULHO,2021,ES,"Lei 9503/97 Lei 10561/02 Res. CONTRAN nº 210/06, 211/06 e 258/07 e alterações Portaria DENATRAN 63/09 e 59/07 e alterações ",Transitar com o veículo com excesso de peso - PBT/PBTC,112,7,202107,134528,134416,112
6407641b305a576376e6f421,Evasão de Balança,JULHO,2021,SP,"Lei 9503 DE 23/09/1997 Transpor, sem autorização, bloqueio viário com ou sem sinalização ou dispositivos auxiliares, deixar de adentrar às áreas destinadas à pesagem de veículos ou evadir-se para não efetuar o pagamento do pedágio.",Art. 209 Deixar de adentrar as áreas destinadas à pesagem de veículos,832,7,202107,134353,133521,832
6407641b305a576376e6f41b,CMT - Capacidade Máxima de Tração,JULHO,2021,RJ,"Lei 9503/97 Lei 10561/02 Res. CONTRAN nº 210/06, 211/06 e 258/07 e alterações Portaria DENATRAN 63/09 e 59/07 e alterações ",Transitar com o veículo excedendo a CMT em até 600 kg,4,7,202107,133521,133517,4
6407641b305a576376e6f419,CMT - Capacidade Máxima de Tração,JULHO,2021,RJ,"Lei 9503/97 Lei 10561/02 Res. CONTRAN nº 210/06, 211/06 e 258/07 e alterações Portaria DENATRAN 63/09 e 59/07 e alterações ",Transitar com o veículo excedendo a CMT entre 601 e 1000 kg,1,7,202107,133517,133516,1
6407641b305a576376e6f43b,Excesso de Peso,JULHO,2021,SC,"Lei 9503/97 Lei 10561/02 Res. CONTRAN nº 210/06, 211/06 e 258/07 e alterações Portaria DENATRAN 63/09 e 59/07 e alterações ",Transitar com o veículo com excesso de peso - Por Eixo,798,7,202107,187056,186258,798
6407641b305a576376e6f422,Excesso de Peso,JULHO,2021,ES,"Lei 9503/97 Lei 10561/02 Res. CONTRAN nº 210/06, 211/06 e 258/07 e alterações Portaria DENATRAN 63/09 e 59/07 e alterações ",Transitar com o veículo com excesso de peso - PBT/PBTC e Por Eixo,63,7,202107,134416,134353,63
6407641b305a576376e6f42b,Excesso de Peso,JULHO,2021,MG,"Lei 9503/97 Lei 10561/02 Res. CONTRAN nº 210/06, 211/06 e 258/07 e alterações Portaria DENATRAN 63/09 e 59/07 e alterações ",Transitar com o veículo com excesso de peso - PBT/PBTC e Por Eixo,328,7,202107,183581,183253,328
6407641b305a576376e6f426,Excesso de Peso,JULHO,2021,GO,"Lei 9503/97 Lei 10561/02 Res. CONTRAN nº 210/06, 211/06 e 258/07 e alterações Portaria DENATRAN 63/09 e 59/07 e alterações ",Transitar com o veículo com excesso de peso - PBT/PBTC,56,7,202107,55344,55288,56
6407641b305a576376e6f41f,Evasão de Balança,JULHO,2021,MG,"Lei 9503 DE 23/09/1997 Transpor, sem autorização, bloqueio viário com ou sem sinalização ou dispositivos auxiliares, deixar de adentrar às áreas destinadas à pesagem de veículos ou evadir-se para não efetuar o pagamento do pedágio.",Art. 209 Deixar de adentrar as áreas destinadas à pesagem de veículos,1023,7,202107,55288,54265,1023
6407641b305a576376e6f41a,CMT - Capacidade Máxima de Tração,JULHO,2021,RJ,"Lei 9503/97 Lei 10561/02 Res. CONTRAN nº 210/06, 211/06 e 258/07 e alterações Portaria DENATRAN 63/09 e 59/07 e alterações ",Transitar com o veículo excedendo a CMT acima de 1000 kg,3,7,202107,183253,183250,3
6407641b305a576376e6f41d,Evasão de Balança,JULHO,2021,ES,"Lei 9503 DE 23/09/1997 Transpor, sem autorização, bloqueio viário com ou sem sinalização ou dispositivos auxiliares, deixar de adentrar às áreas destinadas à pesagem de veículos ou evadir-se para não efetuar o pagamento do pedágio.",Art. 209 Deixar de adentrar as áreas destinadas à pesagem de veículos,63,7,202107,54265,54202,63
6407641b305a576376e6f432,Excesso de Peso,JULHO,2021,PR,"Lei 9503/97 Lei 10561/02 Res. CONTRAN nº 210/06, 211/06 e 258/07 e alterações Portaria DENATRAN 63/09 e 59/07 e alterações ",Transitar com o veículo com excesso de peso - Por Eixo,670,7,202107,54202,53532,670
6407641b305a576376e6f42d,Excesso de Peso,JULHO,2021,MS,"Lei 9503/97 Lei 10561/02 Res. CONTRAN nº 210/06, 211/06 e 258/07 e alterações Portaria DENATRAN 63/09 e 59/07 e alterações ",Transitar com o veículo com excesso de peso - PBT/PBTC,1,7,202107,53532,53531,1
6407641b305a576376e6f42c,Excesso de Peso,JULHO,2021,MG,"Lei 9503/97 Lei 10561/02 Res. CONTRAN nº 210/06, 211/06 e 258/07 e alterações Portaria DENATRAN 63/09 e 59/07 e alterações ",Transitar com o veículo com excesso de peso - Por Eixo,1564,7,202107,53531,51967,1564
6407641b305a576376e6f427,Excesso de Peso,JULHO,2021,GO,"Lei 9503/97 Lei 10561/02 Res. CONTRAN nº 210/06, 211/06 e 258/07 e alterações Portaria DENATRAN 63/09 e 59/07 e alterações ",Transitar com o veículo com excesso de peso - PBT/PBTC e Por Eixo,102,7,202107,51967,51865,102
6407641b305a576376e6f425,Excesso de Peso,JULHO,2021,GO,,"Realizar transporte permissionado de passageiros, sem a emissão de bilhete.",5,7,202107,51865,51860,5
6407641b305a576376e6f424,Excesso de Peso,JULHO,2021,ES,"Lei 9503/97 Lei 10561/02 Res. CONTRAN nº 210/06, 211/06 e 258/07 e alterações Portaria DENATRAN 63/09 e 59/07 e alterações ",Transitar com o veículo com excesso de peso - Por Eixo,257,7,202107,51860,51603,257
6407641b305a576376e6f420,Evasão de Balança,JULHO,2021,RJ,"Lei 9503 DE 23/09/1997 Transpor, sem autorização, bloqueio viário com ou sem sinalização ou dispositivos auxiliares, deixar de adentrar às áreas destinadas à pesagem de veículos ou evadir-se para não efetuar o pagamento do pedágio.",Art. 209 Deixar de adentrar as áreas destinadas à pesagem de veículos,5205,7,202107,51603,46398,5205
6407641b305a576376e6f41e,Evasão de Balança,JULHO,2021,GO,"Lei 9503 DE 23/09/1997 Transpor, sem autorização, bloqueio viário com ou sem sinalização ou dispositivos auxiliares, deixar de adentrar às áreas destinadas à pesagem de veículos ou evadir-se para não efetuar o pagamento do pedágio.",Art. 209 Deixar de adentrar as áreas destinadas à pesagem de veículos,437,7,202107,46398,45961,437
6407641b305a576376e6f43d,Excesso de Peso,JULHO,2021,SP,"Lei 9503/97 Lei 10561/02 Res. CONTRAN nº 210/06, 211/06 e 258/07 e alterações Portaria DENATRAN 63/09 e 59/07 e alterações ",Transitar com o veículo com excesso de peso - PBT/PBTC e Por Eixo,128,7,202107,56215,56087,128
6407641b305a576376e6f436,Excesso de Peso,JULHO,2021,RS,"Lei 9503/97 Lei 10561/02 Res. CONTRAN nº 210/06, 211/06 e 258/07 e alterações Portaria DENATRAN 63/09 e 59/07 e alterações ",Transitar com o veículo com excesso de peso - PBT/PBTC e Por Eixo,77,7,202107,55875,55798,77
6407641b305a576376e6f433,Excesso de Peso,JULHO,2021,RJ,"Lei 9503/97 Lei 10561/02 Res. CONTRAN nº 210/06, 211/06 e 258/07 e alterações Portaria DENATRAN 63/09 e 59/07 e alterações ",Transitar com o veículo com excesso de peso - PBT/PBTC e Por Eixo,316,7,202107,55798,55482,316
6407641b305a576376e6f430,Excesso de Peso,JULHO,2021,PR,"Lei 9503/97 Lei 10561/02 Res. CONTRAN nº 210/06, 211/06 e 258/07 e alterações Portaria DENATRAN 63/09 e 59/07 e alterações ",Transitar com o veículo com excesso de peso - PBT/PBTC e Por Eixo,137,7,202107,55482,55345,137
6407641b305a576376e6f43a,Excesso de Peso,JULHO,2021,SC,"Lei 9503/97 Lei 10561/02 Res. CONTRAN nº 210/06, 211/06 e 258/07 e alterações Portaria DENATRAN 63/09 e 59/07 e alterações ",Transitar com o veículo com excesso de peso - PBT/PBTC,212,7,202107,56087,55875,212
6407641b305a576376e6f418,CMT - Capacidade Máxima de Tração,JULHO,2021,PR,"Lei 9503/97 Lei 10561/02 Res. CONTRAN nº 210/06, 211/06 e 258/07 e alterações Portaria DENATRAN 63/09 e 59/07 e alterações ",Transitar com o veículo excedendo a CMT acima de 1000 kg,1,7,202107,30163,30162,1
6407641b305a576376e6f417,CMT - Capacidade Máxima de Tração,JULHO,2021,MG,"Lei 9503/97 Lei 10561/02 Res. CONTRAN nº 210/06, 211/06 e 258/07 e alterações Portaria DENATRAN 63/09 e 59/07 e alterações ",Transitar com o veículo excedendo a CMT acima de 1000 kg,7,7,202107,45960,45953,7
6407641b305a576376e6f41c,CMT - Capacidade Máxima de Tração,JULHO,2021,SC,"Lei 9503/97 Lei 10561/02 Res. CONTRAN nº 210/06, 211/06 e 258/07 e alterações Portaria DENATRAN 63/09 e 59/07 e alterações ",Transitar com o veículo excedendo a CMT acima de 1000 kg,1,7,202107,45961,45960,1
6407641b305a576376e6f437,Excesso de Peso,JULHO,2021,RS,"Lei 9503/97 Lei 10561/02 Res. CONTRAN nº 210/06, 211/06 e 258/07 e alterações Portaria DENATRAN 63/09 e 59/07 e alterações ",Transitar com o veículo com excesso de peso - PBT/PBTC,86,7,202107,72742,72656,86
6407641b305a576376e6f439,Excesso de Peso,JULHO,2021,SC,"Lei 9503/97 Lei 10561/02 Res. CONTRAN nº 210/06, 211/06 e 258/07 e alterações Portaria DENATRAN 63/09 e 59/07 e alterações ",Transitar com o veículo com excesso de peso - PBT/PBTC e Por Eixo,204,7,202107,72946,72742,204
6407641b305a576376e6f429,Excesso de Peso,JULHO,2021,MG,,"Realizar transporte permissionado de passageiros, sem a emissão de bilhete.",1,7,202107,55345,55344,1
6407641b305a576376e6f463,Excesso de Peso,AGOSTO,2021,RS,"Lei 9503/97 Lei 10561/02 Res. CONTRAN nº 210/06, 211/06 e 258/07 e alterações Portaria DENATRAN 63/09 e 59/07 e alterações ",Transitar com o veículo com excesso de peso - Por Eixo,443,8,202108,79047,78604,443
6407641b305a576376e6f462,Excesso de Peso,AGOSTO,2021,RS,"Lei 9503/97 Lei 10561/02 Res. CONTRAN nº 210/06, 211/06 e 258/07 e alterações Portaria DENATRAN 63/09 e 59/07 e alterações ",Transitar com o veículo com excesso de peso - PBT/PBTC,130,8,202108,61663,61533,130
6407641b305a576376e6f442,CMT - Capacidade Máxima de Tração,AGOSTO,2021,PR,"Lei 9503/97 Lei 10561/02 Res. CONTRAN nº 210/06, 211/06 e 258/07 e alterações Portaria DENATRAN 63/09 e 59/07 e alterações ",Transitar com o veículo excedendo a CMT entre 601 e 1000 kg,1,8,202108,72947,72946,1
6407641b305a576376e6f445,CMT - Capacidade Máxima de Tração,AGOSTO,2021,SC,"Lei 9503/97 Lei 10561/02 Res. CONTRAN nº 210/06, 211/06 e 258/07 e alterações Portaria DENATRAN 63/09 e 59/07 e alterações ",Transitar com o veículo excedendo a CMT acima de 1000 kg,2,8,202108,72951,72949,2
6407641b305a576376e6f449,Evasão de Balança,AGOSTO,2021,MG,"Lei 9503 DE 23/09/1997 Transpor, sem autorização, bloqueio viário com ou sem sinalização ou dispositivos auxiliares, deixar de adentrar às áreas destinadas à pesagem de veículos ou evadir-se para não efetuar o pagamento do pedágio.",Art. 209 Deixar de adentrar as áreas destinadas à pesagem de veículos,1853,8,202108,74804,72951,1853
6407641b305a576376e6f464,Excesso de Peso,AGOSTO,2021,SC,"Lei 9503/97 Lei 10561/02 Res. CONTRAN nº 210/06, 211/06 e 258/07 e alterações Portaria DENATRAN 63/09 e 59/07 e alterações ",Transitar com o veículo com excesso de peso - PBT/PBTC e Por Eixo,144,8,202108,79191,79047,144
6407641b305a576376e6f44b,Evasão de Balança,AGOSTO,2021,SP,"Lei 9503 DE 23/09/1997 Transpor, sem autorização, bloqueio viário com ou sem sinalização ou dispositivos auxiliares, deixar de adentrar às áreas destinadas à pesagem de veículos ou evadir-se para não efetuar o pagamento do pedágio.",Art. 209 Deixar de adentrar as áreas destinadas à pesagem de veículos,1614,8,202108,76418,74804,1614
6407641b305a576376e6f45f,Excesso de Peso,AGOSTO,2021,RJ,"Lei 9503/97 Lei 10561/02 Res. CONTRAN nº 210/06, 211/06 e 258/07 e alterações Portaria DENATRAN 63/09 e 59/07 e alterações ",Transitar com o veículo com excesso de peso - PBT/PBTC,350,8,202108,61533,61183,350
6407641b305a576376e6f45d,Excesso de Peso,AGOSTO,2021,PR,"Lei 9503/97 Lei 10561/02 Res. CONTRAN nº 210/06, 211/06 e 258/07 e alterações Portaria DENATRAN 63/09 e 59/07 e alterações ",Transitar com o veículo com excesso de peso - Por Eixo,561,8,202108,61183,60622,561
6407641b305a576376e6f454,Excesso de Peso,AGOSTO,2021,MG,,"Realizar transporte permissionado de passageiros, sem a emissão de bilhete.",4,8,202108,60622,60618,4
6407641b305a576376e6f44f,Excesso de Peso,AGOSTO,2021,ES,"Lei 9503/97 Lei 10561/02 Res. CONTRAN nº 210/06, 211/06 e 258/07 e alterações Portaria DENATRAN 63/09 e 59/07 e alterações ",Transitar com o veículo com excesso de peso - Por Eixo,247,8,202108,60618,60371,247
6407641b305a576376e6f44c,Excesso de Peso,AGOSTO,2021,BA,"Lei 9503/97 Lei 10561/02 Res. CONTRAN nº 210/06, 211/06 e 258/07 e alterações Portaria DENATRAN 63/09 e 59/07 e alterações ",Transitar com o veículo com excesso de peso - PBT/PBTC,13,8,202108,60371,60358,13
6407641b305a576376e6f44a,Evasão de Balança,AGOSTO,2021,RJ,"Lei 9503 DE 23/09/1997 Transpor, sem autorização, bloqueio viário com ou sem sinalização ou dispositivos auxiliares, deixar de adentrar às áreas destinadas à pesagem de veículos ou evadir-se para não efetuar o pagamento do pedágio.",Art. 209 Deixar de adentrar as áreas destinadas à pesagem de veículos,4143,8,202108,60358,56215,4143
6407641b305a576376e6f45c,Excesso de Peso,AGOSTO,2021,PR,"Lei 9503/97 Lei 10561/02 Res. CONTRAN nº 210/06, 211/06 e 258/07 e alterações Portaria DENATRAN 63/09 e 59/07 e alterações ",Transitar com o veículo com excesso de peso - PBT/PBTC,148,8,202108,78263,78115,148
6407641b305a576376e6f441,CMT - Capacidade Máxima de Tração,AGOSTO,2021,PR,"Lei 9503/97 Lei 10561/02 Res. CONTRAN nº 210/06, 211/06 e 258/07 e alterações Portaria DENATRAN 63/09 e 59/07 e alterações ",Transitar com o veículo excedendo a CMT em até 600 kg,1,8,202108,135435,135434,1
6407641b305a576376e6f45e,Excesso de Peso,AGOSTO,2021,RJ,"Lei 9503/97 Lei 10561/02 Res. CONTRAN nº 210/06, 211/06 e 258/07 e alterações Portaria DENATRAN 63/09 e 59/07 e alterações ",Transitar com o veículo com excesso de peso - PBT/PBTC e Por Eixo,260,8,202108,78523,78263,260
6407641b305a576376e6f461,Excesso de Peso,AGOSTO,2021,RS,"Lei 9503/97 Lei 10561/02 Res. CONTRAN nº 210/06, 211/06 e 258/07 e alterações Portaria DENATRAN 63/09 e 59/07 e alterações ",Transitar com o veículo com excesso de peso - PBT/PBTC e Por Eixo,81,8,202108,78604,78523,81
6407641b305a576376e6f457,Excesso de Peso,AGOSTO,2021,MG,"Lei 9503/97 Lei 10561/02 Res. CONTRAN nº 210/06, 211/06 e 258/07 e alterações Portaria DENATRAN 63/09 e 59/07 e alterações ",Transitar com o veículo com excesso de peso - Por Eixo,1697,8,202108,78115,76418,1697
6407641b305a576376e6f444,CMT - Capacidade Máxima de Tração,AGOSTO,2021,RJ,"Lei 9503/97 Lei 10561/02 Res. CONTRAN nº 210/06, 211/06 e 258/07 e alterações Portaria DENATRAN 63/09 e 59/07 e alterações ",Transitar com o veículo excedendo a CMT acima de 1000 kg,6,8,202108,135441,135435,6
6407641b305a576376e6f443,CMT - Capacidade Máxima de Tração,AGOSTO,2021,PR,"Lei 9503/97 Lei 10561/02 Res. CONTRAN nº 210/06, 211/06 e 258/07 e alterações Portaria DENATRAN 63/09 e 59/07 e alterações ",Transitar com o veículo excedendo a CMT acima de 1000 kg,2,8,202108,72949,72947,2
6407641b305a576376e6f447,Evasão de Balança,AGOSTO,2021,ES,"Lei 9503 DE 23/09/1997 Transpor, sem autorização, bloqueio viário com ou sem sinalização ou dispositivos auxiliares, deixar de adentrar às áreas destinadas à pesagem de veículos ou evadir-se para não efetuar o pagamento do pedágio.",Art. 209 Deixar de adentrar as áreas destinadas à pesagem de veículos,20,8,202108,135463,135443,20
6407641b305a576376e6f43f,CMT - Capacidade Máxima de Tração,AGOSTO,2021,MG,"Lei 9503/97 Lei 10561/02 Res. CONTRAN nº 210/06, 211/06 e 258/07 e alterações Portaria DENATRAN 63/09 e 59/07 e alterações ",Transitar com o veículo excedendo a CMT em até 600 kg,1,8,202108,187618,187617,1
6407641b305a576376e6f440,CMT - Capacidade Máxima de Tração,AGOSTO,2021,MG,"Lei 9503/97 Lei 10561/02 Res. CONTRAN nº 210/06, 211/06 e 258/07 e alterações Portaria DENATRAN 63/09 e 59/07 e alterações ",Transitar com o veículo excedendo a CMT acima de 1000 kg,2,8,202108,187620,187618,2
6407641b305a576376e6f448,Evasão de Balança,AGOSTO,2021,GO,"Lei 9503 DE 23/09/1997 Transpor, sem autorização, bloqueio viário com ou sem sinalização ou dispositivos auxiliares, deixar de adentrar às áreas destinadas à pesagem de veículos ou evadir-se para não efetuar o pagamento do pedágio.",Art. 209 Deixar de adentrar as áreas destinadas à pesagem de veículos,930,8,202108,188550,187620,930
6407641b305a576376e6f450,Excesso de Peso,AGOSTO,2021,GO,,"Realizar transporte permissionado de passageiros, sem a emissão de bilhete.",7,8,202108,188557,188550,7
6407641b305a576376e6f453,Excesso de Peso,AGOSTO,2021,GO,"Lei 9503/97 Lei 10561/02 Res. CONTRAN nº 210/06, 211/06 e 258/07 e alterações Portaria DENATRAN 63/09 e 59/07 e alterações ",Transitar com o veículo com excesso de peso - Por Eixo,458,8,202108,189015,188557,458
6407641b305a576376e6f456,Excesso de Peso,AGOSTO,2021,MG,"Lei 9503/97 Lei 10561/02 Res. CONTRAN nº 210/06, 211/06 e 258/07 e alterações Portaria DENATRAN 63/09 e 59/07 e alterações ",Transitar com o veículo com excesso de peso - PBT/PBTC e Por Eixo,476,8,202108,189491,189015,476
6407641b305a576376e6f458,Excesso de Peso,AGOSTO,2021,MT,"Lei 9503/97 Lei 10561/02 Res. CONTRAN nº 210/06, 211/06 e 258/07 e alterações Portaria DENATRAN 63/09 e 59/07 e alterações ",Transitar com o veículo com excesso de peso - PBT/PBTC e Por Eixo,46,8,202108,189537,189491,46
6407641b305a576376e6f45b,Excesso de Peso,AGOSTO,2021,PR,"Lei 9503/97 Lei 10561/02 Res. CONTRAN nº 210/06, 211/06 e 258/07 e alterações Portaria DENATRAN 63/09 e 59/07 e alterações ",Transitar com o veículo com excesso de peso - PBT/PBTC e Por Eixo,107,8,202108,189644,189537,107
6407641b305a576376e6f460,Excesso de Peso,AGOSTO,2021,RJ,"Lei 9503/97 Lei 10561/02 Res. CONTRAN nº 210/06, 211/06 e 258/07 e alterações Portaria DENATRAN 63/09 e 59/07 e alterações ",Transitar com o veículo com excesso de peso - Por Eixo,1628,8,202108,191272,189644,1628
6407641b305a576376e6f465,Excesso de Peso,AGOSTO,2021,SC,"Lei 9503/97 Lei 10561/02 Res. CONTRAN nº 210/06, 211/06 e 258/07 e alterações Portaria DENATRAN 63/09 e 59/07 e alterações ",Transitar com o veículo com excesso de peso - PBT/PBTC,151,8,202108,191423,191272,151
6407641b305a576376e6f446,CMT - Capacidade Máxima de Tração,AGOSTO,2021,SP,"Lei 9503/97 Lei 10561/02 Res. CONTRAN nº 210/06, 211/06 e 258/07 e alterações Portaria DENATRAN 63/09 e 59/07 e alterações ",Transitar com o veículo excedendo a CMT acima de 1000 kg,2,8,202108,135443,135441,2
6407641b305a576376e6f469,Excesso de Peso,AGOSTO,2021,SP,"Lei 9503/97 Lei 10561/02 Res. CONTRAN nº 210/06, 211/06 e 258/07 e alterações Portaria DENATRAN 63/09 e 59/07 e alterações ",Transitar com o veículo com excesso de peso - Por Eixo,403,8,202108,136713,136310,403
6407641b305a576376e6f45a,Excesso de Peso,AGOSTO,2021,MT,"Lei 9503/97 Lei 10561/02 Res. CONTRAN nº 210/06, 211/06 e 258/07 e alterações Portaria DENATRAN 63/09 e 59/07 e alterações ",Transitar com o veículo com excesso de peso - Por Eixo,209,8,202108,136310,136101,209
6407641b305a576376e6f44e,Excesso de Peso,AGOSTO,2021,ES,"Lei 9503/97 Lei 10561/02 Res. CONTRAN nº 210/06, 211/06 e 258/07 e alterações Portaria DENATRAN 63/09 e 59/07 e alterações ",Transitar com o veículo com excesso de peso - PBT/PBTC,87,8,202108,135612,135525,87
6407641b305a576376e6f455,Excesso de Peso,AGOSTO,2021,MG,"Lei 9503/97 Lei 10561/02 Res. CONTRAN nº 210/06, 211/06 e 258/07 e alterações Portaria DENATRAN 63/09 e 59/07 e alterações ",Transitar com o veículo com excesso de peso - PBT/PBTC,183,8,202108,136054,135871,183
6407641b305a576376e6f44d,Excesso de Peso,AGOSTO,2021,ES,"Lei 9503/97 Lei 10561/02 Res. CONTRAN nº 210/06, 211/06 e 258/07 e alterações Portaria DENATRAN 63/09 e 59/07 e alterações ",Transitar com o veículo com excesso de peso - PBT/PBTC e Por Eixo,62,8,202108,135525,135463,62
6407641b305a576376e6f451,Excesso de Peso,AGOSTO,2021,GO,"Lei 9503/97 Lei 10561/02 Res. CONTRAN nº 210/06, 211/06 e 258/07 e alterações Portaria DENATRAN 63/09 e 59/07 e alterações ",Transitar com o veículo com excesso de peso - PBT/PBTC,65,8,202108,135677,135612,65
6407641b305a576376e6f459,Excesso de Peso,AGOSTO,2021,MT,"Lei 9503/97 Lei 10561/02 Res. CONTRAN nº 210/06, 211/06 e 258/07 e alterações Portaria DENATRAN 63/09 e 59/07 e alterações ",Transitar com o veículo com excesso de peso - PBT/PBTC,47,8,202108,136101,136054,47
6407641b305a576376e6f466,Excesso de Peso,AGOSTO,2021,SC,"Lei 9503/97 Lei 10561/02 Res. CONTRAN nº 210/06, 211/06 e 258/07 e alterações Portaria DENATRAN 63/09 e 59/07 e alterações ",Transitar com o veículo com excesso de peso - Por Eixo,616,8,202108,192039,191423,616
6407641b305a576376e6f452,Excesso de Peso,AGOSTO,2021,GO,"Lei 9503/97 Lei 10561/02 Res. CONTRAN nº 210/06, 211/06 e 258/07 e alterações Portaria DENATRAN 63/09 e 59/07 e alterações ",Transitar com o veículo com excesso de peso - PBT/PBTC e Por Eixo,194,8,202108,135871,135677,194
6407641b305a576376e6f467,Excesso de Peso,AGOSTO,2021,SP,"Lei 9503/97 Lei 10561/02 Res. CONTRAN nº 210/06, 211/06 e 258/07 e alterações Portaria DENATRAN 63/09 e 59/07 e alterações ",Transitar com o veículo com excesso de peso - PBT/PBTC e Por Eixo,72,8,202108,192111,192039,72
6407641b305a576376e6f468,Excesso de Peso,AGOSTO,2021,SP,"Lei 9503/97 Lei 10561/02 Res. CONTRAN nº 210/06, 211/06 e 258/07 e alterações Portaria DENATRAN 63/09 e 59/07 e alterações ",Transitar com o veículo com excesso de peso - PBT/PBTC,97,8,202108,192208,192111,97
6407641b305a576376e6f486,Excesso de Peso,SETEMBRO,2021,RJ,"Lei 9503/97 Lei 10561/02 Res. CONTRAN nº 210/06, 211/06 e 258/07 e alterações Portaria DENATRAN 63/09 e 59/07 e alterações ",Transitar com o veículo com excesso de peso - PBT/PBTC e Por Eixo,347,9,202109,139438,139091,347
6407641b305a576376e6f487,Excesso de Peso,SETEMBRO,2021,RJ,"Lei 9503/97 Lei 10561/02 Res. CONTRAN nº 210/06, 211/06 e 258/07 e alterações Portaria DENATRAN 63/09 e 59/07 e alterações ",Transitar com o veículo com excesso de peso - PBT/PBTC,456,9,202109,139894,139438,456
6407641b305a576376e6f488,Excesso de Peso,SETEMBRO,2021,RJ,"Lei 9503/97 Lei 10561/02 Res. CONTRAN nº 210/06, 211/06 e 258/07 e alterações Portaria DENATRAN 63/09 e 59/07 e alterações ",Transitar com o veículo com excesso de peso - Por Eixo,1894,9,202109,141788,139894,1894
6407641b305a576376e6f47f,Excesso de Peso,SETEMBRO,2021,MG,"Lei 9503/97 Lei 10561/02 Res. CONTRAN nº 210/06, 211/06 e 258/07 e alterações Portaria DENATRAN 63/09 e 59/07 e alterações ",Transitar com o veículo com excesso de peso - Por Eixo,1446,9,202109,138448,137002,1446
6407641b305a576376e6f478,Excesso de Peso,SETEMBRO,2021,ES,"Lei 9503/97 Lei 10561/02 Res. CONTRAN nº 210/06, 211/06 e 258/07 e alterações Portaria DENATRAN 63/09 e 59/07 e alterações ",Transitar com o veículo com excesso de peso - Por Eixo,287,9,202109,137002,136715,287
6407641b305a576376e6f46a,CMT - Capacidade Máxima de Tração,SETEMBRO,2021,MG,"Lei 9503/97 Lei 10561/02 Res. CONTRAN nº 210/06, 211/06 e 258/07 e alterações Portaria DENATRAN 63/09 e 59/07 e alterações ",Transitar com o veículo excedendo a CMT em até 600 kg,1,9,202109,61664,61663,1
6407641b305a576376e6f46f,CMT - Capacidade Máxima de Tração,SETEMBRO,2021,RJ,"Lei 9503/97 Lei 10561/02 Res. CONTRAN nº 210/06, 211/06 e 258/07 e alterações Portaria DENATRAN 63/09 e 59/07 e alterações ",Transitar com o veículo excedendo a CMT em até 600 kg,4,9,202109,61668,61664,4
6407641b305a576376e6f475,Evasão de Balança,SETEMBRO,2021,SP,"Lei 9503 DE 23/09/1997 Transpor, sem autorização, bloqueio viário com ou sem sinalização ou dispositivos auxiliares, deixar de adentrar às áreas destinadas à pesagem de veículos ou evadir-se para não efetuar o pagamento do pedágio.",Art. 209 Deixar de adentrar as áreas destinadas à pesagem de veículos,2301,9,202109,63969,61668,2301
6407641b305a576376e6f47b,Excesso de Peso,SETEMBRO,2021,GO,"Lei 9503/97 Lei 10561/02 Res. CONTRAN nº 210/06, 211/06 e 258/07 e alterações Portaria DENATRAN 63/09 e 59/07 e alterações ",Transitar com o veículo com excesso de peso - Por Eixo,358,9,202109,64327,63969,358
6407641b305a576376e6f482,Excesso de Peso,SETEMBRO,2021,MT,"Lei 9503/97 Lei 10561/02 Res. CONTRAN nº 210/06, 211/06 e 258/07 e alterações Portaria DENATRAN 63/09 e 59/07 e alterações ",Transitar com o veículo com excesso de peso - Por Eixo,260,9,202109,64587,64327,260
6407641b305a576376e6f48d,Excesso de Peso,SETEMBRO,2021,SC,"Lei 9503/97 Lei 10561/02 Res. CONTRAN nº 210/06, 211/06 e 258/07 e alterações Portaria DENATRAN 63/09 e 59/07 e alterações ",Transitar com o veículo com excesso de peso - PBT/PBTC e Por Eixo,30,9,202109,64617,64587,30
6407641b305a576376e6f485,Excesso de Peso,SETEMBRO,2021,PR,"Lei 9503/97 Lei 10561/02 Res. CONTRAN nº 210/06, 211/06 e 258/07 e alterações Portaria DENATRAN 63/09 e 59/07 e alterações ",Transitar com o veículo com excesso de peso - Por Eixo,643,9,202109,139091,138448,643
6407641b305a576376e6f471,CMT - Capacidade Máxima de Tração,SETEMBRO,2021,SP,"Lei 9503/97 Lei 10561/02 Res. CONTRAN nº 210/06, 211/06 e 258/07 e alterações Portaria DENATRAN 63/09 e 59/07 e alterações ",Transitar com o veículo excedendo a CMT acima de 1000 kg,2,9,202109,136715,136713,2
6407641b305a576376e6f472,Evasão de Balança,SETEMBRO,2021,GO,"Lei 9503 DE 23/09/1997 Transpor, sem autorização, bloqueio viário com ou sem sinalização ou dispositivos auxiliares, deixar de adentrar às áreas destinadas à pesagem de veículos ou evadir-se para não efetuar o pagamento do pedágio.",Art. 209 Deixar de adentrar as áreas destinadas à pesagem de veículos,1723,9,202109,80926,79203,1723
6407641b305a576376e6f46c,CMT - Capacidade Máxima de Tração,SETEMBRO,2021,PR,"Lei 9503/97 Lei 10561/02 Res. CONTRAN nº 210/06, 211/06 e 258/07 e alterações Portaria DENATRAN 63/09 e 59/07 e alterações ",Transitar com o veículo excedendo a CMT acima de 1000 kg,1,9,202109,79192,79191,1
6407641b305a576376e6f490,Excesso de Peso,SETEMBRO,2021,SP,"Lei 9503/97 Lei 10561/02 Res. CONTRAN nº 210/06, 211/06 e 258/07 e alterações Portaria DENATRAN 63/09 e 59/07 e alterações ",Transitar com o veículo com excesso de peso - PBT/PBTC,160,9,202109,193557,193397,160
6407641b305a576376e6f48e,Excesso de Peso,SETEMBRO,2021,SC,"Lei 9503/97 Lei 10561/02 Res. CONTRAN nº 210/06, 211/06 e 258/07 e alterações Portaria DENATRAN 63/09 e 59/07 e alterações ",Transitar com o veículo com excesso de peso - Por Eixo,86,9,202109,193397,193311,86
6407641b305a576376e6f48c,Excesso de Peso,SETEMBRO,2021,SC,"Lei 9503/97 Lei 10561/02 Res. CONTRAN nº 210/06, 211/06 e 258/07 e alterações Portaria DENATRAN 63/09 e 59/07 e alterações ",Transitar com o veículo com excesso de peso - PBT/PBTC,26,9,202109,193311,193285,26
6407641b305a576376e6f48b,Excesso de Peso,SETEMBRO,2021,RS,"Lei 9503/97 Lei 10561/02 Res. CONTRAN nº 210/06, 211/06 e 258/07 e alterações Portaria DENATRAN 63/09 e 59/07 e alterações ",Transitar com o veículo com excesso de peso - Por Eixo,461,9,202109,193285,192824,461
6407641b305a576376e6f48a,Excesso de Peso,SETEMBRO,2021,RS,"Lei 9503/97 Lei 10561/02 Res. CONTRAN nº 210/06, 211/06 e 258/07 e alterações Portaria DENATRAN 63/09 e 59/07 e alterações ",Transitar com o veículo com excesso de peso - PBT/PBTC,91,9,202109,192824,192733,91
6407641b305a576376e6f483,Excesso de Peso,SETEMBRO,2021,PR,"Lei 9503/97 Lei 10561/02 Res. CONTRAN nº 210/06, 211/06 e 258/07 e alterações Portaria DENATRAN 63/09 e 59/07 e alterações ",Transitar com o veículo com excesso de peso - PBT/PBTC e Por Eixo,114,9,202109,192733,192619,114
6407641b305a576376e6f47d,Excesso de Peso,SETEMBRO,2021,MG,"Lei 9503/97 Lei 10561/02 Res. CONTRAN nº 210/06, 211/06 e 258/07 e alterações Portaria DENATRAN 63/09 e 59/07 e alterações ",Transitar com o veículo com excesso de peso - PBT/PBTC,213,9,202109,192619,192406,213
6407641b305a576376e6f47a,Excesso de Peso,SETEMBRO,2021,GO,"Lei 9503/97 Lei 10561/02 Res. CONTRAN nº 210/06, 211/06 e 258/07 e alterações Portaria DENATRAN 63/09 e 59/07 e alterações ",Transitar com o veículo com excesso de peso - PBT/PBTC e Por Eixo,143,9,202109,192406,192263,143
6407641b305a576376e6f476,Excesso de Peso,SETEMBRO,2021,ES,"Lei 9503/97 Lei 10561/02 Res. CONTRAN nº 210/06, 211/06 e 258/07 e alterações Portaria DENATRAN 63/09 e 59/07 e alterações ",Transitar com o veículo com excesso de peso - PBT/PBTC e Por Eixo,51,9,202109,192263,192212,51
6407641b305a576376e6f46b,CMT - Capacidade Máxima de Tração,SETEMBRO,2021,MG,"Lei 9503/97 Lei 10561/02 Res. CONTRAN nº 210/06, 211/06 e 258/07 e alterações Portaria DENATRAN 63/09 e 59/07 e alterações ",Transitar com o veículo excedendo a CMT acima de 1000 kg,4,9,202109,192212,192208,4
6407641b305a576376e6f48f,Excesso de Peso,SETEMBRO,2021,SP,"Lei 9503/97 Lei 10561/02 Res. CONTRAN nº 210/06, 211/06 e 258/07 e alterações Portaria DENATRAN 63/09 e 59/07 e alterações ",Transitar com o veículo com excesso de peso - PBT/PBTC e Por Eixo,134,9,202109,90064,89930,134
6407641b305a576376e6f484,Excesso de Peso,SETEMBRO,2021,PR,"Lei 9503/97 Lei 10561/02 Res. CONTRAN nº 210/06, 211/06 e 258/07 e alterações Portaria DENATRAN 63/09 e 59/07 e alterações ",Transitar com o veículo com excesso de peso - PBT/PBTC,162,9,202109,89930,89768,162
6407641b305a576376e6f491,Excesso de Peso,SETEMBRO,2021,SP,"Lei 9503/97 Lei 10561/02 Res. CONTRAN nº 210/06, 211/06 e 258/07 e alterações Portaria DENATRAN 63/09 e 59/07 e alterações ",Transitar com o veículo com excesso de peso - Por Eixo,735,9,202109,142597,141862,735
6407641b305a576376e6f480,Excesso de Peso,SETEMBRO,2021,MT,"Lei 9503/97 Lei 10561/02 Res. CONTRAN nº 210/06, 211/06 e 258/07 e alterações Portaria DENATRAN 63/09 e 59/07 e alterações ",Transitar com o veículo com excesso de peso - PBT/PBTC e Por Eixo,54,9,202109,89698,89644,54
6407641b305a576376e6f46d,CMT - Capacidade Máxima de Tração,SETEMBRO,2021,PR,"Lei 9503/97 Lei 10561/02 Res. CONTRAN nº 210/06, 211/06 e 258/07 e alterações Portaria DENATRAN 63/09 e 59/07 e alterações ",Transitar com o veículo excedendo a CMT entre 601 e 1000 kg,1,9,202109,79193,79192,1
6407641b305a576376e6f46e,CMT - Capacidade Máxima de Tração,SETEMBRO,2021,RJ,"Lei 9503/97 Lei 10561/02 Res. CONTRAN nº 210/06, 211/06 e 258/07 e alterações Portaria DENATRAN 63/09 e 59/07 e alterações ",Transitar com o veículo excedendo a CMT entre 601 e 1000 kg,2,9,202109,79195,79193,2
6407641b305a576376e6f470,CMT - Capacidade Máxima de Tração,SETEMBRO,2021,RJ,"Lei 9503/97 Lei 10561/02 Res. CONTRAN nº 210/06, 211/06 e 258/07 e alterações Portaria DENATRAN 63/09 e 59/07 e alterações ",Transitar com o veículo excedendo a CMT acima de 1000 kg,8,9,202109,79203,79195,8
6407641b305a576376e6f489,Excesso de Peso,SETEMBRO,2021,RS,"Lei 9503/97 Lei 10561/02 Res. CONTRAN nº 210/06, 211/06 e 258/07 e alterações Portaria DENATRAN 63/09 e 59/07 e alterações ",Transitar com o veículo com excesso de peso - PBT/PBTC e Por Eixo,74,9,202109,141862,141788,74
6407641b305a576376e6f473,Evasão de Balança,SETEMBRO,2021,MG,"Lei 9503 DE 23/09/1997 Transpor, sem autorização, bloqueio viário com ou sem sinalização ou dispositivos auxiliares, deixar de adentrar às áreas destinadas à pesagem de veículos ou evadir-se para não efetuar o pagamento do pedágio.",Art. 209 Deixar de adentrar as áreas destinadas à pesagem de veículos,3363,9,202109,84289,80926,3363
6407641b305a576376e6f474,Evasão de Balança,SETEMBRO,2021,RJ,"Lei 9503 DE 23/09/1997 Transpor, sem autorização, bloqueio viário com ou sem sinalização ou dispositivos auxiliares, deixar de adentrar às áreas destinadas à pesagem de veículos ou evadir-se para não efetuar o pagamento do pedágio.",Art. 209 Deixar de adentrar as áreas destinadas à pesagem de veículos,4811,9,202109,89100,84289,4811
6407641b305a576376e6f477,Excesso de Peso,SETEMBRO,2021,ES,"Lei 9503/97 Lei 10561/02 Res. CONTRAN nº 210/06, 211/06 e 258/07 e alterações Portaria DENATRAN 63/09 e 59/07 e alterações ",Transitar com o veículo com excesso de peso - PBT/PBTC,65,9,202109,89165,89100,65
6407641b305a576376e6f479,Excesso de Peso,SETEMBRO,2021,GO,"Lei 9503/97 Lei 10561/02 Res. CONTRAN nº 210/06, 211/06 e 258/07 e alterações Portaria DENATRAN 63/09 e 59/07 e alterações ",Transitar com o veículo com excesso de peso - PBT/PBTC,43,9,202109,89208,89165,43
6407641b305a576376e6f47c,Excesso de Peso,SETEMBRO,2021,MG,,"Realizar transporte permissionado de passageiros, sem a emissão de bilhete.",2,9,202109,89210,89208,2
6407641b305a576376e6f481,Excesso de Peso,SETEMBRO,2021,MT,"Lei 9503/97 Lei 10561/02 Res. CONTRAN nº 210/06, 211/06 e 258/07 e alterações Portaria DENATRAN 63/09 e 59/07 e alterações ",Transitar com o veículo com excesso de peso - PBT/PBTC,70,9,202109,89768,89698,70
6407641b305a576376e6f47e,Excesso de Peso,SETEMBRO,2021,MG,"Lei 9503/97 Lei 10561/02 Res. CONTRAN nº 210/06, 211/06 e 258/07 e alterações Portaria DENATRAN 63/09 e 59/07 e alterações ",Transitar com o veículo com excesso de peso - PBT/PBTC e Por Eixo,434,9,202109,89644,89210,434
6407641b305a576376e6f4ac,Excesso de Peso,OUTUBRO,2021,RJ,"Lei 9503/97 Lei 10561/02 Res. CONTRAN nº 210/06, 211/06 e 258/07 e alterações Portaria DENATRAN 63/09 e 59/07 e alterações ",Transitar com o veículo com excesso de peso - PBT/PBTC,461,10,202110,65352,64891,461
6407641b305a576376e6f4a9,Excesso de Peso,OUTUBRO,2021,PR,"Lei 9503/97 Lei 10561/02 Res. CONTRAN nº 210/06, 211/06 e 258/07 e alterações Portaria DENATRAN 63/09 e 59/07 e alterações ",Transitar com o veículo com excesso de peso - PBT/PBTC,109,10,202110,64891,64782,109
6407641b305a576376e6f4a1,Excesso de Peso,OUTUBRO,2021,MG,,"Realizar transporte permissionado de passageiros, sem a emissão de bilhete.",3,10,202110,64782,64779,3
6407641b305a576376e6f49c,Excesso de Peso,OUTUBRO,2021,ES,"Lei 9503/97 Lei 10561/02 Res. CONTRAN nº 210/06, 211/06 e 258/07 e alterações Portaria DENATRAN 63/09 e 59/07 e alterações ",Transitar com o veículo com excesso de peso - PBT/PBTC,102,10,202110,64779,64677,102
6407641b305a576376e6f49b,Excesso de Peso,OUTUBRO,2021,ES,"Lei 9503/97 Lei 10561/02 Res. CONTRAN nº 210/06, 211/06 e 258/07 e alterações Portaria DENATRAN 63/09 e 59/07 e alterações ",Transitar com o veículo com excesso de peso - PBT/PBTC e Por Eixo,60,10,202110,64677,64617,60
6407641b305a576376e6f498,Evasão de Balança,OUTUBRO,2021,MG,"Lei 9503 DE 23/09/1997 Transpor, sem autorização, bloqueio viário com ou sem sinalização ou dispositivos auxiliares, deixar de adentrar às áreas destinadas à pesagem de veículos ou evadir-se para não efetuar o pagamento do pedágio.",Art. 209 Deixar de adentrar as áreas destinadas à pesagem de veículos,1858,10,202110,146419,144561,1858
6407641b305a576376e6f4b0,Excesso de Peso,OUTUBRO,2021,RS,"Lei 9503/97 Lei 10561/02 Res. CONTRAN nº 210/06, 211/06 e 258/07 e alterações Portaria DENATRAN 63/09 e 59/07 e alterações ",Transitar com o veículo com excesso de peso - Por Eixo,235,10,202110,148894,148659,235
6407641b305a576376e6f4ad,Excesso de Peso,OUTUBRO,2021,RJ,"Lei 9503/97 Lei 10561/02 Res. CONTRAN nº 210/06, 211/06 e 258/07 e alterações Portaria DENATRAN 63/09 e 59/07 e alterações ",Transitar com o veículo com excesso de peso - Por Eixo,1713,10,202110,148659,146946,1713
6407641b305a576376e6f4a0,Excesso de Peso,OUTUBRO,2021,GO,"Lei 9503/97 Lei 10561/02 Res. CONTRAN nº 210/06, 211/06 e 258/07 e alterações Portaria DENATRAN 63/09 e 59/07 e alterações ",Transitar com o veículo com excesso de peso - Por Eixo,455,10,202110,146946,146491,455
6407641b305a576376e6f49f,Excesso de Peso,OUTUBRO,2021,GO,"Lei 9503/97 Lei 10561/02 Res. CONTRAN nº 210/06, 211/06 e 258/07 e alterações Portaria DENATRAN 63/09 e 59/07 e alterações ",Transitar com o veículo com excesso de peso - PBT/PBTC e Por Eixo,72,10,202110,146491,146419,72
6407641b305a576376e6f4b6,Excesso de Peso,OUTUBRO,2021,SP,"Lei 9503/97 Lei 10561/02 Res. CONTRAN nº 210/06, 211/06 e 258/07 e alterações Portaria DENATRAN 63/09 e 59/07 e alterações ",Transitar com o veículo com excesso de peso - Por Eixo,326,10,202110,65714,65388,326
6407641b305a576376e6f4af,Excesso de Peso,OUTUBRO,2021,RS,"Lei 9503/97 Lei 10561/02 Res. CONTRAN nº 210/06, 211/06 e 258/07 e alterações Portaria DENATRAN 63/09 e 59/07 e alterações ",Transitar com o veículo com excesso de peso - PBT/PBTC,36,10,202110,65388,65352,36
6407641b305a576376e6f4b2,Excesso de Peso,OUTUBRO,2021,SC,"Lei 9503/97 Lei 10561/02 Res. CONTRAN nº 210/06, 211/06 e 258/07 e alterações Portaria DENATRAN 63/09 e 59/07 e alterações ",Transitar com o veículo com excesso de peso - PBT/PBTC,164,10,202110,149058,148894,164
6407641b305a576376e6f492,CMT - Capacidade Máxima de Tração,OUTUBRO,2021,MG,"Lei 9503/97 Lei 10561/02 Res. CONTRAN nº 210/06, 211/06 e 258/07 e alterações Portaria DENATRAN 63/09 e 59/07 e alterações ",Transitar com o veículo excedendo a CMT acima de 1000 kg,1,10,202110,90065,90064,1
6407641b305a576376e6f4b3,Excesso de Peso,OUTUBRO,2021,SC,"Lei 9503/97 Lei 10561/02 Res. CONTRAN nº 210/06, 211/06 e 258/07 e alterações Portaria DENATRAN 63/09 e 59/07 e alterações ",Transitar com o veículo com excesso de peso - Por Eixo,622,10,202110,93829,93207,622
6407641b305a576376e6f4a8,Excesso de Peso,OUTUBRO,2021,PR,"Lei 9503/97 Lei 10561/02 Res. CONTRAN nº 210/06, 211/06 e 258/07 e alterações Portaria DENATRAN 63/09 e 59/07 e alterações ",Transitar com o veículo com excesso de peso - PBT/PBTC e Por Eixo,76,10,202110,199033,198957,76
6407641b305a576376e6f4a6,Excesso de Peso,OUTUBRO,2021,MT,"Lei 9503/97 Lei 10561/02 Res. CONTRAN nº 210/06, 211/06 e 258/07 e alterações Portaria DENATRAN 63/09 e 59/07 e alterações ",Transitar com o veículo com excesso de peso - PBT/PBTC,63,10,202110,198957,198894,63
6407641b305a576376e6f4a5,Excesso de Peso,OUTUBRO,2021,MT,"Lei 9503/97 Lei 10561/02 Res. CONTRAN nº 210/06, 211/06 e 258/07 e alterações Portaria DENATRAN 63/09 e 59/07 e alterações ",Transitar com o veículo com excesso de peso - PBT/PBTC e Por Eixo,39,10,202110,198894,198855,39
6407641b305a576376e6f4a4,Excesso de Peso,OUTUBRO,2021,MG,"Lei 9503/97 Lei 10561/02 Res. CONTRAN nº 210/06, 211/06 e 258/07 e alterações Portaria DENATRAN 63/09 e 59/07 e alterações ",Transitar com o veículo com excesso de peso - Por Eixo,1303,10,202110,198855,197552,1303
6407641b305a576376e6f4a2,Excesso de Peso,OUTUBRO,2021,MG,"Lei 9503/97 Lei 10561/02 Res. CONTRAN nº 210/06, 211/06 e 258/07 e alterações Portaria DENATRAN 63/09 e 59/07 e alterações ",Transitar com o veículo com excesso de peso - PBT/PBTC,148,10,202110,197552,197404,148
6407641b305a576376e6f49e,Excesso de Peso,OUTUBRO,2021,GO,"Lei 9503/97 Lei 10561/02 Res. CONTRAN nº 210/06, 211/06 e 258/07 e alterações Portaria DENATRAN 63/09 e 59/07 e alterações ",Transitar com o veículo com excesso de peso - PBT/PBTC,58,10,202110,197404,197346,58
6407641b305a576376e6f499,Evasão de Balança,OUTUBRO,2021,RJ,"Lei 9503 DE 23/09/1997 Transpor, sem autorização, bloqueio viário com ou sem sinalização ou dispositivos auxiliares, deixar de adentrar às áreas destinadas à pesagem de veículos ou evadir-se para não efetuar o pagamento do pedágio.",Art. 209 Deixar de adentrar as áreas destinadas à pesagem de veículos,3782,10,202110,197346,193564,3782
6407641b305a576376e6f4b5,Excesso de Peso,OUTUBRO,2021,SP,"Lei 9503/97 Lei 10561/02 Res. CONTRAN nº 210/06, 211/06 e 258/07 e alterações Portaria DENATRAN 63/09 e 59/07 e alterações ",Transitar com o veículo com excesso de peso - PBT/PBTC,123,10,202110,199275,199152,123
6407641b305a576376e6f497,Evasão de Balança,OUTUBRO,2021,GO,"Lei 9503 DE 23/09/1997 Transpor, sem autorização, bloqueio viário com ou sem sinalização ou dispositivos auxiliares, deixar de adentrar às áreas destinadas à pesagem de veículos ou evadir-se para não efetuar o pagamento do pedágio.",Art. 209 Deixar de adentrar as áreas destinadas à pesagem de veículos,1964,10,202110,144561,142597,1964
6407641b305a576376e6f495,CMT - Capacidade Máxima de Tração,OUTUBRO,2021,RJ,"Lei 9503/97 Lei 10561/02 Res. CONTRAN nº 210/06, 211/06 e 258/07 e alterações Portaria DENATRAN 63/09 e 59/07 e alterações ",Transitar com o veículo excedendo a CMT acima de 1000 kg,7,10,202110,193564,193557,7
6407641b305a576376e6f4b4,Excesso de Peso,OUTUBRO,2021,SP,"Lei 9503/97 Lei 10561/02 Res. CONTRAN nº 210/06, 211/06 e 258/07 e alterações Portaria DENATRAN 63/09 e 59/07 e alterações ",Transitar com o veículo com excesso de peso - PBT/PBTC e Por Eixo,88,10,202110,199152,199064,88
6407641b305a576376e6f4b1,Excesso de Peso,OUTUBRO,2021,SC,"Lei 9503/97 Lei 10561/02 Res. CONTRAN nº 210/06, 211/06 e 258/07 e alterações Portaria DENATRAN 63/09 e 59/07 e alterações ",Transitar com o veículo com excesso de peso - PBT/PBTC e Por Eixo,141,10,202110,93207,93066,141
6407641b305a576376e6f4ab,Excesso de Peso,OUTUBRO,2021,RJ,"Lei 9503/97 Lei 10561/02 Res. CONTRAN nº 210/06, 211/06 e 258/07 e alterações Portaria DENATRAN 63/09 e 59/07 e alterações ",Transitar com o veículo com excesso de peso - PBT/PBTC e Por Eixo,317,10,202110,93066,92749,317
6407641b305a576376e6f4aa,Excesso de Peso,OUTUBRO,2021,PR,"Lei 9503/97 Lei 10561/02 Res. CONTRAN nº 210/06, 211/06 e 258/07 e alterações Portaria DENATRAN 63/09 e 59/07 e alterações ",Transitar com o veículo com excesso de peso - Por Eixo,362,10,202110,92749,92387,362
6407641b305a576376e6f4a7,Excesso de Peso,OUTUBRO,2021,MT,"Lei 9503/97 Lei 10561/02 Res. CONTRAN nº 210/06, 211/06 e 258/07 e alterações Portaria DENATRAN 63/09 e 59/07 e alterações ",Transitar com o veículo com excesso de peso - Por Eixo,279,10,202110,92387,92108,279
6407641b305a576376e6f4a3,Excesso de Peso,OUTUBRO,2021,MG,"Lei 9503/97 Lei 10561/02 Res. CONTRAN nº 210/06, 211/06 e 258/07 e alterações Portaria DENATRAN 63/09 e 59/07 e alterações ",Transitar com o veículo com excesso de peso - PBT/PBTC e Por Eixo,251,10,202110,92108,91857,251
6407641b305a576376e6f49d,Excesso de Peso,OUTUBRO,2021,ES,"Lei 9503/97 Lei 10561/02 Res. CONTRAN nº 210/06, 211/06 e 258/07 e alterações Portaria DENATRAN 63/09 e 59/07 e alterações ",Transitar com o veículo com excesso de peso - Por Eixo,345,10,202110,91857,91512,345
6407641b305a576376e6f49a,Evasão de Balança,OUTUBRO,2021,SP,"Lei 9503 DE 23/09/1997 Transpor, sem autorização, bloqueio viário com ou sem sinalização ou dispositivos auxiliares, deixar de adentrar às áreas destinadas à pesagem de veículos ou evadir-se para não efetuar o pagamento do pedágio.",Art. 209 Deixar de adentrar as áreas destinadas à pesagem de veículos,1442,10,202110,91512,90070,1442
6407641b305a576376e6f496,CMT - Capacidade Máxima de Tração,OUTUBRO,2021,SP,"Lei 9503/97 Lei 10561/02 Res. CONTRAN nº 210/06, 211/06 e 258/07 e alterações Portaria DENATRAN 63/09 e 59/07 e alterações ",Transitar com o veículo excedendo a CMT acima de 1000 kg,2,10,202110,90070,90068,2
6407641b305a576376e6f494,CMT - Capacidade Máxima de Tração,OUTUBRO,2021,RJ,"Lei 9503/97 Lei 10561/02 Res. CONTRAN nº 210/06, 211/06 e 258/07 e alterações Portaria DENATRAN 63/09 e 59/07 e alterações ",Transitar com o veículo excedendo a CMT em até 600 kg,2,10,202110,90068,90066,2
6407641b305a576376e6f493,CMT - Capacidade Máxima de Tração,OUTUBRO,2021,RJ,"Lei 9503/97 Lei 10561/02 Res. CONTRAN nº 210/06, 211/06 e 258/07 e alterações Portaria DENATRAN 63/09 e 59/07 e alterações ",Transitar com o veículo excedendo a CMT entre 601 e 1000 kg,1,10,202110,90066,90065,1
6407641b305a576376e6f4ae,Excesso de Peso,OUTUBRO,2021,RS,"Lei 9503/97 Lei 10561/02 Res. CONTRAN nº 210/06, 211/06 e 258/07 e alterações Portaria DENATRAN 63/09 e 59/07 e alterações ",Transitar com o veículo com excesso de peso - PBT/PBTC e Por Eixo,31,10,202110,199064,199033,31
6407641b305a576376e6f4bf,Evasão de Balança,NOVEMBRO,2021,GO,"Lei 9503 DE 23/09/1997 Transpor, sem autorização, bloqueio viário com ou sem sinalização ou dispositivos auxiliares, deixar de adentrar às áreas destinadas à pesagem de veículos ou evadir-se para não efetuar o pagamento do pedágio.",Art. 209 Deixar de adentrar as áreas destinadas à pesagem de veículos,1740,11,202111,67648,65908,1740
6407641b305a576376e6f4b8,CMT - Capacidade Máxima de Tração,NOVEMBRO,2021,MG,"Lei 9503/97 Lei 10561/02 Res. CONTRAN nº 210/06, 211/06 e 258/07 e alterações Portaria DENATRAN 63/09 e 59/07 e alterações ",Transitar com o veículo excedendo a CMT acima de 1000 kg,1,11,202111,65715,65714,1
6407641b305a576376e6f4be,Evasão de Balança,NOVEMBRO,2021,ES,"Lei 9503 DE 23/09/1997 Transpor, sem autorização, bloqueio viário com ou sem sinalização ou dispositivos auxiliares, deixar de adentrar às áreas destinadas à pesagem de veículos ou evadir-se para não efetuar o pagamento do pedágio.",Art. 209 Deixar de adentrar as áreas destinadas à pesagem de veículos,193,11,202111,65908,65715,193
6407641b305a576376e6f4c1,Evasão de Balança,NOVEMBRO,2021,MT,"Lei 9503 DE 23/09/1997 Transpor, sem autorização, bloqueio viário com ou sem sinalização ou dispositivos auxiliares, deixar de adentrar às áreas destinadas à pesagem de veículos ou evadir-se para não efetuar o pagamento do pedágio.",Art. 209 Deixar de adentrar as áreas destinadas à pesagem de veículos,12,11,202111,67660,67648,12
6407641b305a576376e6f4c3,Evasão de Balança,NOVEMBRO,2021,SP,"Lei 9503 DE 23/09/1997 Transpor, sem autorização, bloqueio viário com ou sem sinalização ou dispositivos auxiliares, deixar de adentrar às áreas destinadas à pesagem de veículos ou evadir-se para não efetuar o pagamento do pedágio.",Art. 209 Deixar de adentrar as áreas destinadas à pesagem de veículos,1260,11,202111,202635,201375,1260
6407641b305a576376e6f4cd,Excesso de Peso,NOVEMBRO,2021,MG,"Lei 9503/97 Lei 10561/02 Res. CONTRAN nº 210/06, 211/06 e 258/07 e alterações Portaria DENATRAN 63/09 e 59/07 e alterações ",Transitar com o veículo com excesso de peso - Por Eixo,711,11,202111,68435,67724,711
6407641b305a576376e6f4d9,Excesso de Peso,NOVEMBRO,2021,RS,"Lei 9503/97 Lei 10561/02 Res. CONTRAN nº 210/06, 211/06 e 258/07 e alterações Portaria DENATRAN 63/09 e 59/07 e alterações ",Transitar com o veículo com excesso de peso - Por Eixo,234,11,202111,204219,203985,234
6407641b305a576376e6f4d5,Excesso de Peso,NOVEMBRO,2021,RJ,"Lei 9503/97 Lei 10561/02 Res. CONTRAN nº 210/06, 211/06 e 258/07 e alterações Portaria DENATRAN 63/09 e 59/07 e alterações ",Transitar com o veículo com excesso de peso - PBT/PBTC,411,11,202111,203985,203574,411
6407641b305a576376e6f4d0,Excesso de Peso,NOVEMBRO,2021,MT,"Lei 9503/97 Lei 10561/02 Res. CONTRAN nº 210/06, 211/06 e 258/07 e alterações Portaria DENATRAN 63/09 e 59/07 e alterações ",Transitar com o veículo com excesso de peso - Por Eixo,287,11,202111,203574,203287,287
6407641b305a576376e6f4cf,Excesso de Peso,NOVEMBRO,2021,MT,"Lei 9503/97 Lei 10561/02 Res. CONTRAN nº 210/06, 211/06 e 258/07 e alterações Portaria DENATRAN 63/09 e 59/07 e alterações ",Transitar com o veículo com excesso de peso - PBT/PBTC,99,11,202111,203287,203188,99
6407641b305a576376e6f4ce,Excesso de Peso,NOVEMBRO,2021,MT,"Lei 9503/97 Lei 10561/02 Res. CONTRAN nº 210/06, 211/06 e 258/07 e alterações Portaria DENATRAN 63/09 e 59/07 e alterações ",Transitar com o veículo com excesso de peso - PBT/PBTC e Por Eixo,40,11,202111,203188,203148,40
6407641b305a576376e6f4cc,Excesso de Peso,NOVEMBRO,2021,MG,"Lei 9503/97 Lei 10561/02 Res. CONTRAN nº 210/06, 211/06 e 258/07 e alterações Portaria DENATRAN 63/09 e 59/07 e alterações ",Transitar com o veículo com excesso de peso - PBT/PBTC e Por Eixo,169,11,202111,203148,202979,169
6407641b305a576376e6f4cb,Excesso de Peso,NOVEMBRO,2021,MG,"Lei 9503/97 Lei 10561/02 Res. CONTRAN nº 210/06, 211/06 e 258/07 e alterações Portaria DENATRAN 63/09 e 59/07 e alterações ",Transitar com o veículo com excesso de peso - PBT/PBTC,143,11,202111,202979,202836,143
6407641b305a576376e6f4ba,CMT - Capacidade Máxima de Tração,NOVEMBRO,2021,RJ,"Lei 9503/97 Lei 10561/02 Res. CONTRAN nº 210/06, 211/06 e 258/07 e alterações Portaria DENATRAN 63/09 e 59/07 e alterações ",Transitar com o veículo excedendo a CMT acima de 1000 kg,4,11,202111,93833,93829,4
6407641b305a576376e6f4c8,Excesso de Peso,NOVEMBRO,2021,GO,"Lei 9503/97 Lei 10561/02 Res. CONTRAN nº 210/06, 211/06 e 258/07 e alterações Portaria DENATRAN 63/09 e 59/07 e alterações ",Transitar com o veículo com excesso de peso - PBT/PBTC e Por Eixo,49,11,202111,93882,93833,49
6407641b305a576376e6f4c9,Excesso de Peso,NOVEMBRO,2021,GO,"Lei 9503/97 Lei 10561/02 Res. CONTRAN nº 210/06, 211/06 e 258/07 e alterações Portaria DENATRAN 63/09 e 59/07 e alterações ",Transitar com o veículo com excesso de peso - PBT/PBTC,58,11,202111,93940,93882,58
6407641b305a576376e6f4d1,Excesso de Peso,NOVEMBRO,2021,PR,"Lei 9503/97 Lei 10561/02 Res. CONTRAN nº 210/06, 211/06 e 258/07 e alterações Portaria DENATRAN 63/09 e 59/07 e alterações ",Transitar com o veículo com excesso de peso - PBT/PBTC e Por Eixo,101,11,202111,94041,93940,101
6407641b305a576376e6f4d2,Excesso de Peso,NOVEMBRO,2021,PR,"Lei 9503/97 Lei 10561/02 Res. CONTRAN nº 210/06, 211/06 e 258/07 e alterações Portaria DENATRAN 63/09 e 59/07 e alterações ",Transitar com o veículo com excesso de peso - PBT/PBTC,124,11,202111,94165,94041,124
6407641b305a576376e6f4d3,Excesso de Peso,NOVEMBRO,2021,PR,"Lei 9503/97 Lei 10561/02 Res. CONTRAN nº 210/06, 211/06 e 258/07 e alterações Portaria DENATRAN 63/09 e 59/07 e alterações ",Transitar com o veículo com excesso de peso - Por Eixo,157,11,202111,94322,94165,157
6407641b305a576376e6f4d4,Excesso de Peso,NOVEMBRO,2021,RJ,"Lei 9503/97 Lei 10561/02 Res. CONTRAN nº 210/06, 211/06 e 258/07 e alterações Portaria DENATRAN 63/09 e 59/07 e alterações ",Transitar com o veículo com excesso de peso - PBT/PBTC e Por Eixo,257,11,202111,94579,94322,257
6407641b305a576376e6f4db,Excesso de Peso,NOVEMBRO,2021,SC,"Lei 9503/97 Lei 10561/02 Res. CONTRAN nº 210/06, 211/06 e 258/07 e alterações Portaria DENATRAN 63/09 e 59/07 e alterações ",Transitar com o veículo com excesso de peso - PBT/PBTC,193,11,202111,94772,94579,193
6407641b305a576376e6f4df,Excesso de Peso,NOVEMBRO,2021,SP,"Lei 9503/97 Lei 10561/02 Res. CONTRAN nº 210/06, 211/06 e 258/07 e alterações Portaria DENATRAN 63/09 e 59/07 e alterações ",Transitar com o veículo com excesso de peso - Por Eixo,195,11,202111,94967,94772,195
6407641b305a576376e6f4b9,CMT - Capacidade Máxima de Tração,NOVEMBRO,2021,PR,"Lei 9503/97 Lei 10561/02 Res. CONTRAN nº 210/06, 211/06 e 258/07 e alterações Portaria DENATRAN 63/09 e 59/07 e alterações ",Transitar com o veículo excedendo a CMT acima de 1000 kg,1,11,202111,199276,199275,1
6407641b305a576376e6f4bd,CMT - Capacidade Máxima de Tração,NOVEMBRO,2021,SP,"Lei 9503/97 Lei 10561/02 Res. CONTRAN nº 210/06, 211/06 e 258/07 e alterações Portaria DENATRAN 63/09 e 59/07 e alterações ",Transitar com o veículo excedendo a CMT acima de 1000 kg,6,11,202111,199282,199276,6
6407641b305a576376e6f4c0,Evasão de Balança,NOVEMBRO,2021,MG,"Lei 9503 DE 23/09/1997 Transpor, sem autorização, bloqueio viário com ou sem sinalização ou dispositivos auxiliares, deixar de adentrar às áreas destinadas à pesagem de veículos ou evadir-se para não efetuar o pagamento do pedágio.",Art. 209 Deixar de adentrar as áreas destinadas à pesagem de veículos,2093,11,202111,201375,199282,2093
6407641b305a576376e6f4dd,Excesso de Peso,NOVEMBRO,2021,SP,"Lei 9503/97 Lei 10561/02 Res. CONTRAN nº 210/06, 211/06 e 258/07 e alterações Portaria DENATRAN 63/09 e 59/07 e alterações ",Transitar com o veículo com excesso de peso - PBT/PBTC e Por Eixo,171,11,202111,204390,204219,171
6407641b305a576376e6f4c5,Excesso de Peso,NOVEMBRO,2021,ES,"Lei 9503/97 Lei 10561/02 Res. CONTRAN nº 210/06, 211/06 e 258/07 e alterações Portaria DENATRAN 63/09 e 59/07 e alterações ",Transitar com o veículo com excesso de peso - PBT/PBTC e Por Eixo,64,11,202111,67724,67660,64
6407641b305a576376e6f4de,Excesso de Peso,NOVEMBRO,2021,SP,"Lei 9503/97 Lei 10561/02 Res. CONTRAN nº 210/06, 211/06 e 258/07 e alterações Portaria DENATRAN 63/09 e 59/07 e alterações ",Transitar com o veículo com excesso de peso - PBT/PBTC,190,11,202111,204580,204390,190
6407641b305a576376e6f4d6,Excesso de Peso,NOVEMBRO,2021,RJ,"Lei 9503/97 Lei 10561/02 Res. CONTRAN nº 210/06, 211/06 e 258/07 e alterações Portaria DENATRAN 63/09 e 59/07 e alterações ",Transitar com o veículo com excesso de peso - Por Eixo,724,11,202111,69159,68435,724
6407641b305a576376e6f4da,Excesso de Peso,NOVEMBRO,2021,SC,"Lei 9503/97 Lei 10561/02 Res. CONTRAN nº 210/06, 211/06 e 258/07 e alterações Portaria DENATRAN 63/09 e 59/07 e alterações ",Transitar com o veículo com excesso de peso - PBT/PBTC e Por Eixo,169,11,202111,154037,153868,169
6407641b305a576376e6f4d8,Excesso de Peso,NOVEMBRO,2021,RS,"Lei 9503/97 Lei 10561/02 Res. CONTRAN nº 210/06, 211/06 e 258/07 e alterações Portaria DENATRAN 63/09 e 59/07 e alterações ",Transitar com o veículo com excesso de peso - PBT/PBTC,57,11,202111,153868,153811,57
6407641b305a576376e6f4c7,Excesso de Peso,NOVEMBRO,2021,ES,"Lei 9503/97 Lei 10561/02 Res. CONTRAN nº 210/06, 211/06 e 258/07 e alterações Portaria DENATRAN 63/09 e 59/07 e alterações ",Transitar com o veículo com excesso de peso - Por Eixo,256,11,202111,153811,153555,256
6407641b305a576376e6f4c6,Excesso de Peso,NOVEMBRO,2021,ES,"Lei 9503/97 Lei 10561/02 Res. CONTRAN nº 210/06, 211/06 e 258/07 e alterações Portaria DENATRAN 63/09 e 59/07 e alterações ",Transitar com o veículo com excesso de peso - PBT/PBTC,94,11,202111,153555,153461,94
6407641b305a576376e6f4c4,Excesso de Peso,NOVEMBRO,2021,BA,"Lei 9503/97 Lei 10561/02 Res. CONTRAN nº 210/06, 211/06 e 258/07 e alterações Portaria DENATRAN 63/09 e 59/07 e alterações ",Transitar com o veículo com excesso de peso - PBT/PBTC,5,11,202111,153461,153456,5
6407641b305a576376e6f4c2,Evasão de Balança,NOVEMBRO,2021,RJ,"Lei 9503 DE 23/09/1997 Transpor, sem autorização, bloqueio viário com ou sem sinalização ou dispositivos auxiliares, deixar de adentrar às áreas destinadas à pesagem de veículos ou evadir-se para não efetuar o pagamento do pedágio.",Art. 209 Deixar de adentrar as áreas destinadas à pesagem de veículos,4392,11,202111,153456,149064,4392
6407641b305a576376e6f4bc,CMT - Capacidade Máxima de Tração,NOVEMBRO,2021,RS,"Lei 9503/97 Lei 10561/02 Res. CONTRAN nº 210/06, 211/06 e 258/07 e alterações Portaria DENATRAN 63/09 e 59/07 e alterações ",Transitar com o veículo excedendo a CMT entre 601 e 1000 kg,1,11,202111,149064,149063,1
6407641b305a576376e6f4bb,CMT - Capacidade Máxima de Tração,NOVEMBRO,2021,RJ,"Lei 9503/97 Lei 10561/02 Res. CONTRAN nº 210/06, 211/06 e 258/07 e alterações Portaria DENATRAN 63/09 e 59/07 e alterações ",Transitar com o veículo excedendo a CMT em até 600 kg,4,11,202111,149063,149059,4
6407641b305a576376e6f4b7,CMT - Capacidade Máxima de Tração,NOVEMBRO,2021,ES,"Lei 9503/97 Lei 10561/02 Res. CONTRAN nº 210/06, 211/06 e 258/07 e alterações Portaria DENATRAN 63/09 e 59/07 e alterações ",Transitar com o veículo excedendo a CMT acima de 1000 kg,1,11,202111,149059,149058,1
6407641b305a576376e6f4d7,Excesso de Peso,NOVEMBRO,2021,RS,"Lei 9503/97 Lei 10561/02 Res. CONTRAN nº 210/06, 211/06 e 258/07 e alterações Portaria DENATRAN 63/09 e 59/07 e alterações ",Transitar com o veículo com excesso de peso - PBT/PBTC e Por Eixo,46,11,202111,69205,69159,46
6407641b305a576376e6f4ca,Excesso de Peso,NOVEMBRO,2021,GO,"Lei 9503/97 Lei 10561/02 Res. CONTRAN nº 210/06, 211/06 e 258/07 e alterações Portaria DENATRAN 63/09 e 59/07 e alterações ",Transitar com o veículo com excesso de peso - Por Eixo,201,11,202111,202836,202635,201
6407641b305a576376e6f4dc,Excesso de Peso,NOVEMBRO,2021,SC,"Lei 9503/97 Lei 10561/02 Res. CONTRAN nº 210/06, 211/06 e 258/07 e alterações Portaria DENATRAN 63/09 e 59/07 e alterações ",Transitar com o veículo com excesso de peso - Por Eixo,292,11,202111,69497,69205,292
6407641b305a576376e6f509,Excesso de Peso,DEZEMBRO,2021,SP,"Lei 9503/97 Lei 10561/02 Res. CONTRAN nº 210/06, 211/06 e 258/07 e alterações Portaria DENATRAN 63/09 e 59/07 e alterações ",Transitar com o veículo com excesso de peso - Por Eixo,197,12,202112,206961,206764,197
6407641b305a576376e6f508,Excesso de Peso,DEZEMBRO,2021,SP,"Lei 9503/97 Lei 10561/02 Res. CONTRAN nº 210/06, 211/06 e 258/07 e alterações Portaria DENATRAN 63/09 e 59/07 e alterações ",Transitar com o veículo com excesso de peso - PBT/PBTC e Por Eixo,149,12,202112,206764,206615,149
6407641b305a576376e6f506,Excesso de Peso,DEZEMBRO,2021,SC,"Lei 9503/97 Lei 10561/02 Res. CONTRAN nº 210/06, 211/06 e 258/07 e alterações Portaria DENATRAN 63/09 e 59/07 e alterações ",Transitar com o veículo com excesso de peso - PBT/PBTC,176,12,202112,206615,206439,176
6407641b305a576376e6f505,Excesso de Peso,DEZEMBRO,2021,SC,"Lei 9503/97 Lei 10561/02 Res. CONTRAN nº 210/06, 211/06 e 258/07 e alterações Portaria DENATRAN 63/09 e 59/07 e alterações ",Transitar com o veículo com excesso de peso - PBT/PBTC e Por Eixo,160,12,202112,206439,206279,160
6407641b305a576376e6f4fb,Excesso de Peso,DEZEMBRO,2021,MT,"Lei 9503/97 Lei 10561/02 Res. CONTRAN nº 210/06, 211/06 e 258/07 e alterações Portaria DENATRAN 63/09 e 59/07 e alterações ",Transitar com o veículo com excesso de peso - Por Eixo,232,12,202112,206279,206047,232
6407641b305a576376e6f4f8,Excesso de Peso,DEZEMBRO,2021,MG,"Lei 9503/97 Lei 10561/02 Res. CONTRAN nº 210/06, 211/06 e 258/07 e alterações Portaria DENATRAN 63/09 e 59/07 e alterações ",Transitar com o veículo com excesso de peso - Por Eixo,609,12,202112,206047,205438,609
6407641b305a576376e6f4ef,Excesso de Peso,DEZEMBRO,2021,BA,"Lei 9503/97 Lei 10561/02 Res. CONTRAN nº 210/06, 211/06 e 258/07 e alterações Portaria DENATRAN 63/09 e 59/07 e alterações ",Transitar com o veículo com excesso de peso - PBT/PBTC,5,12,202112,205438,205433,5
6407641b305a576376e6f4e0,CMT - Capacidade Máxima de Tração,DEZEMBRO,2021,ES,"Lei 9503/97 Lei 10561/02 Res. CONTRAN nº 210/06, 211/06 e 258/07 e alterações Portaria DENATRAN 63/09 e 59/07 e alterações ",Transitar com o veículo excedendo a CMT entre 601 e 1000 kg,1,12,202112,204581,204580,1
6407641b305a576376e6f4ee,Evasão de Balança,DEZEMBRO,2021,SP,"Lei 9503 DE 23/09/1997 Transpor, sem autorização, bloqueio viário com ou sem sinalização ou dispositivos auxiliares, deixar de adentrar às áreas destinadas à pesagem de veículos ou evadir-se para não efetuar o pagamento do pedágio.",Art. 209 Deixar de adentrar as áreas destinadas à pesagem de veículos,851,12,202112,205433,204582,851
6407641b305a576376e6f4e5,CMT - Capacidade Máxima de Tração,DEZEMBRO,2021,RJ,"Lei 9503/97 Lei 10561/02 Res. CONTRAN nº 210/06, 211/06 e 258/07 e alterações Portaria DENATRAN 63/09 e 59/07 e alterações ",Transitar com o veículo excedendo a CMT entre 601 e 1000 kg,1,12,202112,204582,204581,1
6407641b305a576376e6f4fc,Excesso de Peso,DEZEMBRO,2021,PR,"Lei 9503/97 Lei 10561/02 Res. CONTRAN nº 210/06, 211/06 e 258/07 e alterações Portaria DENATRAN 63/09 e 59/07 e alterações ",Transitar com o veículo com excesso de peso - PBT/PBTC e Por Eixo,72,12,202112,70149,70077,72
6407641b305a576376e6f4e8,CMT - Capacidade Máxima de Tração,DEZEMBRO,2021,SP,"Lei 9503/97 Lei 10561/02 Res. CONTRAN nº 210/06, 211/06 e 258/07 e alterações Portaria DENATRAN 63/09 e 59/07 e alterações ",Transitar com o veículo excedendo a CMT em até 600 kg,1,12,202112,69499,69498,1
6407641b305a576376e6f4f3,Excesso de Peso,DEZEMBRO,2021,GO,"Lei 9503/97 Lei 10561/02 Res. CONTRAN nº 210/06, 211/06 e 258/07 e alterações Portaria DENATRAN 63/09 e 59/07 e alterações ",Transitar com o veículo com excesso de peso - PBT/PBTC,149,12,202112,69648,69499,149
6407641b305a576376e6f4f5,Excesso de Peso,DEZEMBRO,2021,GO,"Lei 9503/97 Lei 10561/02 Res. CONTRAN nº 210/06, 211/06 e 258/07 e alterações Portaria DENATRAN 63/09 e 59/07 e alterações ",Transitar com o veículo com excesso de peso - Por Eixo,380,12,202112,70028,69648,380
6407641b305a576376e6f4f9,Excesso de Peso,DEZEMBRO,2021,MT,"Lei 9503/97 Lei 10561/02 Res. CONTRAN nº 210/06, 211/06 e 258/07 e alterações Portaria DENATRAN 63/09 e 59/07 e alterações ",Transitar com o veículo com excesso de peso - PBT/PBTC e Por Eixo,49,12,202112,70077,70028,49
6407641b305a576376e6f4ec,Evasão de Balança,DEZEMBRO,2021,MT,"Lei 9503 DE 23/09/1997 Transpor, sem autorização, bloqueio viário com ou sem sinalização ou dispositivos auxiliares, deixar de adentrar às áreas destinadas à pesagem de veículos ou evadir-se para não efetuar o pagamento do pedágio.",Art. 209 Deixar de adentrar as áreas destinadas à pesagem de veículos,330,12,202112,95495,95165,330
6407641b305a576376e6f4f0,Excesso de Peso,DEZEMBRO,2021,ES,"Lei 9503/97 Lei 10561/02 Res. CONTRAN nº 210/06, 211/06 e 258/07 e alterações Portaria DENATRAN 63/09 e 59/07 e alterações ",Transitar com o veículo com excesso de peso - PBT/PBTC,124,12,202112,95619,95495,124
6407641b305a576376e6f4e1,CMT - Capacidade Máxima de Tração,DEZEMBRO,2021,ES,"Lei 9503/97 Lei 10561/02 Res. CONTRAN nº 210/06, 211/06 e 258/07 e alterações Portaria DENATRAN 63/09 e 59/07 e alterações ",Transitar com o veículo excedendo a CMT em até 600 kg,1,12,202112,69498,69497,1
6407641b305a576376e6f4f1,Excesso de Peso,DEZEMBRO,2021,ES,"Lei 9503/97 Lei 10561/02 Res. CONTRAN nº 210/06, 211/06 e 258/07 e alterações Portaria DENATRAN 63/09 e 59/07 e alterações ",Transitar com o veículo com excesso de peso - PBT/PBTC e Por Eixo,136,12,202112,95755,95619,136
6407641b305a576376e6f507,Excesso de Peso,DEZEMBRO,2021,SC,"Lei 9503/97 Lei 10561/02 Res. CONTRAN nº 210/06, 211/06 e 258/07 e alterações Portaria DENATRAN 63/09 e 59/07 e alterações ",Transitar com o veículo com excesso de peso - Por Eixo,272,12,202112,97756,97484,272
6407641b305a576376e6f503,Excesso de Peso,DEZEMBRO,2021,RS,"Lei 9503/97 Lei 10561/02 Res. CONTRAN nº 210/06, 211/06 e 258/07 e alterações Portaria DENATRAN 63/09 e 59/07 e alterações ",Transitar com o veículo com excesso de peso - PBT/PBTC,31,12,202112,97484,97453,31
6407641b305a576376e6f502,Excesso de Peso,DEZEMBRO,2021,RS,"Lei 9503/97 Lei 10561/02 Res. CONTRAN nº 210/06, 211/06 e 258/07 e alterações Portaria DENATRAN 63/09 e 59/07 e alterações ",Transitar com o veículo com excesso de peso - PBT/PBTC e Por Eixo,23,12,202112,97453,97430,23
6407641b305a576376e6f501,Excesso de Peso,DEZEMBRO,2021,RJ,"Lei 9503/97 Lei 10561/02 Res. CONTRAN nº 210/06, 211/06 e 258/07 e alterações Portaria DENATRAN 63/09 e 59/07 e alterações ",Transitar com o veículo com excesso de peso - Por Eixo,711,12,202112,97430,96719,711
6407641b305a576376e6f500,Excesso de Peso,DEZEMBRO,2021,RJ,"Lei 9503/97 Lei 10561/02 Res. CONTRAN nº 210/06, 211/06 e 258/07 e alterações Portaria DENATRAN 63/09 e 59/07 e alterações ",Transitar com o veículo com excesso de peso - PBT/PBTC,441,12,202112,96719,96278,441
6407641b305a576376e6f4fd,Excesso de Peso,DEZEMBRO,2021,PR,"Lei 9503/97 Lei 10561/02 Res. CONTRAN nº 210/06, 211/06 e 258/07 e alterações Portaria DENATRAN 63/09 e 59/07 e alterações ",Transitar com o veículo com excesso de peso - PBT/PBTC,103,12,202112,96278,96175,103
6407641b305a576376e6f4f4,Excesso de Peso,DEZEMBRO,2021,GO,"Lei 9503/97 Lei 10561/02 Res. CONTRAN nº 210/06, 211/06 e 258/07 e alterações Portaria DENATRAN 63/09 e 59/07 e alterações ",Transitar com o veículo com excesso de peso - PBT/PBTC e Por Eixo,151,12,202112,95906,95755,151
6407641b305a576376e6f4fa,Excesso de Peso,DEZEMBRO,2021,MT,"Lei 9503/97 Lei 10561/02 Res. CONTRAN nº 210/06, 211/06 e 258/07 e alterações Portaria DENATRAN 63/09 e 59/07 e alterações ",Transitar com o veículo com excesso de peso - PBT/PBTC,77,12,202112,96175,96098,77
6407641b305a576376e6f4e9,Evasão de Balança,DEZEMBRO,2021,ES,"Lei 9503 DE 23/09/1997 Transpor, sem autorização, bloqueio viário com ou sem sinalização ou dispositivos auxiliares, deixar de adentrar às áreas destinadas à pesagem de veículos ou evadir-se para não efetuar o pagamento do pedágio.",Art. 209 Deixar de adentrar as áreas destinadas à pesagem de veículos,194,12,202112,95165,94971,194
6407641b305a576376e6f4e4,CMT - Capacidade Máxima de Tração,DEZEMBRO,2021,MT,"Lei 9503/97 Lei 10561/02 Res. CONTRAN nº 210/06, 211/06 e 258/07 e alterações Portaria DENATRAN 63/09 e 59/07 e alterações ",Transitar com o veículo excedendo a CMT acima de 1000 kg,1,12,202112,94970,94969,1
6407641b305a576376e6f4e2,CMT - Capacidade Máxima de Tração,DEZEMBRO,2021,ES,"Lei 9503/97 Lei 10561/02 Res. CONTRAN nº 210/06, 211/06 e 258/07 e alterações Portaria DENATRAN 63/09 e 59/07 e alterações ",Transitar com o veículo excedendo a CMT acima de 1000 kg,1,12,202112,94968,94967,1
6407641b305a576376e6f4e3,CMT - Capacidade Máxima de Tração,DEZEMBRO,2021,MG,"Lei 9503/97 Lei 10561/02 Res. CONTRAN nº 210/06, 211/06 e 258/07 e alterações Portaria DENATRAN 63/09 e 59/07 e alterações ",Transitar com o veículo excedendo a CMT acima de 1000 kg,1,12,202112,94969,94968,1
6407641b305a576376e6f50a,Excesso de Peso,DEZEMBRO,2021,SP,"Lei 9503/97 Lei 10561/02 Res. CONTRAN nº 210/06, 211/06 e 258/07 e alterações Portaria DENATRAN 63/09 e 59/07 e alterações ",Transitar com o veículo com excesso de peso - PBT/PBTC,205,12,202112,160117,159912,205
6407641b305a576376e6f504,Excesso de Peso,DEZEMBRO,2021,RS,"Lei 9503/97 Lei 10561/02 Res. CONTRAN nº 210/06, 211/06 e 258/07 e alterações Portaria DENATRAN 63/09 e 59/07 e alterações ",Transitar com o veículo com excesso de peso - Por Eixo,177,12,202112,159912,159735,177
6407641b305a576376e6f4e6,CMT - Capacidade Máxima de Tração,DEZEMBRO,2021,RJ,"Lei 9503/97 Lei 10561/02 Res. CONTRAN nº 210/06, 211/06 e 258/07 e alterações Portaria DENATRAN 63/09 e 59/07 e alterações ",Transitar com o veículo excedendo a CMT em até 600 kg,1,12,202112,94971,94970,1
6407641b305a576376e6f4fe,Excesso de Peso,DEZEMBRO,2021,PR,"Lei 9503/97 Lei 10561/02 Res. CONTRAN nº 210/06, 211/06 e 258/07 e alterações Portaria DENATRAN 63/09 e 59/07 e alterações ",Transitar com o veículo com excesso de peso - Por Eixo,112,12,202112,159415,159303,112
6407641b305a576376e6f4ff,Excesso de Peso,DEZEMBRO,2021,RJ,"Lei 9503/97 Lei 10561/02 Res. CONTRAN nº 210/06, 211/06 e 258/07 e alterações Portaria DENATRAN 63/09 e 59/07 e alterações ",Transitar com o veículo com excesso de peso - PBT/PBTC e Por Eixo,320,12,202112,159735,159415,320
6407641b305a576376e6f4f2,Excesso de Peso,DEZEMBRO,2021,ES,"Lei 9503/97 Lei 10561/02 Res. CONTRAN nº 210/06, 211/06 e 258/07 e alterações Portaria DENATRAN 63/09 e 59/07 e alterações ",Transitar com o veículo com excesso de peso - Por Eixo,374,12,202112,159172,158798,374
6407641b305a576376e6f4ed,Evasão de Balança,DEZEMBRO,2021,RJ,"Lei 9503 DE 23/09/1997 Transpor, sem autorização, bloqueio viário com ou sem sinalização ou dispositivos auxiliares, deixar de adentrar às áreas destinadas à pesagem de veículos ou evadir-se para não efetuar o pagamento do pedágio.",Art. 209 Deixar de adentrar as áreas destinadas à pesagem de veículos,3099,12,202112,158798,155699,3099
6407641b305a576376e6f4eb,Evasão de Balança,DEZEMBRO,2021,MG,"Lei 9503 DE 23/09/1997 Transpor, sem autorização, bloqueio viário com ou sem sinalização ou dispositivos auxiliares, deixar de adentrar às áreas destinadas à pesagem de veículos ou evadir-se para não efetuar o pagamento do pedágio.",Art. 209 Deixar de adentrar as áreas destinadas à pesagem de veículos,637,12,202112,155699,155062,637
6407641b305a576376e6f4ea,Evasão de Balança,DEZEMBRO,2021,GO,"Lei 9503 DE 23/09/1997 Transpor, sem autorização, bloqueio viário com ou sem sinalização ou dispositivos auxiliares, deixar de adentrar às áreas destinadas à pesagem de veículos ou evadir-se para não efetuar o pagamento do pedágio.",Art. 209 Deixar de adentrar as áreas destinadas à pesagem de veículos,1021,12,202112,155062,154041,1021
6407641b305a576376e6f4e7,CMT - Capacidade Máxima de Tração,DEZEMBRO,2021,RJ,"Lei 9503/97 Lei 10561/02 Res. CONTRAN nº 210/06, 211/06 e 258/07 e alterações Portaria DENATRAN 63/09 e 59/07 e alterações ",Transitar com o veículo excedendo a CMT acima de 1000 kg,4,12,202112,154041,154037,4
6407641b305a576376e6f4f6,Excesso de Peso,DEZEMBRO,2021,MG,"Lei 9503/97 Lei 10561/02 Res. CONTRAN nº 210/06, 211/06 e 258/07 e alterações Portaria DENATRAN 63/09 e 59/07 e alterações ",Transitar com o veículo com excesso de peso - PBT/PBTC,131,12,202112,159303,159172,131
6407641b305a576376e6f4f7,Excesso de Peso,DEZEMBRO,2021,MG,"Lei 9503/97 Lei 10561/02 Res. CONTRAN nº 210/06, 211/06 e 258/07 e alterações Portaria DENATRAN 63/09 e 59/07 e alterações ",Transitar com o veículo com excesso de peso - PBT/PBTC e Por Eixo,192,12,202112,96098,95906,192
6407641b305a576376e6f517,Excesso de Peso,JANEIRO,2022,ES,"Lei 9503/97 Lei 10561/02 Res. CONTRAN nº 210/06, 211/06 e 258/07 e alterações Portaria DENATRAN 63/09 e 59/07 e alterações ",Transitar com o veículo com excesso de peso - PBT/PBTC e Por Eixo,96,1,202201,71131,71035,96
6407641b305a576376e6f51f,Excesso de Peso,JANEIRO,2022,MT,"Lei 9503/97 Lei 10561/02 Res. CONTRAN nº 210/06, 211/06 e 258/07 e alterações Portaria DENATRAN 63/09 e 59/07 e alterações ",Transitar com o veículo com excesso de peso - PBT/PBTC e Por Eixo,22,1,202201,71153,71131,22
6407641b305a576376e6f529,Excesso de Peso,JANEIRO,2022,RS,"Lei 9503/97 Lei 10561/02 Res. CONTRAN nº 210/06, 211/06 e 258/07 e alterações Portaria DENATRAN 63/09 e 59/07 e alterações ",Transitar com o veículo com excesso de peso - PBT/PBTC,10,1,202201,161112,161102,10
6407641b305a576376e6f510,Evasão de Balança,JANEIRO,2022,ES,"Lei 9503 DE 23/09/1997 Transpor, sem autorização, bloqueio viário com ou sem sinalização ou dispositivos auxiliares, deixar de adentrar às áreas destinadas à pesagem de veículos ou evadir-se para não efetuar o pagamento do pedágio.",Art. 209 Deixar de adentrar as áreas destinadas à pesagem de veículos,136,1,202201,70287,70151,136
6407641b305a576376e6f50d,CMT - Capacidade Máxima de Tração,JANEIRO,2022,RJ,"Lei 9503/97 Lei 10561/02 Res. CONTRAN nº 210/06, 211/06 e 258/07 e alterações Portaria DENATRAN 63/09 e 59/07 e alterações ",Transitar com o veículo excedendo a CMT em até 600 kg,2,1,202201,70151,70149,2
6407641b305a576376e6f520,Excesso de Peso,JANEIRO,2022,MT,"Lei 9503/97 Lei 10561/02 Res. CONTRAN nº 210/06, 211/06 e 258/07 e alterações Portaria DENATRAN 63/09 e 59/07 e alterações ",Transitar com o veículo com excesso de peso - PBT/PBTC,26,1,202201,71179,71153,26
6407641b305a576376e6f50f,CMT - Capacidade Máxima de Tração,JANEIRO,2022,SC,"Lei 9503/97 Lei 10561/02 Res. CONTRAN nº 210/06, 211/06 e 258/07 e alterações Portaria DENATRAN 63/09 e 59/07 e alterações ",Transitar com o veículo excedendo a CMT acima de 1000 kg,1,1,202201,206962,206961,1
6407641b305a576376e6f511,Evasão de Balança,JANEIRO,2022,GO,"Lei 9503 DE 23/09/1997 Transpor, sem autorização, bloqueio viário com ou sem sinalização ou dispositivos auxiliares, deixar de adentrar às áreas destinadas à pesagem de veículos ou evadir-se para não efetuar o pagamento do pedágio.",Art. 209 Deixar de adentrar as áreas destinadas à pesagem de veículos,678,1,202201,207640,206962,678
6407641b305a576376e6f51a,Excesso de Peso,JANEIRO,2022,GO,"Lei 9503/97 Lei 10561/02 Res. CONTRAN nº 210/06, 211/06 e 258/07 e alterações Portaria DENATRAN 63/09 e 59/07 e alterações ",Transitar com o veículo com excesso de peso - PBT/PBTC,159,1,202201,208037,207878,159
6407641b305a576376e6f51c,Excesso de Peso,JANEIRO,2022,MG,"Lei 9503/97 Lei 10561/02 Res. CONTRAN nº 210/06, 211/06 e 258/07 e alterações Portaria DENATRAN 63/09 e 59/07 e alterações ",Transitar com o veículo com excesso de peso - PBT/PBTC e Por Eixo,221,1,202201,208258,208037,221
6407641b305a576376e6f51d,Excesso de Peso,JANEIRO,2022,MG,"Lei 9503/97 Lei 10561/02 Res. CONTRAN nº 210/06, 211/06 e 258/07 e alterações Portaria DENATRAN 63/09 e 59/07 e alterações ",Transitar com o veículo com excesso de peso - PBT/PBTC,224,1,202201,208482,208258,224
6407641b305a576376e6f52e,Excesso de Peso,JANEIRO,2022,SP,"Lei 9503/97 Lei 10561/02 Res. CONTRAN nº 210/06, 211/06 e 258/07 e alterações Portaria DENATRAN 63/09 e 59/07 e alterações ",Transitar com o veículo com excesso de peso - PBT/PBTC e Por Eixo,99,1,202201,208581,208482,99
6407641b305a576376e6f52b,Excesso de Peso,JANEIRO,2022,SC,"Lei 9503/97 Lei 10561/02 Res. CONTRAN nº 210/06, 211/06 e 258/07 e alterações Portaria DENATRAN 63/09 e 59/07 e alterações ",Transitar com o veículo com excesso de peso - PBT/PBTC,330,1,202201,161442,161112,330
6407641b305a576376e6f515,Evasão de Balança,JANEIRO,2022,SP,"Lei 9503 DE 23/09/1997 Transpor, sem autorização, bloqueio viário com ou sem sinalização ou dispositivos auxiliares, deixar de adentrar às áreas destinadas à pesagem de veículos ou evadir-se para não efetuar o pagamento do pedágio.",Art. 209 Deixar de adentrar as áreas destinadas à pesagem de veículos,748,1,202201,71035,70287,748
6407641b305a576376e6f521,Excesso de Peso,JANEIRO,2022,MT,"Lei 9503/97 Lei 10561/02 Res. CONTRAN nº 210/06, 211/06 e 258/07 e alterações Portaria DENATRAN 63/09 e 59/07 e alterações ",Transitar com o veículo com excesso de peso - Por Eixo,236,1,202201,71415,71179,236
6407641b305a576376e6f518,Excesso de Peso,JANEIRO,2022,ES,"Lei 9503/97 Lei 10561/02 Res. CONTRAN nº 210/06, 211/06 e 258/07 e alterações Portaria DENATRAN 63/09 e 59/07 e alterações ",Transitar com o veículo com excesso de peso - Por Eixo,238,1,202201,207878,207640,238
6407641b305a576376e6f523,Excesso de Peso,JANEIRO,2022,PR,"Lei 9503/97 Lei 10561/02 Res. CONTRAN nº 210/06, 211/06 e 258/07 e alterações Portaria DENATRAN 63/09 e 59/07 e alterações ",Transitar com o veículo com excesso de peso - PBT/PBTC,29,1,202201,71469,71440,29
6407641b305a576376e6f528,Excesso de Peso,JANEIRO,2022,RS,"Lei 9503/97 Lei 10561/02 Res. CONTRAN nº 210/06, 211/06 e 258/07 e alterações Portaria DENATRAN 63/09 e 59/07 e alterações ",Transitar com o veículo com excesso de peso - PBT/PBTC e Por Eixo,7,1,202201,161102,161095,7
6407641b305a576376e6f522,Excesso de Peso,JANEIRO,2022,PR,"Lei 9503/97 Lei 10561/02 Res. CONTRAN nº 210/06, 211/06 e 258/07 e alterações Portaria DENATRAN 63/09 e 59/07 e alterações ",Transitar com o veículo com excesso de peso - PBT/PBTC e Por Eixo,25,1,202201,71440,71415,25
6407641b305a576376e6f527,Excesso de Peso,JANEIRO,2022,RJ,"Lei 9503/97 Lei 10561/02 Res. CONTRAN nº 210/06, 211/06 e 258/07 e alterações Portaria DENATRAN 63/09 e 59/07 e alterações ",Transitar com o veículo com excesso de peso - Por Eixo,803,1,202201,161095,160292,803
6407641b305a576376e6f512,Evasão de Balança,JANEIRO,2022,MG,"Lei 9503 DE 23/09/1997 Transpor, sem autorização, bloqueio viário com ou sem sinalização ou dispositivos auxiliares, deixar de adentrar às áreas destinadas à pesagem de veículos ou evadir-se para não efetuar o pagamento do pedágio.",Art. 209 Deixar de adentrar as áreas destinadas à pesagem de veículos,172,1,202201,160292,160120,172
6407641b305a576376e6f50c,CMT - Capacidade Máxima de Tração,JANEIRO,2022,MG,"Lei 9503/97 Lei 10561/02 Res. CONTRAN nº 210/06, 211/06 e 258/07 e alterações Portaria DENATRAN 63/09 e 59/07 e alterações ",Transitar com o veículo excedendo a CMT acima de 1000 kg,3,1,202201,160120,160117,3
6407641b305a576376e6f52f,Excesso de Peso,JANEIRO,2022,SP,"Lei 9503/97 Lei 10561/02 Res. CONTRAN nº 210/06, 211/06 e 258/07 e alterações Portaria DENATRAN 63/09 e 59/07 e alterações ",Transitar com o veículo com excesso de peso - PBT/PBTC,103,1,202201,102858,102755,103
6407641b305a576376e6f52c,Excesso de Peso,JANEIRO,2022,SC,"Lei 9503/97 Lei 10561/02 Res. CONTRAN nº 210/06, 211/06 e 258/07 e alterações Portaria DENATRAN 63/09 e 59/07 e alterações ",Transitar com o veículo com excesso de peso - PBT/PBTC e Por Eixo,353,1,202201,102755,102402,353
6407641b305a576376e6f525,Excesso de Peso,JANEIRO,2022,RJ,"Lei 9503/97 Lei 10561/02 Res. CONTRAN nº 210/06, 211/06 e 258/07 e alterações Portaria DENATRAN 63/09 e 59/07 e alterações ",Transitar com o veículo com excesso de peso - PBT/PBTC e Por Eixo,372,1,202201,102402,102030,372
6407641b305a576376e6f524,Excesso de Peso,JANEIRO,2022,PR,"Lei 9503/97 Lei 10561/02 Res. CONTRAN nº 210/06, 211/06 e 258/07 e alterações Portaria DENATRAN 63/09 e 59/07 e alterações ",Transitar com o veículo com excesso de peso - Por Eixo,44,1,202201,102030,101986,44
6407641b305a576376e6f51e,Excesso de Peso,JANEIRO,2022,MG,"Lei 9503/97 Lei 10561/02 Res. CONTRAN nº 210/06, 211/06 e 258/07 e alterações Portaria DENATRAN 63/09 e 59/07 e alterações ",Transitar com o veículo com excesso de peso - Por Eixo,754,1,202201,101986,101232,754
6407641b305a576376e6f530,Excesso de Peso,JANEIRO,2022,SP,"Lei 9503/97 Lei 10561/02 Res. CONTRAN nº 210/06, 211/06 e 258/07 e alterações Portaria DENATRAN 63/09 e 59/07 e alterações ",Transitar com o veículo com excesso de peso - Por Eixo,136,1,202201,259323,259187,136
6407641b305a576376e6f519,Excesso de Peso,JANEIRO,2022,GO,"Lei 9503/97 Lei 10561/02 Res. CONTRAN nº 210/06, 211/06 e 258/07 e alterações Portaria DENATRAN 63/09 e 59/07 e alterações ",Transitar com o veículo com excesso de peso - PBT/PBTC e Por Eixo,126,1,202201,100879,100753,126
6407641b305a576376e6f51b,Excesso de Peso,JANEIRO,2022,GO,"Lei 9503/97 Lei 10561/02 Res. CONTRAN nº 210/06, 211/06 e 258/07 e alterações Portaria DENATRAN 63/09 e 59/07 e alterações ",Transitar com o veículo com excesso de peso - Por Eixo,353,1,202201,101232,100879,353
6407641b305a576376e6f526,Excesso de Peso,JANEIRO,2022,RJ,"Lei 9503/97 Lei 10561/02 Res. CONTRAN nº 210/06, 211/06 e 258/07 e alterações Portaria DENATRAN 63/09 e 59/07 e alterações ",Transitar com o veículo com excesso de peso - PBT/PBTC,459,1,202201,71928,71469,459
6407641b305a576376e6f52d,Excesso de Peso,JANEIRO,2022,SC,"Lei 9503/97 Lei 10561/02 Res. CONTRAN nº 210/06, 211/06 e 258/07 e alterações Portaria DENATRAN 63/09 e 59/07 e alterações ",Transitar com o veículo com excesso de peso - Por Eixo,677,1,202201,72656,71979,677
6407641b305a576376e6f50b,CMT - Capacidade Máxima de Tração,JANEIRO,2022,MG,"Lei 9503/97 Lei 10561/02 Res. CONTRAN nº 210/06, 211/06 e 258/07 e alterações Portaria DENATRAN 63/09 e 59/07 e alterações ",Transitar com o veículo excedendo a CMT em até 600 kg,1,1,202201,97757,97756,1
6407641b305a576376e6f52a,Excesso de Peso,JANEIRO,2022,RS,"Lei 9503/97 Lei 10561/02 Res. CONTRAN nº 210/06, 211/06 e 258/07 e alterações Portaria DENATRAN 63/09 e 59/07 e alterações ",Transitar com o veículo com excesso de peso - Por Eixo,51,1,202201,71979,71928,51
6407641b305a576376e6f513,Evasão de Balança,JANEIRO,2022,MT,"Lei 9503 DE 23/09/1997 Transpor, sem autorização, bloqueio viário com ou sem sinalização ou dispositivos auxiliares, deixar de adentrar às áreas destinadas à pesagem de veículos ou evadir-se para não efetuar o pagamento do pedágio.",Art. 209 Deixar de adentrar as áreas destinadas à pesagem de veículos,899,1,202201,98660,97761,899
6407641b305a576376e6f516,Excesso de Peso,JANEIRO,2022,ES,"Lei 9503/97 Lei 10561/02 Res. CONTRAN nº 210/06, 211/06 e 258/07 e alterações Portaria DENATRAN 63/09 e 59/07 e alterações ",Transitar com o veículo com excesso de peso - PBT/PBTC,71,1,202201,100753,100682,71
6407641b305a576376e6f514,Evasão de Balança,JANEIRO,2022,RJ,"Lei 9503 DE 23/09/1997 Transpor, sem autorização, bloqueio viário com ou sem sinalização ou dispositivos auxiliares, deixar de adentrar às áreas destinadas à pesagem de veículos ou evadir-se para não efetuar o pagamento do pedágio.",Art. 209 Deixar de adentrar as áreas destinadas à pesagem de veículos,2022,1,202201,100682,98660,2022
6407641b305a576376e6f50e,CMT - Capacidade Máxima de Tração,JANEIRO,2022,RJ,"Lei 9503/97 Lei 10561/02 Res. CONTRAN nº 210/06, 211/06 e 258/07 e alterações Portaria DENATRAN 63/09 e 59/07 e alterações ",Transitar com o veículo excedendo a CMT acima de 1000 kg,4,1,202201,97761,97757,4
6407641b305a576376e6f53e,Excesso de Peso,FEVEREIRO,2022,ES,"Lei 9503/97 Lei 10561/02 Res. CONTRAN nº 210/06, 211/06 e 258/07 e alterações Portaria DENATRAN 63/09 e 59/07 e alterações ",Transitar com o veículo com excesso de peso - PBT/PBTC,60,2,202202,260184,260124,60
6407641b305a576376e6f533,CMT - Capacidade Máxima de Tração,FEVEREIRO,2022,RJ,"Lei 9503/97 Lei 10561/02 Res. CONTRAN nº 210/06, 211/06 e 258/07 e alterações Portaria DENATRAN 63/09 e 59/07 e alterações ",Transitar com o veículo excedendo a CMT em até 600 kg,2,2,202202,335070,335068,2
6407641b305a576376e6f532,CMT - Capacidade Máxima de Tração,FEVEREIRO,2022,MG,"Lei 9503/97 Lei 10561/02 Res. CONTRAN nº 210/06, 211/06 e 258/07 e alterações Portaria DENATRAN 63/09 e 59/07 e alterações ",Transitar com o veículo excedendo a CMT acima de 1000 kg,2,2,202202,335068,335066,2
6407641b305a576376e6f54f,Excesso de Peso,FEVEREIRO,2022,SC,"Lei 9503/97 Lei 10561/02 Res. CONTRAN nº 210/06, 211/06 e 258/07 e alterações Portaria DENATRAN 63/09 e 59/07 e alterações ",Transitar com o veículo com excesso de peso - Por Eixo,617,2,202202,286387,285770,617
6407641b305a576376e6f54c,Excesso de Peso,FEVEREIRO,2022,RJ,"Lei 9503/97 Lei 10561/02 Res. CONTRAN nº 210/06, 211/06 e 258/07 e alterações Portaria DENATRAN 63/09 e 59/07 e alterações ",Transitar com o veículo com excesso de peso - Por Eixo,787,2,202202,285770,284983,787
6407641b305a576376e6f549,Excesso de Peso,FEVEREIRO,2022,MT,"Lei 9503/97 Lei 10561/02 Res. CONTRAN nº 210/06, 211/06 e 258/07 e alterações Portaria DENATRAN 63/09 e 59/07 e alterações ",Transitar com o veículo com excesso de peso - Por Eixo,415,2,202202,284983,284568,415
6407641b305a576376e6f541,Excesso de Peso,FEVEREIRO,2022,GO,"Lei 9503/97 Lei 10561/02 Res. CONTRAN nº 210/06, 211/06 e 258/07 e alterações Portaria DENATRAN 63/09 e 59/07 e alterações ",Transitar com o veículo com excesso de peso - PBT/PBTC e Por Eixo,126,2,202202,284568,284442,126
6407641b305a576376e6f53a,Evasão de Balança,FEVEREIRO,2022,MT,"Lei 9503 DE 23/09/1997 Transpor, sem autorização, bloqueio viário com ou sem sinalização ou dispositivos auxiliares, deixar de adentrar às áreas destinadas à pesagem de veículos ou evadir-se para não efetuar o pagamento do pedágio.",Art. 209 Deixar de adentrar as áreas destinadas à pesagem de veículos,1600,2,202202,284430,282830,1600
6407641b305a576376e6f539,Evasão de Balança,FEVEREIRO,2022,MG,"Lei 9503 DE 23/09/1997 Transpor, sem autorização, bloqueio viário com ou sem sinalização ou dispositivos auxiliares, deixar de adentrar às áreas destinadas à pesagem de veículos ou evadir-se para não efetuar o pagamento do pedágio.",Art. 209 Deixar de adentrar as áreas destinadas à pesagem de veículos,3163,2,202202,282830,279667,3163
6407641b305a576376e6f537,Evasão de Balança,FEVEREIRO,2022,ES,"Lei 9503 DE 23/09/1997 Transpor, sem autorização, bloqueio viário com ou sem sinalização ou dispositivos auxiliares, deixar de adentrar às áreas destinadas à pesagem de veículos ou evadir-se para não efetuar o pagamento do pedágio.",Art. 209 Deixar de adentrar as áreas destinadas à pesagem de veículos,463,2,202202,279667,279204,463
6407641b305a576376e6f54b,Excesso de Peso,FEVEREIRO,2022,RJ,"Lei 9503/97 Lei 10561/02 Res. CONTRAN nº 210/06, 211/06 e 258/07 e alterações Portaria DENATRAN 63/09 e 59/07 e alterações ",Transitar com o veículo com excesso de peso - PBT/PBTC,459,2,202202,335529,335070,459
6407641b305a576376e6f54d,Excesso de Peso,FEVEREIRO,2022,SC,"Lei 9503/97 Lei 10561/02 Res. CONTRAN nº 210/06, 211/06 e 258/07 e alterações Portaria DENATRAN 63/09 e 59/07 e alterações ",Transitar com o veículo com excesso de peso - PBT/PBTC,292,2,202202,261024,260732,292
6407641b305a576376e6f547,Excesso de Peso,FEVEREIRO,2022,MT,"Lei 9503/97 Lei 10561/02 Res. CONTRAN nº 210/06, 211/06 e 258/07 e alterações Portaria DENATRAN 63/09 e 59/07 e alterações ",Transitar com o veículo com excesso de peso - PBT/PBTC,51,2,202202,260732,260681,51
6407641b305a576376e6f543,Excesso de Peso,FEVEREIRO,2022,GO,"Lei 9503/97 Lei 10561/02 Res. CONTRAN nº 210/06, 211/06 e 258/07 e alterações Portaria DENATRAN 63/09 e 59/07 e alterações ",Transitar com o veículo com excesso de peso - Por Eixo,434,2,202202,260681,260247,434
6407641b305a576376e6f53f,Excesso de Peso,FEVEREIRO,2022,ES,"Lei 9503/97 Lei 10561/02 Res. CONTRAN nº 210/06, 211/06 e 258/07 e alterações Portaria DENATRAN 63/09 e 59/07 e alterações ",Transitar com o veículo com excesso de peso - PBT/PBTC e Por Eixo,63,2,202202,260247,260184,63
6407641b305a576376e6f53c,Evasão de Balança,FEVEREIRO,2022,SP,"Lei 9503 DE 23/09/1997 Transpor, sem autorização, bloqueio viário com ou sem sinalização ou dispositivos auxiliares, deixar de adentrar às áreas destinadas à pesagem de veículos ou evadir-se para não efetuar o pagamento do pedágio.",Art. 209 Deixar de adentrar as áreas destinadas à pesagem de veículos,799,2,202202,260124,259325,799
6407641b305a576376e6f53d,Excesso de Peso,FEVEREIRO,2022,BA,"Lei 9503/97 Lei 10561/02 Res. CONTRAN nº 210/06, 211/06 e 258/07 e alterações Portaria DENATRAN 63/09 e 59/07 e alterações ",Transitar com o veículo com excesso de peso - PBT/PBTC,12,2,202202,284442,284430,12
6407641b305a576376e6f531,CMT - Capacidade Máxima de Tração,FEVEREIRO,2022,ES,"Lei 9503/97 Lei 10561/02 Res. CONTRAN nº 210/06, 211/06 e 258/07 e alterações Portaria DENATRAN 63/09 e 59/07 e alterações ",Transitar com o veículo excedendo a CMT entre 601 e 1000 kg,2,2,202202,279204,279202,2
6407641b305a576376e6f54e,Excesso de Peso,FEVEREIRO,2022,SC,"Lei 9503/97 Lei 10561/02 Res. CONTRAN nº 210/06, 211/06 e 258/07 e alterações Portaria DENATRAN 63/09 e 59/07 e alterações ",Transitar com o veículo com excesso de peso - PBT/PBTC e Por Eixo,364,2,202202,335893,335529,364
6407641b305a576376e6f550,Excesso de Peso,FEVEREIRO,2022,SP,"Lei 9503/97 Lei 10561/02 Res. CONTRAN nº 210/06, 211/06 e 258/07 e alterações Portaria DENATRAN 63/09 e 59/07 e alterações ",Transitar com o veículo com excesso de peso - PBT/PBTC e Por Eixo,96,2,202202,214520,214424,96
6407641b305a576376e6f54a,Excesso de Peso,FEVEREIRO,2022,RJ,"Lei 9503/97 Lei 10561/02 Res. CONTRAN nº 210/06, 211/06 e 258/07 e alterações Portaria DENATRAN 63/09 e 59/07 e alterações ",Transitar com o veículo com excesso de peso - PBT/PBTC e Por Eixo,319,2,202202,214424,214105,319
6407641b305a576376e6f548,Excesso de Peso,FEVEREIRO,2022,MT,"Lei 9503/97 Lei 10561/02 Res. CONTRAN nº 210/06, 211/06 e 258/07 e alterações Portaria DENATRAN 63/09 e 59/07 e alterações ",Transitar com o veículo com excesso de peso - PBT/PBTC e Por Eixo,75,2,202202,214105,214030,75
6407641b305a576376e6f546,Excesso de Peso,FEVEREIRO,2022,MG,"Lei 9503/97 Lei 10561/02 Res. CONTRAN nº 210/06, 211/06 e 258/07 e alterações Portaria DENATRAN 63/09 e 59/07 e alterações ",Transitar com o veículo com excesso de peso - Por Eixo,770,2,202202,214030,213260,770
6407641b305a576376e6f545,Excesso de Peso,FEVEREIRO,2022,MG,"Lei 9503/97 Lei 10561/02 Res. CONTRAN nº 210/06, 211/06 e 258/07 e alterações Portaria DENATRAN 63/09 e 59/07 e alterações ",Transitar com o veículo com excesso de peso - PBT/PBTC,241,2,202202,213260,213019,241
6407641b305a576376e6f544,Excesso de Peso,FEVEREIRO,2022,MG,"Lei 9503/97 Lei 10561/02 Res. CONTRAN nº 210/06, 211/06 e 258/07 e alterações Portaria DENATRAN 63/09 e 59/07 e alterações ",Transitar com o veículo com excesso de peso - PBT/PBTC e Por Eixo,222,2,202202,213019,212797,222
6407641b305a576376e6f542,Excesso de Peso,FEVEREIRO,2022,GO,"Lei 9503/97 Lei 10561/02 Res. CONTRAN nº 210/06, 211/06 e 258/07 e alterações Portaria DENATRAN 63/09 e 59/07 e alterações ",Transitar com o veículo com excesso de peso - PBT/PBTC,135,2,202202,212797,212662,135
6407641b305a576376e6f540,Excesso de Peso,FEVEREIRO,2022,ES,"Lei 9503/97 Lei 10561/02 Res. CONTRAN nº 210/06, 211/06 e 258/07 e alterações Portaria DENATRAN 63/09 e 59/07 e alterações ",Transitar com o veículo com excesso de peso - Por Eixo,296,2,202202,212662,212366,296
6407641b305a576376e6f552,Excesso de Peso,FEVEREIRO,2022,SP,"Lei 9503/97 Lei 10561/02 Res. CONTRAN nº 210/06, 211/06 e 258/07 e alterações Portaria DENATRAN 63/09 e 59/07 e alterações ",Transitar com o veículo com excesso de peso - Por Eixo,189,2,202202,214709,214520,189
6407641b305a576376e6f551,Excesso de Peso,FEVEREIRO,2022,SP,"Lei 9503/97 Lei 10561/02 Res. CONTRAN nº 210/06, 211/06 e 258/07 e alterações Portaria DENATRAN 63/09 e 59/07 e alterações ",Transitar com o veículo com excesso de peso - PBT/PBTC,112,2,202202,336005,335893,112
6407641b305a576376e6f53b,Evasão de Balança,FEVEREIRO,2022,RJ,"Lei 9503 DE 23/09/1997 Transpor, sem autorização, bloqueio viário com ou sem sinalização ou dispositivos auxiliares, deixar de adentrar às áreas destinadas à pesagem de veículos ou evadir-se para não efetuar o pagamento do pedágio.",Art. 209 Deixar de adentrar as áreas destinadas à pesagem de veículos,2939,2,202202,212366,209427,2939
6407641b305a576376e6f538,Evasão de Balança,FEVEREIRO,2022,GO,"Lei 9503 DE 23/09/1997 Transpor, sem autorização, bloqueio viário com ou sem sinalização ou dispositivos auxiliares, deixar de adentrar às áreas destinadas à pesagem de veículos ou evadir-se para não efetuar o pagamento do pedágio.",Art. 209 Deixar de adentrar as áreas destinadas à pesagem de veículos,840,2,202202,209427,208587,840
6407641b305a576376e6f535,CMT - Capacidade Máxima de Tração,FEVEREIRO,2022,SC,"Lei 9503/97 Lei 10561/02 Res. CONTRAN nº 210/06, 211/06 e 258/07 e alterações Portaria DENATRAN 63/09 e 59/07 e alterações ",Transitar com o veículo excedendo a CMT acima de 1000 kg,1,2,202202,208587,208586,1
6407641b305a576376e6f534,CMT - Capacidade Máxima de Tração,FEVEREIRO,2022,RJ,"Lei 9503/97 Lei 10561/02 Res. CONTRAN nº 210/06, 211/06 e 258/07 e alterações Portaria DENATRAN 63/09 e 59/07 e alterações ",Transitar com o veículo excedendo a CMT acima de 1000 kg,5,2,202202,208586,208581,5
6407641b305a576376e6f536,CMT - Capacidade Máxima de Tração,FEVEREIRO,2022,SP,"Lei 9503/97 Lei 10561/02 Res. CONTRAN nº 210/06, 211/06 e 258/07 e alterações Portaria DENATRAN 63/09 e 59/07 e alterações ",Transitar com o veículo excedendo a CMT entre 601 e 1000 kg,2,2,202202,259325,259323,2
6407641b305a576376e6f557,CMT - Capacidade Máxima de Tração,MARÇO,2022,RJ,"Lei 9503/97 Lei 10561/02 Res. CONTRAN nº 210/06, 211/06 e 258/07 e alterações Portaria DENATRAN 63/09 e 59/07 e alterações ",Transitar com o veículo excedendo a CMT acima de 1000 kg,3,3,202203,261029,261026,3
6407641b305a576376e6f565,Excesso de Peso,MARÇO,2022,GO,"Lei 9503/97 Lei 10561/02 Res. CONTRAN nº 210/06, 211/06 e 258/07 e alterações Portaria DENATRAN 63/09 e 59/07 e alterações ",Transitar com o veículo com excesso de peso - PBT/PBTC,135,3,202203,265904,265769,135
6407641b305a576376e6f556,CMT - Capacidade Máxima de Tração,MARÇO,2022,RJ,"Lei 9503/97 Lei 10561/02 Res. CONTRAN nº 210/06, 211/06 e 258/07 e alterações Portaria DENATRAN 63/09 e 59/07 e alterações ",Transitar com o veículo excedendo a CMT em até 600 kg,2,3,202203,261026,261024,2
6407641b305a576376e6f577,Excesso de Peso,MARÇO,2022,SP,"Lei 9503/97 Lei 10561/02 Res. CONTRAN nº 210/06, 211/06 e 258/07 e alterações Portaria DENATRAN 63/09 e 59/07 e alterações ",Transitar com o veículo com excesso de peso - PBT/PBTC,154,3,202203,338099,337945,154
6407641b305a576376e6f55d,Evasão de Balança,MARÇO,2022,MT,"Lei 9503 DE 23/09/1997 Transpor, sem autorização, bloqueio viário com ou sem sinalização ou dispositivos auxiliares, deixar de adentrar às áreas destinadas à pesagem de veículos ou evadir-se para não efetuar o pagamento do pedágio.",Art. 209 Deixar de adentrar as áreas destinadas à pesagem de veículos,2305,3,202203,263334,261029,2305
6407641b305a576376e6f55e,Evasão de Balança,MARÇO,2022,RJ,"Lei 9503 DE 23/09/1997 Transpor, sem autorização, bloqueio viário com ou sem sinalização ou dispositivos auxiliares, deixar de adentrar às áreas destinadas à pesagem de veículos ou evadir-se para não efetuar o pagamento do pedágio.",Art. 209 Deixar de adentrar as áreas destinadas à pesagem de veículos,2435,3,202203,265769,263334,2435
6407641b305a576376e6f555,CMT - Capacidade Máxima de Tração,MARÇO,2022,MT,"Lei 9503/97 Lei 10561/02 Res. CONTRAN nº 210/06, 211/06 e 258/07 e alterações Portaria DENATRAN 63/09 e 59/07 e alterações ",Transitar com o veículo excedendo a CMT entre 601 e 1000 kg,1,3,202203,336006,336005,1
6407641b305a576376e6f558,CMT - Capacidade Máxima de Tração,MARÇO,2022,RJ,"Lei 9503/97 Lei 10561/02 Res. CONTRAN nº 210/06, 211/06 e 258/07 e alterações Portaria DENATRAN 63/09 e 59/07 e alterações ",Transitar com o veículo excedendo a CMT entre 601 e 1000 kg,4,3,202203,286393,286389,4
6407641b305a576376e6f567,Excesso de Peso,MARÇO,2022,MG,"Lei 9503/97 Lei 10561/02 Res. CONTRAN nº 210/06, 211/06 e 258/07 e alterações Portaria DENATRAN 63/09 e 59/07 e alterações ",Transitar com o veículo com excesso de peso - PBT/PBTC,264,3,202203,336270,336006,264
6407641b305a576376e6f56f,Excesso de Peso,MARÇO,2022,RJ,"Lei 9503/97 Lei 10561/02 Res. CONTRAN nº 210/06, 211/06 e 258/07 e alterações Portaria DENATRAN 63/09 e 59/07 e alterações ",Transitar com o veículo com excesso de peso - Por Eixo,986,3,202203,337256,336270,986
6407641b305a576376e6f578,Excesso de Peso,MARÇO,2022,SP,"Lei 9503/97 Lei 10561/02 Res. CONTRAN nº 210/06, 211/06 e 258/07 e alterações Portaria DENATRAN 63/09 e 59/07 e alterações ",Transitar com o veículo com excesso de peso - Por Eixo,155,3,202203,293893,293738,155
6407641b305a576376e6f575,Excesso de Peso,MARÇO,2022,SC,"Lei 9503/97 Lei 10561/02 Res. CONTRAN nº 210/06, 211/06 e 258/07 e alterações Portaria DENATRAN 63/09 e 59/07 e alterações ",Transitar com o veículo com excesso de peso - Por Eixo,607,3,202203,293738,293131,607
6407641b305a576376e6f573,Excesso de Peso,MARÇO,2022,SC,"Lei 9503/97 Lei 10561/02 Res. CONTRAN nº 210/06, 211/06 e 258/07 e alterações Portaria DENATRAN 63/09 e 59/07 e alterações ",Transitar com o veículo com excesso de peso - PBT/PBTC e Por Eixo,337,3,202203,337593,337256,337
6407641b305a576376e6f56e,Excesso de Peso,MARÇO,2022,RJ,"Lei 9503/97 Lei 10561/02 Res. CONTRAN nº 210/06, 211/06 e 258/07 e alterações Portaria DENATRAN 63/09 e 59/07 e alterações ",Transitar com o veículo com excesso de peso - PBT/PBTC,840,3,202203,293023,292183,840
6407641b305a576376e6f56c,Excesso de Peso,MARÇO,2022,MT,"Lei 9503/97 Lei 10561/02 Res. CONTRAN nº 210/06, 211/06 e 258/07 e alterações Portaria DENATRAN 63/09 e 59/07 e alterações ",Transitar com o veículo com excesso de peso - Por Eixo,442,3,202203,292183,291741,442
6407641b305a576376e6f554,CMT - Capacidade Máxima de Tração,MARÇO,2022,MG,"Lei 9503/97 Lei 10561/02 Res. CONTRAN nº 210/06, 211/06 e 258/07 e alterações Portaria DENATRAN 63/09 e 59/07 e alterações ",Transitar com o veículo excedendo a CMT em até 600 kg,2,3,202203,286389,286387,2
6407641b305a576376e6f56b,Excesso de Peso,MARÇO,2022,MT,"Lei 9503/97 Lei 10561/02 Res. CONTRAN nº 210/06, 211/06 e 258/07 e alterações Portaria DENATRAN 63/09 e 59/07 e alterações ",Transitar com o veículo com excesso de peso - PBT/PBTC e Por Eixo,78,3,202203,291741,291663,78
6407641b305a576376e6f564,Excesso de Peso,MARÇO,2022,GO,"Lei 9503/97 Lei 10561/02 Res. CONTRAN nº 210/06, 211/06 e 258/07 e alterações Portaria DENATRAN 63/09 e 59/07 e alterações ",Transitar com o veículo com excesso de peso - PBT/PBTC e Por Eixo,128,3,202203,291225,291097,128
6407641b305a576376e6f563,Excesso de Peso,MARÇO,2022,ES,"Lei 9503/97 Lei 10561/02 Res. CONTRAN nº 210/06, 211/06 e 258/07 e alterações Portaria DENATRAN 63/09 e 59/07 e alterações ",Transitar com o veículo com excesso de peso - Por Eixo,67,3,202203,291097,291030,67
6407641b305a576376e6f561,Excesso de Peso,MARÇO,2022,ES,"Lei 9503/97 Lei 10561/02 Res. CONTRAN nº 210/06, 211/06 e 258/07 e alterações Portaria DENATRAN 63/09 e 59/07 e alterações ",Transitar com o veículo com excesso de peso - PBT/PBTC e Por Eixo,13,3,202203,291030,291017,13
6407641b305a576376e6f55f,Evasão de Balança,MARÇO,2022,SP,"Lei 9503 DE 23/09/1997 Transpor, sem autorização, bloqueio viário com ou sem sinalização ou dispositivos auxiliares, deixar de adentrar às áreas destinadas à pesagem de veículos ou evadir-se para não efetuar o pagamento do pedágio.",Art. 209 Deixar de adentrar as áreas destinadas à pesagem de veículos,1436,3,202203,291017,289581,1436
6407641b305a576376e6f55c,Evasão de Balança,MARÇO,2022,MG,"Lei 9503 DE 23/09/1997 Transpor, sem autorização, bloqueio viário com ou sem sinalização ou dispositivos auxiliares, deixar de adentrar às áreas destinadas à pesagem de veículos ou evadir-se para não efetuar o pagamento do pedágio.",Art. 209 Deixar de adentrar as áreas destinadas à pesagem de veículos,1568,3,202203,289581,288013,1568
6407641b305a576376e6f574,Excesso de Peso,MARÇO,2022,SC,"Lei 9503/97 Lei 10561/02 Res. CONTRAN nº 210/06, 211/06 e 258/07 e alterações Portaria DENATRAN 63/09 e 59/07 e alterações ",Transitar com o veículo com excesso de peso - PBT/PBTC,352,3,202203,337945,337593,352
6407641b305a576376e6f55a,Evasão de Balança,MARÇO,2022,ES,"Lei 9503 DE 23/09/1997 Transpor, sem autorização, bloqueio viário com ou sem sinalização ou dispositivos auxiliares, deixar de adentrar às áreas destinadas à pesagem de veículos ou evadir-se para não efetuar o pagamento do pedágio.",Art. 209 Deixar de adentrar as áreas destinadas à pesagem de veículos,414,3,202203,286807,286393,414
6407641b305a576376e6f566,Excesso de Peso,MARÇO,2022,GO,"Lei 9503/97 Lei 10561/02 Res. CONTRAN nº 210/06, 211/06 e 258/07 e alterações Portaria DENATRAN 63/09 e 59/07 e alterações ",Transitar com o veículo com excesso de peso - Por Eixo,438,3,202203,291663,291225,438
6407641b305a576376e6f571,Excesso de Peso,MARÇO,2022,RS,"Lei 9503/97 Lei 10561/02 Res. CONTRAN nº 210/06, 211/06 e 258/07 e alterações Portaria DENATRAN 63/09 e 59/07 e alterações ",Transitar com o veículo com excesso de peso - PBT/PBTC,108,3,202203,293131,293023,108
6407641b305a576376e6f55b,Evasão de Balança,MARÇO,2022,GO,"Lei 9503 DE 23/09/1997 Transpor, sem autorização, bloqueio viário com ou sem sinalização ou dispositivos auxiliares, deixar de adentrar às áreas destinadas à pesagem de veículos ou evadir-se para não efetuar o pagamento do pedágio.",Art. 209 Deixar de adentrar as áreas destinadas à pesagem de veículos,1206,3,202203,288013,286807,1206
6407641b305a576376e6f572,Excesso de Peso,MARÇO,2022,RS,"Lei 9503/97 Lei 10561/02 Res. CONTRAN nº 210/06, 211/06 e 258/07 e alterações Portaria DENATRAN 63/09 e 59/07 e alterações ",Transitar com o veículo com excesso de peso - Por Eixo,351,3,202203,217053,216702,351
6407641b305a576376e6f576,Excesso de Peso,MARÇO,2022,SP,"Lei 9503/97 Lei 10561/02 Res. CONTRAN nº 210/06, 211/06 e 258/07 e alterações Portaria DENATRAN 63/09 e 59/07 e alterações ",Transitar com o veículo com excesso de peso - PBT/PBTC e Por Eixo,90,3,202203,217143,217053,90
6407641b305a576376e6f570,Excesso de Peso,MARÇO,2022,RS,"Lei 9503/97 Lei 10561/02 Res. CONTRAN nº 210/06, 211/06 e 258/07 e alterações Portaria DENATRAN 63/09 e 59/07 e alterações ",Transitar com o veículo com excesso de peso - PBT/PBTC e Por Eixo,80,3,202203,216702,216622,80
6407641b305a576376e6f559,CMT - Capacidade Máxima de Tração,MARÇO,2022,SC,"Lei 9503/97 Lei 10561/02 Res. CONTRAN nº 210/06, 211/06 e 258/07 e alterações Portaria DENATRAN 63/09 e 59/07 e alterações ",Transitar com o veículo excedendo a CMT entre 601 e 1000 kg,1,3,202203,214711,214710,1
6407641b305a576376e6f560,Excesso de Peso,MARÇO,2022,BA,"Lei 9503/97 Lei 10561/02 Res. CONTRAN nº 210/06, 211/06 e 258/07 e alterações Portaria DENATRAN 63/09 e 59/07 e alterações ",Transitar com o veículo com excesso de peso - PBT/PBTC,3,3,202203,214714,214711,3
6407641b305a576376e6f553,CMT - Capacidade Máxima de Tração,MARÇO,2022,MG,"Lei 9503/97 Lei 10561/02 Res. CONTRAN nº 210/06, 211/06 e 258/07 e alterações Portaria DENATRAN 63/09 e 59/07 e alterações ",Transitar com o veículo excedendo a CMT acima de 1000 kg,1,3,202203,214710,214709,1
6407641b305a576376e6f568,Excesso de Peso,MARÇO,2022,MG,"Lei 9503/97 Lei 10561/02 Res. CONTRAN nº 210/06, 211/06 e 258/07 e alterações Portaria DENATRAN 63/09 e 59/07 e alterações ",Transitar com o veículo com excesso de peso - PBT/PBTC e Por Eixo,290,3,202203,215026,214736,290
6407641b305a576376e6f569,Excesso de Peso,MARÇO,2022,MG,"Lei 9503/97 Lei 10561/02 Res. CONTRAN nº 210/06, 211/06 e 258/07 e alterações Portaria DENATRAN 63/09 e 59/07 e alterações ",Transitar com o veículo com excesso de peso - Por Eixo,1029,3,202203,216055,215026,1029
6407641b305a576376e6f56a,Excesso de Peso,MARÇO,2022,MT,"Lei 9503/97 Lei 10561/02 Res. CONTRAN nº 210/06, 211/06 e 258/07 e alterações Portaria DENATRAN 63/09 e 59/07 e alterações ",Transitar com o veículo com excesso de peso - PBT/PBTC,65,3,202203,216120,216055,65
6407641b305a576376e6f56d,Excesso de Peso,MARÇO,2022,RJ,"Lei 9503/97 Lei 10561/02 Res. CONTRAN nº 210/06, 211/06 e 258/07 e alterações Portaria DENATRAN 63/09 e 59/07 e alterações ",Transitar com o veículo com excesso de peso - PBT/PBTC e Por Eixo,502,3,202203,216622,216120,502
6407641b305a576376e6f562,Excesso de Peso,MARÇO,2022,ES,"Lei 9503/97 Lei 10561/02 Res. CONTRAN nº 210/06, 211/06 e 258/07 e alterações Portaria DENATRAN 63/09 e 59/07 e alterações ",Transitar com o veículo com excesso de peso - PBT/PBTC,22,3,202203,214736,214714,22
6407641b305a576376e6f584,Evasão de Balança,ABRIL,2022,MT,"Lei 9503 DE 23/09/1997 Transpor, sem autorização, bloqueio viário com ou sem sinalização ou dispositivos auxiliares, deixar de adentrar às áreas destinadas à pesagem de veículos ou evadir-se para não efetuar o pagamento do pedágio.",Art. 209 Deixar de adentrar as áreas destinadas à pesagem de veículos,2902,4,202204,220045,217143,2902
6407641b305a576376e6f586,Evasão de Balança,ABRIL,2022,SP,"Lei 9503 DE 23/09/1997 Transpor, sem autorização, bloqueio viário com ou sem sinalização ou dispositivos auxiliares, deixar de adentrar às áreas destinadas à pesagem de veículos ou evadir-se para não efetuar o pagamento do pedágio.",Art. 209 Deixar de adentrar as áreas destinadas à pesagem de veículos,1626,4,202204,221671,220045,1626
6407641b305a576376e6f587,Excesso de Peso,ABRIL,2022,BA,"Lei 9503/97 Lei 10561/02 Res. CONTRAN nº 210/06, 211/06 e 258/07 e alterações Portaria DENATRAN 63/09 e 59/07 e alterações ",Transitar com o veículo com excesso de peso - PBT/PBTC,1,4,202204,221672,221671,1
6407641b305a576376e6f58d,Excesso de Peso,ABRIL,2022,GO,"Lei 9503/97 Lei 10561/02 Res. CONTRAN nº 210/06, 211/06 e 258/07 e alterações Portaria DENATRAN 63/09 e 59/07 e alterações ",Transitar com o veículo com excesso de peso - Por Eixo,283,4,202204,221955,221672,283
6407641b305a576376e6f590,Excesso de Peso,ABRIL,2022,MG,"Lei 9503/97 Lei 10561/02 Res. CONTRAN nº 210/06, 211/06 e 258/07 e alterações Portaria DENATRAN 63/09 e 59/07 e alterações ",Transitar com o veículo com excesso de peso - Por Eixo,835,4,202204,222790,221955,835
6407641b305a576376e6f594,Excesso de Peso,ABRIL,2022,RJ,"Lei 9503/97 Lei 10561/02 Res. CONTRAN nº 210/06, 211/06 e 258/07 e alterações Portaria DENATRAN 63/09 e 59/07 e alterações ",Transitar com o veículo com excesso de peso - PBT/PBTC e Por Eixo,629,4,202204,223872,223243,629
6407641b305a576376e6f58f,Excesso de Peso,ABRIL,2022,MG,"Lei 9503/97 Lei 10561/02 Res. CONTRAN nº 210/06, 211/06 e 258/07 e alterações Portaria DENATRAN 63/09 e 59/07 e alterações ",Transitar com o veículo com excesso de peso - PBT/PBTC,281,4,202204,266758,266477,281
6407641b305a576376e6f59f,Excesso de Peso,ABRIL,2022,SP,"Lei 9503/97 Lei 10561/02 Res. CONTRAN nº 210/06, 211/06 e 258/07 e alterações Portaria DENATRAN 63/09 e 59/07 e alterações ",Transitar com o veículo com excesso de peso - Por Eixo,123,4,202204,224409,224286,123
6407641b305a576376e6f597,Excesso de Peso,ABRIL,2022,RS,"Lei 9503/97 Lei 10561/02 Res. CONTRAN nº 210/06, 211/06 e 258/07 e alterações Portaria DENATRAN 63/09 e 59/07 e alterações ",Transitar com o veículo com excesso de peso - PBT/PBTC e Por Eixo,101,4,202204,268083,267982,101
6407641b305a576376e6f596,Excesso de Peso,ABRIL,2022,RJ,"Lei 9503/97 Lei 10561/02 Res. CONTRAN nº 210/06, 211/06 e 258/07 e alterações Portaria DENATRAN 63/09 e 59/07 e alterações ",Transitar com o veículo com excesso de peso - Por Eixo,1224,4,202204,267982,266758,1224
6407641b305a576376e6f57b,CMT - Capacidade Máxima de Tração,ABRIL,2022,MG,"Lei 9503/97 Lei 10561/02 Res. CONTRAN nº 210/06, 211/06 e 258/07 e alterações Portaria DENATRAN 63/09 e 59/07 e alterações ",Transitar com o veículo excedendo a CMT acima de 1000 kg,2,4,202204,293895,293893,2
6407641b305a576376e6f58c,Excesso de Peso,ABRIL,2022,GO,"Lei 9503/97 Lei 10561/02 Res. CONTRAN nº 210/06, 211/06 e 258/07 e alterações Portaria DENATRAN 63/09 e 59/07 e alterações ",Transitar com o veículo com excesso de peso - PBT/PBTC,92,4,202204,266477,266385,92
6407641b305a576376e6f589,Excesso de Peso,ABRIL,2022,ES,"Lei 9503/97 Lei 10561/02 Res. CONTRAN nº 210/06, 211/06 e 258/07 e alterações Portaria DENATRAN 63/09 e 59/07 e alterações ",Transitar com o veículo com excesso de peso - PBT/PBTC,92,4,202204,266385,266293,92
6407641b305a576376e6f588,Excesso de Peso,ABRIL,2022,ES,"Lei 9503/97 Lei 10561/02 Res. CONTRAN nº 210/06, 211/06 e 258/07 e alterações Portaria DENATRAN 63/09 e 59/07 e alterações ",Transitar com o veículo com excesso de peso - PBT/PBTC e Por Eixo,78,4,202204,266293,266215,78
6407641b305a576376e6f583,Evasão de Balança,ABRIL,2022,MG,"Lei 9503 DE 23/09/1997 Transpor, sem autorização, bloqueio viário com ou sem sinalização ou dispositivos auxiliares, deixar de adentrar às áreas destinadas à pesagem de veículos ou evadir-se para não efetuar o pagamento do pedágio.",Art. 209 Deixar de adentrar as áreas destinadas à pesagem de veículos,300,4,202204,266215,265915,300
6407641b305a576376e6f599,Excesso de Peso,ABRIL,2022,RS,"Lei 9503/97 Lei 10561/02 Res. CONTRAN nº 210/06, 211/06 e 258/07 e alterações Portaria DENATRAN 63/09 e 59/07 e alterações ",Transitar com o veículo com excesso de peso - Por Eixo,414,4,202204,224286,223872,414
6407641b305a576376e6f57d,CMT - Capacidade Máxima de Tração,ABRIL,2022,RJ,"Lei 9503/97 Lei 10561/02 Res. CONTRAN nº 210/06, 211/06 e 258/07 e alterações Portaria DENATRAN 63/09 e 59/07 e alterações ",Transitar com o veículo excedendo a CMT em até 600 kg,10,4,202204,293905,293895,10
6407641b305a576376e6f58a,Excesso de Peso,ABRIL,2022,ES,"Lei 9503/97 Lei 10561/02 Res. CONTRAN nº 210/06, 211/06 e 258/07 e alterações Portaria DENATRAN 63/09 e 59/07 e alterações ",Transitar com o veículo com excesso de peso - Por Eixo,241,4,202204,295432,295191,241
6407641b305a576376e6f581,Evasão de Balança,ABRIL,2022,ES,"Lei 9503 DE 23/09/1997 Transpor, sem autorização, bloqueio viário com ou sem sinalização ou dispositivos auxiliares, deixar de adentrar às áreas destinadas à pesagem de veículos ou evadir-se para não efetuar o pagamento do pedágio.",Art. 209 Deixar de adentrar as áreas destinadas à pesagem de veículos,36,4,202204,293942,293906,36
6407641b305a576376e6f57a,CMT - Capacidade Máxima de Tração,ABRIL,2022,MG,"Lei 9503/97 Lei 10561/02 Res. CONTRAN nº 210/06, 211/06 e 258/07 e alterações Portaria DENATRAN 63/09 e 59/07 e alterações ",Transitar com o veículo excedendo a CMT em até 600 kg,1,4,202204,338100,338099,1
6407641b305a576376e6f57c,CMT - Capacidade Máxima de Tração,ABRIL,2022,RJ,"Lei 9503/97 Lei 10561/02 Res. CONTRAN nº 210/06, 211/06 e 258/07 e alterações Portaria DENATRAN 63/09 e 59/07 e alterações ",Transitar com o veículo excedendo a CMT entre 601 e 1000 kg,4,4,202204,338104,338100,4
6407641b305a576376e6f57f,CMT - Capacidade Máxima de Tração,ABRIL,2022,SC,"Lei 9503/97 Lei 10561/02 Res. CONTRAN nº 210/06, 211/06 e 258/07 e alterações Portaria DENATRAN 63/09 e 59/07 e alterações ",Transitar com o veículo excedendo a CMT acima de 1000 kg,3,4,202204,338107,338104,3
6407641b305a576376e6f585,Evasão de Balança,ABRIL,2022,RJ,"Lei 9503 DE 23/09/1997 Transpor, sem autorização, bloqueio viário com ou sem sinalização ou dispositivos auxiliares, deixar de adentrar às áreas destinadas à pesagem de veículos ou evadir-se para não efetuar o pagamento do pedágio.",Art. 209 Deixar de adentrar as áreas destinadas à pesagem de veículos,3804,4,202204,341911,338107,3804
6407641b305a576376e6f58b,Excesso de Peso,ABRIL,2022,GO,"Lei 9503/97 Lei 10561/02 Res. CONTRAN nº 210/06, 211/06 e 258/07 e alterações Portaria DENATRAN 63/09 e 59/07 e alterações ",Transitar com o veículo com excesso de peso - PBT/PBTC e Por Eixo,84,4,202204,341995,341911,84
6407641b305a576376e6f58e,Excesso de Peso,ABRIL,2022,MG,"Lei 9503/97 Lei 10561/02 Res. CONTRAN nº 210/06, 211/06 e 258/07 e alterações Portaria DENATRAN 63/09 e 59/07 e alterações ",Transitar com o veículo com excesso de peso - PBT/PBTC e Por Eixo,223,4,202204,342218,341995,223
6407641b305a576376e6f591,Excesso de Peso,ABRIL,2022,MT,"Lei 9503/97 Lei 10561/02 Res. CONTRAN nº 210/06, 211/06 e 258/07 e alterações Portaria DENATRAN 63/09 e 59/07 e alterações ",Transitar com o veículo com excesso de peso - PBT/PBTC e Por Eixo,51,4,202204,342269,342218,51
6407641b305a576376e6f595,Excesso de Peso,ABRIL,2022,RJ,"Lei 9503/97 Lei 10561/02 Res. CONTRAN nº 210/06, 211/06 e 258/07 e alterações Portaria DENATRAN 63/09 e 59/07 e alterações ",Transitar com o veículo com excesso de peso - PBT/PBTC,905,4,202204,343174,342269,905
6407641b305a576376e6f598,Excesso de Peso,ABRIL,2022,RS,"Lei 9503/97 Lei 10561/02 Res. CONTRAN nº 210/06, 211/06 e 258/07 e alterações Portaria DENATRAN 63/09 e 59/07 e alterações ",Transitar com o veículo com excesso de peso - PBT/PBTC,180,4,202204,343354,343174,180
6407641b305a576376e6f59a,Excesso de Peso,ABRIL,2022,SC,"Lei 9503/97 Lei 10561/02 Res. CONTRAN nº 210/06, 211/06 e 258/07 e alterações Portaria DENATRAN 63/09 e 59/07 e alterações ",Transitar com o veículo com excesso de peso - PBT/PBTC,246,4,202204,343600,343354,246
6407641b305a576376e6f59c,Excesso de Peso,ABRIL,2022,SC,"Lei 9503/97 Lei 10561/02 Res. CONTRAN nº 210/06, 211/06 e 258/07 e alterações Portaria DENATRAN 63/09 e 59/07 e alterações ",Transitar com o veículo com excesso de peso - Por Eixo,452,4,202204,344052,343600,452
6407641b305a576376e6f59d,Excesso de Peso,ABRIL,2022,SP,"Lei 9503/97 Lei 10561/02 Res. CONTRAN nº 210/06, 211/06 e 258/07 e alterações Portaria DENATRAN 63/09 e 59/07 e alterações ",Transitar com o veículo com excesso de peso - PBT/PBTC e Por Eixo,44,4,202204,344096,344052,44
6407641b305a576376e6f59e,Excesso de Peso,ABRIL,2022,SP,"Lei 9503/97 Lei 10561/02 Res. CONTRAN nº 210/06, 211/06 e 258/07 e alterações Portaria DENATRAN 63/09 e 59/07 e alterações ",Transitar com o veículo com excesso de peso - PBT/PBTC,87,4,202204,344183,344096,87
6407641b305a576376e6f59b,Excesso de Peso,ABRIL,2022,SC,"Lei 9503/97 Lei 10561/02 Res. CONTRAN nº 210/06, 211/06 e 258/07 e alterações Portaria DENATRAN 63/09 e 59/07 e alterações ",Transitar com o veículo com excesso de peso - PBT/PBTC e Por Eixo,258,4,202204,295758,295500,258
6407641b305a576376e6f592,Excesso de Peso,ABRIL,2022,MT,"Lei 9503/97 Lei 10561/02 Res. CONTRAN nº 210/06, 211/06 e 258/07 e alterações Portaria DENATRAN 63/09 e 59/07 e alterações ",Transitar com o veículo com excesso de peso - PBT/PBTC,68,4,202204,295500,295432,68
6407641b305a576376e6f57e,CMT - Capacidade Máxima de Tração,ABRIL,2022,RJ,"Lei 9503/97 Lei 10561/02 Res. CONTRAN nº 210/06, 211/06 e 258/07 e alterações Portaria DENATRAN 63/09 e 59/07 e alterações ",Transitar com o veículo excedendo a CMT acima de 1000 kg,10,4,202204,265915,265905,10
6407641b305a576376e6f582,Evasão de Balança,ABRIL,2022,GO,"Lei 9503 DE 23/09/1997 Transpor, sem autorização, bloqueio viário com ou sem sinalização ou dispositivos auxiliares, deixar de adentrar às áreas destinadas à pesagem de veículos ou evadir-se para não efetuar o pagamento do pedágio.",Art. 209 Deixar de adentrar as áreas destinadas à pesagem de veículos,1249,4,202204,295191,293942,1249
6407641b305a576376e6f580,CMT - Capacidade Máxima de Tração,ABRIL,2022,SP,"Lei 9503/97 Lei 10561/02 Res. CONTRAN nº 210/06, 211/06 e 258/07 e alterações Portaria DENATRAN 63/09 e 59/07 e alterações ",Transitar com o veículo excedendo a CMT em até 600 kg,1,4,202204,293906,293905,1
6407641b305a576376e6f579,CMT - Capacidade Máxima de Tração,ABRIL,2022,MG,"Lei 9503/97 Lei 10561/02 Res. CONTRAN nº 210/06, 211/06 e 258/07 e alterações Portaria DENATRAN 63/09 e 59/07 e alterações ",Transitar com o veículo excedendo a CMT entre 601 e 1000 kg,1,4,202204,265905,265904,1
6407641b305a576376e6f593,Excesso de Peso,ABRIL,2022,MT,"Lei 9503/97 Lei 10561/02 Res. CONTRAN nº 210/06, 211/06 e 258/07 e alterações Portaria DENATRAN 63/09 e 59/07 e alterações ",Transitar com o veículo com excesso de peso - Por Eixo,453,4,202204,223243,222790,453
6407641b305a576376e6f5a4,CMT - Capacidade Máxima de Tração,MAIO,2022,SC,"Lei 9503/97 Lei 10561/02 Res. CONTRAN nº 210/06, 211/06 e 258/07 e alterações Portaria DENATRAN 63/09 e 59/07 e alterações ",Transitar com o veículo excedendo a CMT acima de 1000 kg,2,5,202205,295760,295758,2
6407641b305a576376e6f5aa,Evasão de Balança,MAIO,2022,SP,"Lei 9503 DE 23/09/1997 Transpor, sem autorização, bloqueio viário com ou sem sinalização ou dispositivos auxiliares, deixar de adentrar às áreas destinadas à pesagem de veículos ou evadir-se para não efetuar o pagamento do pedágio.",Art. 209 Deixar de adentrar as áreas destinadas à pesagem de veículos,1206,5,202205,225627,224421,1206
6407641b305a576376e6f5ba,Excesso de Peso,MAIO,2022,RJ,"Lei 9503/97 Lei 10561/02 Res. CONTRAN nº 210/06, 211/06 e 258/07 e alterações Portaria DENATRAN 63/09 e 59/07 e alterações ",Transitar com o veículo com excesso de peso - Por Eixo,1416,5,202205,352412,350996,1416
6407641b305a576376e6f5c3,Excesso de Peso,MAIO,2022,SP,"Lei 9503/97 Lei 10561/02 Res. CONTRAN nº 210/06, 211/06 e 258/07 e alterações Portaria DENATRAN 63/09 e 59/07 e alterações ",Transitar com o veículo com excesso de peso - Por Eixo,160,5,202205,352572,352412,160
6407641b305a576376e6f5b5,Excesso de Peso,MAIO,2022,MT,"Lei 9503/97 Lei 10561/02 Res. CONTRAN nº 210/06, 211/06 e 258/07 e alterações Portaria DENATRAN 63/09 e 59/07 e alterações ",Transitar com o veículo com excesso de peso - PBT/PBTC e Por Eixo,69,5,202205,225696,225627,69
6407641b305a576376e6f5b7,Excesso de Peso,MAIO,2022,MT,"Lei 9503/97 Lei 10561/02 Res. CONTRAN nº 210/06, 211/06 e 258/07 e alterações Portaria DENATRAN 63/09 e 59/07 e alterações ",Transitar com o veículo com excesso de peso - Por Eixo,434,5,202205,226130,225696,434
6407641b305a576376e6f5b9,Excesso de Peso,MAIO,2022,RJ,"Lei 9503/97 Lei 10561/02 Res. CONTRAN nº 210/06, 211/06 e 258/07 e alterações Portaria DENATRAN 63/09 e 59/07 e alterações ",Transitar com o veículo com excesso de peso - PBT/PBTC,912,5,202205,227042,226130,912
6407641b305a576376e6f5bd,Excesso de Peso,MAIO,2022,RS,"Lei 9503/97 Lei 10561/02 Res. CONTRAN nº 210/06, 211/06 e 258/07 e alterações Portaria DENATRAN 63/09 e 59/07 e alterações ",Transitar com o veículo com excesso de peso - Por Eixo,349,5,202205,227391,227042,349
6407641b305a576376e6f5a0,CMT - Capacidade Máxima de Tração,MAIO,2022,MG,"Lei 9503/97 Lei 10561/02 Res. CONTRAN nº 210/06, 211/06 e 258/07 e alterações Portaria DENATRAN 63/09 e 59/07 e alterações ",Transitar com o veículo excedendo a CMT em até 600 kg,2,5,202205,268085,268083,2
6407641b305a576376e6f5a2,CMT - Capacidade Máxima de Tração,MAIO,2022,RJ,"Lei 9503/97 Lei 10561/02 Res. CONTRAN nº 210/06, 211/06 e 258/07 e alterações Portaria DENATRAN 63/09 e 59/07 e alterações ",Transitar com o veículo excedendo a CMT em até 600 kg,1,5,202205,268086,268085,1
6407641b305a576376e6f5ad,Excesso de Peso,MAIO,2022,ES,"Lei 9503/97 Lei 10561/02 Res. CONTRAN nº 210/06, 211/06 e 258/07 e alterações Portaria DENATRAN 63/09 e 59/07 e alterações ",Transitar com o veículo com excesso de peso - PBT/PBTC,246,5,202205,268332,268086,246
6407641b305a576376e6f5b1,Excesso de Peso,MAIO,2022,GO,"Lei 9503/97 Lei 10561/02 Res. CONTRAN nº 210/06, 211/06 e 258/07 e alterações Portaria DENATRAN 63/09 e 59/07 e alterações ",Transitar com o veículo com excesso de peso - Por Eixo,356,5,202205,268688,268332,356
6407641b305a576376e6f5b2,Excesso de Peso,MAIO,2022,MG,"Lei 9503/97 Lei 10561/02 Res. CONTRAN nº 210/06, 211/06 e 258/07 e alterações Portaria DENATRAN 63/09 e 59/07 e alterações ",Transitar com o veículo com excesso de peso - PBT/PBTC e Por Eixo,270,5,202205,268958,268688,270
6407641b305a576376e6f5b4,Excesso de Peso,MAIO,2022,MG,"Lei 9503/97 Lei 10561/02 Res. CONTRAN nº 210/06, 211/06 e 258/07 e alterações Portaria DENATRAN 63/09 e 59/07 e alterações ",Transitar com o veículo com excesso de peso - Por Eixo,899,5,202205,269857,268958,899
6407641b305a576376e6f5b6,Excesso de Peso,MAIO,2022,MT,"Lei 9503/97 Lei 10561/02 Res. CONTRAN nº 210/06, 211/06 e 258/07 e alterações Portaria DENATRAN 63/09 e 59/07 e alterações ",Transitar com o veículo com excesso de peso - PBT/PBTC,89,5,202205,269946,269857,89
6407641b305a576376e6f5c0,Excesso de Peso,MAIO,2022,SC,"Lei 9503/97 Lei 10561/02 Res. CONTRAN nº 210/06, 211/06 e 258/07 e alterações Portaria DENATRAN 63/09 e 59/07 e alterações ",Transitar com o veículo com excesso de peso - Por Eixo,420,5,202205,270366,269946,420
6407641b305a576376e6f5be,Excesso de Peso,MAIO,2022,SC,"Lei 9503/97 Lei 10561/02 Res. CONTRAN nº 210/06, 211/06 e 258/07 e alterações Portaria DENATRAN 63/09 e 59/07 e alterações ",Transitar com o veículo com excesso de peso - PBT/PBTC,214,5,202205,227605,227391,214
6407641b305a576376e6f5c1,Excesso de Peso,MAIO,2022,SP,"Lei 9503/97 Lei 10561/02 Res. CONTRAN nº 210/06, 211/06 e 258/07 e alterações Portaria DENATRAN 63/09 e 59/07 e alterações ",Transitar com o veículo com excesso de peso - PBT/PBTC e Por Eixo,90,5,202205,227695,227605,90
6407641b305a576376e6f5c2,Excesso de Peso,MAIO,2022,SP,"Lei 9503/97 Lei 10561/02 Res. CONTRAN nº 210/06, 211/06 e 258/07 e alterações Portaria DENATRAN 63/09 e 59/07 e alterações ",Transitar com o veículo com excesso de peso - PBT/PBTC,137,5,202205,227832,227695,137
6407641b305a576376e6f5a7,Evasão de Balança,MAIO,2022,MG,"Lei 9503 DE 23/09/1997 Transpor, sem autorização, bloqueio viário com ou sem sinalização ou dispositivos auxiliares, deixar de adentrar às áreas destinadas à pesagem de veículos ou evadir-se para não efetuar o pagamento do pedágio.",Art. 209 Deixar de adentrar as áreas destinadas à pesagem de veículos,470,5,202205,296230,295760,470
6407641b305a576376e6f5a3,CMT - Capacidade Máxima de Tração,MAIO,2022,RJ,"Lei 9503/97 Lei 10561/02 Res. CONTRAN nº 210/06, 211/06 e 258/07 e alterações Portaria DENATRAN 63/09 e 59/07 e alterações ",Transitar com o veículo excedendo a CMT acima de 1000 kg,4,5,202205,224421,224417,4
6407641b305a576376e6f5a1,CMT - Capacidade Máxima de Tração,MAIO,2022,MG,"Lei 9503/97 Lei 10561/02 Res. CONTRAN nº 210/06, 211/06 e 258/07 e alterações Portaria DENATRAN 63/09 e 59/07 e alterações ",Transitar com o veículo excedendo a CMT acima de 1000 kg,8,5,202205,224417,224409,8
6407641b305a576376e6f5b8,Excesso de Peso,MAIO,2022,RJ,"Lei 9503/97 Lei 10561/02 Res. CONTRAN nº 210/06, 211/06 e 258/07 e alterações Portaria DENATRAN 63/09 e 59/07 e alterações ",Transitar com o veículo com excesso de peso - PBT/PBTC e Por Eixo,790,5,202205,350996,350206,790
6407641b305a576376e6f5a9,Evasão de Balança,MAIO,2022,RJ,"Lei 9503 DE 23/09/1997 Transpor, sem autorização, bloqueio viário com ou sem sinalização ou dispositivos auxiliares, deixar de adentrar às áreas destinadas à pesagem de veículos ou evadir-se para não efetuar o pagamento do pedágio.",Art. 209 Deixar de adentrar as áreas destinadas à pesagem de veículos,4343,5,202205,349301,344958,4343
6407641b305a576376e6f5a5,CMT - Capacidade Máxima de Tração,MAIO,2022,SC,"Lei 9503/97 Lei 10561/02 Res. CONTRAN nº 210/06, 211/06 e 258/07 e alterações Portaria DENATRAN 63/09 e 59/07 e alterações ",Transitar com o veículo excedendo a CMT em até 600 kg,5,5,202205,344188,344183,5
6407641b305a576376e6f5a6,Evasão de Balança,MAIO,2022,GO,"Lei 9503 DE 23/09/1997 Transpor, sem autorização, bloqueio viário com ou sem sinalização ou dispositivos auxiliares, deixar de adentrar às áreas destinadas à pesagem de veículos ou evadir-se para não efetuar o pagamento do pedágio.",Art. 209 Deixar de adentrar as áreas destinadas à pesagem de veículos,770,5,202205,344958,344188,770
6407641b305a576376e6f5ac,Excesso de Peso,MAIO,2022,ES,"Lei 9503/97 Lei 10561/02 Res. CONTRAN nº 210/06, 211/06 e 258/07 e alterações Portaria DENATRAN 63/09 e 59/07 e alterações ",Transitar com o veículo com excesso de peso - PBT/PBTC e Por Eixo,204,5,202205,298602,298398,204
6407641b305a576376e6f5ab,Excesso de Peso,MAIO,2022,BA,"Lei 9503/97 Lei 10561/02 Res. CONTRAN nº 210/06, 211/06 e 258/07 e alterações Portaria DENATRAN 63/09 e 59/07 e alterações ",Transitar com o veículo com excesso de peso - PBT/PBTC,13,5,202205,349314,349301,13
6407641b305a576376e6f5ae,Excesso de Peso,MAIO,2022,ES,"Lei 9503/97 Lei 10561/02 Res. CONTRAN nº 210/06, 211/06 e 258/07 e alterações Portaria DENATRAN 63/09 e 59/07 e alterações ",Transitar com o veículo com excesso de peso - Por Eixo,586,5,202205,349900,349314,586
6407641b305a576376e6f5af,Excesso de Peso,MAIO,2022,GO,"Lei 9503/97 Lei 10561/02 Res. CONTRAN nº 210/06, 211/06 e 258/07 e alterações Portaria DENATRAN 63/09 e 59/07 e alterações ",Transitar com o veículo com excesso de peso - PBT/PBTC e Por Eixo,135,5,202205,350035,349900,135
6407641b305a576376e6f5b0,Excesso de Peso,MAIO,2022,GO,"Lei 9503/97 Lei 10561/02 Res. CONTRAN nº 210/06, 211/06 e 258/07 e alterações Portaria DENATRAN 63/09 e 59/07 e alterações ",Transitar com o veículo com excesso de peso - PBT/PBTC,171,5,202205,350206,350035,171
6407641b305a576376e6f5bb,Excesso de Peso,MAIO,2022,RS,"Lei 9503/97 Lei 10561/02 Res. CONTRAN nº 210/06, 211/06 e 258/07 e alterações Portaria DENATRAN 63/09 e 59/07 e alterações ",Transitar com o veículo com excesso de peso - PBT/PBTC e Por Eixo,96,5,202205,298994,298898,96
6407641b305a576376e6f5bc,Excesso de Peso,MAIO,2022,RS,"Lei 9503/97 Lei 10561/02 Res. CONTRAN nº 210/06, 211/06 e 258/07 e alterações Portaria DENATRAN 63/09 e 59/07 e alterações ",Transitar com o veículo com excesso de peso - PBT/PBTC,190,5,202205,299184,298994,190
6407641b305a576376e6f5a8,Evasão de Balança,MAIO,2022,MT,"Lei 9503 DE 23/09/1997 Transpor, sem autorização, bloqueio viário com ou sem sinalização ou dispositivos auxiliares, deixar de adentrar às áreas destinadas à pesagem de veículos ou evadir-se para não efetuar o pagamento do pedágio.",Art. 209 Deixar de adentrar as áreas destinadas à pesagem de veículos,2168,5,202205,298398,296230,2168
6407641b305a576376e6f5bf,Excesso de Peso,MAIO,2022,SC,"Lei 9503/97 Lei 10561/02 Res. CONTRAN nº 210/06, 211/06 e 258/07 e alterações Portaria DENATRAN 63/09 e 59/07 e alterações ",Transitar com o veículo com excesso de peso - PBT/PBTC e Por Eixo,237,5,202205,299421,299184,237
6407641b305a576376e6f5b3,Excesso de Peso,MAIO,2022,MG,"Lei 9503/97 Lei 10561/02 Res. CONTRAN nº 210/06, 211/06 e 258/07 e alterações Portaria DENATRAN 63/09 e 59/07 e alterações ",Transitar com o veículo com excesso de peso - PBT/PBTC,296,5,202205,298898,298602,296
6407641b305a576376e6f5c6,CMT - Capacidade Máxima de Tração,JUNHO,2022,ES,"Lei 9503/97 Lei 10561/02 Res. CONTRAN nº 210/06, 211/06 e 258/07 e alterações Portaria DENATRAN 63/09 e 59/07 e alterações ",Transitar com o veículo excedendo a CMT acima de 1000 kg,4,6,202206,227836,227832,4
6407641b305a576376e6f5c7,CMT - Capacidade Máxima de Tração,JUNHO,2022,MG,"Lei 9503/97 Lei 10561/02 Res. CONTRAN nº 210/06, 211/06 e 258/07 e alterações Portaria DENATRAN 63/09 e 59/07 e alterações ",Transitar com o veículo excedendo a CMT entre 601 e 1000 kg,1,6,202206,227837,227836,1
6407641b305a576376e6f5cb,CMT - Capacidade Máxima de Tração,JUNHO,2022,RJ,"Lei 9503/97 Lei 10561/02 Res. CONTRAN nº 210/06, 211/06 e 258/07 e alterações Portaria DENATRAN 63/09 e 59/07 e alterações ",Transitar com o veículo excedendo a CMT acima de 1000 kg,3,6,202206,227840,227837,3
6407641b305a576376e6f5cd,CMT - Capacidade Máxima de Tração,JUNHO,2022,RS,"Lei 9503/97 Lei 10561/02 Res. CONTRAN nº 210/06, 211/06 e 258/07 e alterações Portaria DENATRAN 63/09 e 59/07 e alterações ",Transitar com o veículo excedendo a CMT entre 601 e 1000 kg,2,6,202206,227842,227840,2
6407641b305a576376e6f5cf,CMT - Capacidade Máxima de Tração,JUNHO,2022,SC,"Lei 9503/97 Lei 10561/02 Res. CONTRAN nº 210/06, 211/06 e 258/07 e alterações Portaria DENATRAN 63/09 e 59/07 e alterações ",Transitar com o veículo excedendo a CMT em até 600 kg,1,6,202206,227843,227842,1
6407641b305a576376e6f5ec,Excesso de Peso,JUNHO,2022,SC,"Lei 9503/97 Lei 10561/02 Res. CONTRAN nº 210/06, 211/06 e 258/07 e alterações Portaria DENATRAN 63/09 e 59/07 e alterações ",Transitar com o veículo com excesso de peso - PBT/PBTC e Por Eixo,201,6,202206,354390,354189,201
6407641b305a576376e6f5e7,Excesso de Peso,JUNHO,2022,RJ,"Lei 9503/97 Lei 10561/02 Res. CONTRAN nº 210/06, 211/06 e 258/07 e alterações Portaria DENATRAN 63/09 e 59/07 e alterações ",Transitar com o veículo com excesso de peso - Por Eixo,1139,6,202206,303577,302438,1139
6407641b305a576376e6f5cc,CMT - Capacidade Máxima de Tração,JUNHO,2022,RJ,"Lei 9503/97 Lei 10561/02 Res. CONTRAN nº 210/06, 211/06 e 258/07 e alterações Portaria DENATRAN 63/09 e 59/07 e alterações ",Transitar com o veículo excedendo a CMT entre 601 e 1000 kg,5,6,202206,299426,299421,5
6407641b305a576376e6f5d2,Evasão de Balança,JUNHO,2022,GO,"Lei 9503 DE 23/09/1997 Transpor, sem autorização, bloqueio viário com ou sem sinalização ou dispositivos auxiliares, deixar de adentrar às áreas destinadas à pesagem de veículos ou evadir-se para não efetuar o pagamento do pedágio.",Art. 209 Deixar de adentrar as áreas destinadas à pesagem de veículos,472,6,202206,299898,299426,472
6407641b305a576376e6f5dd,Excesso de Peso,JUNHO,2022,GO,"Lei 9503/97 Lei 10561/02 Res. CONTRAN nº 210/06, 211/06 e 258/07 e alterações Portaria DENATRAN 63/09 e 59/07 e alterações ",Transitar com o veículo com excesso de peso - PBT/PBTC,97,6,202206,301159,301062,97
6407641b305a576376e6f5e0,Excesso de Peso,JUNHO,2022,MG,"Lei 9503/97 Lei 10561/02 Res. CONTRAN nº 210/06, 211/06 e 258/07 e alterações Portaria DENATRAN 63/09 e 59/07 e alterações ",Transitar com o veículo com excesso de peso - PBT/PBTC,332,6,202206,301491,301159,332
6407641b305a576376e6f5e3,Excesso de Peso,JUNHO,2022,MT,"Lei 9503/97 Lei 10561/02 Res. CONTRAN nº 210/06, 211/06 e 258/07 e alterações Portaria DENATRAN 63/09 e 59/07 e alterações ",Transitar com o veículo com excesso de peso - PBT/PBTC e Por Eixo,144,6,202206,301635,301491,144
6407641b305a576376e6f5e2,Excesso de Peso,JUNHO,2022,MT,"Lei 9503/97 Lei 10561/02 Res. CONTRAN nº 210/06, 211/06 e 258/07 e alterações Portaria DENATRAN 63/09 e 59/07 e alterações ",Transitar com o veículo com excesso de peso - PBT/PBTC,125,6,202206,353571,353446,125
6407641b305a576376e6f5e6,Excesso de Peso,JUNHO,2022,RJ,"Lei 9503/97 Lei 10561/02 Res. CONTRAN nº 210/06, 211/06 e 258/07 e alterações Portaria DENATRAN 63/09 e 59/07 e alterações ",Transitar com o veículo com excesso de peso - PBT/PBTC,803,6,202206,302438,301635,803
6407641b305a576376e6f5ed,Excesso de Peso,JUNHO,2022,SC,"Lei 9503/97 Lei 10561/02 Res. CONTRAN nº 210/06, 211/06 e 258/07 e alterações Portaria DENATRAN 63/09 e 59/07 e alterações ",Transitar com o veículo com excesso de peso - Por Eixo,382,6,202206,303959,303577,382
6407641b305a576376e6f5df,Excesso de Peso,JUNHO,2022,MG,"Lei 9503/97 Lei 10561/02 Res. CONTRAN nº 210/06, 211/06 e 258/07 e alterações Portaria DENATRAN 63/09 e 59/07 e alterações ",Transitar com o veículo com excesso de peso - PBT/PBTC e Por Eixo,259,6,202206,353446,353187,259
6407641b305a576376e6f5d3,Evasão de Balança,JUNHO,2022,MG,"Lei 9503 DE 23/09/1997 Transpor, sem autorização, bloqueio viário com ou sem sinalização ou dispositivos auxiliares, deixar de adentrar às áreas destinadas à pesagem de veículos ou evadir-se para não efetuar o pagamento do pedágio.",Art. 209 Deixar de adentrar as áreas destinadas à pesagem de veículos,1164,6,202206,301062,299898,1164
6407641b305a576376e6f5d8,Excesso de Peso,JUNHO,2022,DF,"Lei 9503/97 Lei 10561/02 Res. CONTRAN nº 210/06, 211/06 e 258/07 e alterações Portaria DENATRAN 63/09 e 59/07 e alterações ",Transitar com o veículo com excesso de peso - Por Eixo,1,6,202206,353135,353134,1
6407641b305a576376e6f5e9,Excesso de Peso,JUNHO,2022,RS,"Lei 9503/97 Lei 10561/02 Res. CONTRAN nº 210/06, 211/06 e 258/07 e alterações Portaria DENATRAN 63/09 e 59/07 e alterações ",Transitar com o veículo com excesso de peso - PBT/PBTC,193,6,202206,273601,273408,193
6407641b305a576376e6f5e8,Excesso de Peso,JUNHO,2022,RS,"Lei 9503/97 Lei 10561/02 Res. CONTRAN nº 210/06, 211/06 e 258/07 e alterações Portaria DENATRAN 63/09 e 59/07 e alterações ",Transitar com o veículo com excesso de peso - PBT/PBTC e Por Eixo,97,6,202206,273408,273311,97
6407641b305a576376e6f5dc,Excesso de Peso,JUNHO,2022,GO,"Lei 9503/97 Lei 10561/02 Res. CONTRAN nº 210/06, 211/06 e 258/07 e alterações Portaria DENATRAN 63/09 e 59/07 e alterações ",Transitar com o veículo com excesso de peso - PBT/PBTC e Por Eixo,52,6,202206,353187,353135,52
6407641b305a576376e6f5d5,Evasão de Balança,JUNHO,2022,RJ,"Lei 9503 DE 23/09/1997 Transpor, sem autorização, bloqueio viário com ou sem sinalização ou dispositivos auxiliares, deixar de adentrar às áreas destinadas à pesagem de veículos ou evadir-se para não efetuar o pagamento do pedágio.",Art. 209 Deixar de adentrar as áreas destinadas à pesagem de veículos,2191,6,202206,272559,270368,2191
6407641b305a576376e6f5ce,CMT - Capacidade Máxima de Tração,JUNHO,2022,RS,"Lei 9503/97 Lei 10561/02 Res. CONTRAN nº 210/06, 211/06 e 258/07 e alterações Portaria DENATRAN 63/09 e 59/07 e alterações ",Transitar com o veículo excedendo a CMT acima de 1000 kg,2,6,202206,270368,270366,2
6407641b305a576376e6f5c9,CMT - Capacidade Máxima de Tração,JUNHO,2022,MT,"Lei 9503/97 Lei 10561/02 Res. CONTRAN nº 210/06, 211/06 e 258/07 e alterações Portaria DENATRAN 63/09 e 59/07 e alterações ",Transitar com o veículo excedendo a CMT em até 600 kg,1,6,202206,352584,352583,1
6407641b305a576376e6f5c8,CMT - Capacidade Máxima de Tração,JUNHO,2022,MG,"Lei 9503/97 Lei 10561/02 Res. CONTRAN nº 210/06, 211/06 e 258/07 e alterações Portaria DENATRAN 63/09 e 59/07 e alterações ",Transitar com o veículo excedendo a CMT acima de 1000 kg,4,6,202206,352583,352579,4
6407641b305a576376e6f5c5,CMT - Capacidade Máxima de Tração,JUNHO,2022,ES,"Lei 9503/97 Lei 10561/02 Res. CONTRAN nº 210/06, 211/06 e 258/07 e alterações Portaria DENATRAN 63/09 e 59/07 e alterações ",Transitar com o veículo excedendo a CMT em até 600 kg,4,6,202206,352579,352575,4
6407641b305a576376e6f5c4,CMT - Capacidade Máxima de Tração,JUNHO,2022,ES,"Lei 9503/97 Lei 10561/02 Res. CONTRAN nº 210/06, 211/06 e 258/07 e alterações Portaria DENATRAN 63/09 e 59/07 e alterações ",Transitar com o veículo excedendo a CMT entre 601 e 1000 kg,3,6,202206,352575,352572,3
6407641b305a576376e6f5ee,Excesso de Peso,JUNHO,2022,SP,"Lei 9503/97 Lei 10561/02 Res. CONTRAN nº 210/06, 211/06 e 258/07 e alterações Portaria DENATRAN 63/09 e 59/07 e alterações ",Transitar com o veículo com excesso de peso - PBT/PBTC,167,6,202206,273768,273601,167
6407641b305a576376e6f5d0,CMT - Capacidade Máxima de Tração,JUNHO,2022,SP,"Lei 9503/97 Lei 10561/02 Res. CONTRAN nº 210/06, 211/06 e 258/07 e alterações Portaria DENATRAN 63/09 e 59/07 e alterações ",Transitar com o veículo excedendo a CMT acima de 1000 kg,2,6,202206,227845,227843,2
6407641b305a576376e6f5d7,Excesso de Peso,JUNHO,2022,BA,"Lei 9503/97 Lei 10561/02 Res. CONTRAN nº 210/06, 211/06 e 258/07 e alterações Portaria DENATRAN 63/09 e 59/07 e alterações ",Transitar com o veículo com excesso de peso - PBT/PBTC,2,6,202206,229391,229389,2
6407641b305a576376e6f5d9,Excesso de Peso,JUNHO,2022,ES,"Lei 9503/97 Lei 10561/02 Res. CONTRAN nº 210/06, 211/06 e 258/07 e alterações Portaria DENATRAN 63/09 e 59/07 e alterações ",Transitar com o veículo com excesso de peso - PBT/PBTC e Por Eixo,232,6,202206,229623,229391,232
6407641b305a576376e6f5da,Excesso de Peso,JUNHO,2022,ES,"Lei 9503/97 Lei 10561/02 Res. CONTRAN nº 210/06, 211/06 e 258/07 e alterações Portaria DENATRAN 63/09 e 59/07 e alterações ",Transitar com o veículo com excesso de peso - PBT/PBTC,262,6,202206,229885,229623,262
6407641b305a576376e6f5db,Excesso de Peso,JUNHO,2022,ES,"Lei 9503/97 Lei 10561/02 Res. CONTRAN nº 210/06, 211/06 e 258/07 e alterações Portaria DENATRAN 63/09 e 59/07 e alterações ",Transitar com o veículo com excesso de peso - Por Eixo,579,6,202206,230464,229885,579
6407641b305a576376e6f5de,Excesso de Peso,JUNHO,2022,GO,"Lei 9503/97 Lei 10561/02 Res. CONTRAN nº 210/06, 211/06 e 258/07 e alterações Portaria DENATRAN 63/09 e 59/07 e alterações ",Transitar com o veículo com excesso de peso - Por Eixo,163,6,202206,230627,230464,163
6407641b305a576376e6f5e4,Excesso de Peso,JUNHO,2022,MT,"Lei 9503/97 Lei 10561/02 Res. CONTRAN nº 210/06, 211/06 e 258/07 e alterações Portaria DENATRAN 63/09 e 59/07 e alterações ",Transitar com o veículo com excesso de peso - Por Eixo,792,6,202206,231419,230627,792
6407641b305a576376e6f5ea,Excesso de Peso,JUNHO,2022,RS,"Lei 9503/97 Lei 10561/02 Res. CONTRAN nº 210/06, 211/06 e 258/07 e alterações Portaria DENATRAN 63/09 e 59/07 e alterações ",Transitar com o veículo com excesso de peso - Por Eixo,463,6,202206,231882,231419,463
6407641b305a576376e6f5eb,Excesso de Peso,JUNHO,2022,SC,"Lei 9503/97 Lei 10561/02 Res. CONTRAN nº 210/06, 211/06 e 258/07 e alterações Portaria DENATRAN 63/09 e 59/07 e alterações ",Transitar com o veículo com excesso de peso - PBT/PBTC,174,6,202206,232056,231882,174
6407641b305a576376e6f5f0,Excesso de Peso,JUNHO,2022,SP,"Lei 9503/97 Lei 10561/02 Res. CONTRAN nº 210/06, 211/06 e 258/07 e alterações Portaria DENATRAN 63/09 e 59/07 e alterações ",Transitar com o veículo com excesso de peso - PBT/PBTC e Por Eixo,260,6,202206,232316,232056,260
6407641b305a576376e6f5d4,Evasão de Balança,JUNHO,2022,MT,"Lei 9503 DE 23/09/1997 Transpor, sem autorização, bloqueio viário com ou sem sinalização ou dispositivos auxiliares, deixar de adentrar às áreas destinadas à pesagem de veículos ou evadir-se para não efetuar o pagamento do pedágio.",Art. 209 Deixar de adentrar as áreas destinadas à pesagem de veículos,1544,6,202206,229389,227845,1544
6407641b305a576376e6f5ef,Excesso de Peso,JUNHO,2022,SP,"Lei 9503/97 Lei 10561/02 Res. CONTRAN nº 210/06, 211/06 e 258/07 e alterações Portaria DENATRAN 63/09 e 59/07 e alterações ",Transitar com o veículo com excesso de peso - Por Eixo,210,6,202206,273978,273768,210
6407641b305a576376e6f5e1,Excesso de Peso,JUNHO,2022,MG,"Lei 9503/97 Lei 10561/02 Res. CONTRAN nº 210/06, 211/06 e 258/07 e alterações Portaria DENATRAN 63/09 e 59/07 e alterações ",Transitar com o veículo com excesso de peso - Por Eixo,752,6,202206,273311,272559,752
6407641b305a576376e6f5e5,Excesso de Peso,JUNHO,2022,RJ,"Lei 9503/97 Lei 10561/02 Res. CONTRAN nº 210/06, 211/06 e 258/07 e alterações Portaria DENATRAN 63/09 e 59/07 e alterações ",Transitar com o veículo com excesso de peso - PBT/PBTC e Por Eixo,618,6,202206,354189,353571,618
6407641b305a576376e6f5d6,Evasão de Balança,JUNHO,2022,SP,"Lei 9503 DE 23/09/1997 Transpor, sem autorização, bloqueio viário com ou sem sinalização ou dispositivos auxiliares, deixar de adentrar às áreas destinadas à pesagem de veículos ou evadir-se para não efetuar o pagamento do pedágio.",Art. 209 Deixar de adentrar as áreas destinadas à pesagem de veículos,544,6,202206,353134,352590,544
6407641b305a576376e6f5d1,CMT - Capacidade Máxima de Tração,JUNHO,2022,SP,"Lei 9503/97 Lei 10561/02 Res. CONTRAN nº 210/06, 211/06 e 258/07 e alterações Portaria DENATRAN 63/09 e 59/07 e alterações ",Transitar com o veículo excedendo a CMT em até 600 kg,5,6,202206,352590,352585,5
6407641b305a576376e6f5ca,CMT - Capacidade Máxima de Tração,JUNHO,2022,MT,"Lei 9503/97 Lei 10561/02 Res. CONTRAN nº 210/06, 211/06 e 258/07 e alterações Portaria DENATRAN 63/09 e 59/07 e alterações ",Transitar com o veículo excedendo a CMT acima de 1000 kg,1,6,202206,352585,352584,1
6407641b305a576376e6f60a,Excesso de Peso,JULHO,2022,MT,"Lei 9503/97 Lei 10561/02 Res. CONTRAN nº 210/06, 211/06 e 258/07 e alterações Portaria DENATRAN 63/09 e 59/07 e alterações ",Transitar com o veículo com excesso de peso - PBT/PBTC e Por Eixo,33,7,202207,235105,235072,33
6407641b305a576376e6f60c,Excesso de Peso,JULHO,2022,MT,"Lei 9503/97 Lei 10561/02 Res. CONTRAN nº 210/06, 211/06 e 258/07 e alterações Portaria DENATRAN 63/09 e 59/07 e alterações ",Transitar com o veículo com excesso de peso - Por Eixo,320,7,202207,235425,235105,320
6407641b305a576376e6f60f,Excesso de Peso,JULHO,2022,RJ,"Lei 9503/97 Lei 10561/02 Res. CONTRAN nº 210/06, 211/06 e 258/07 e alterações Portaria DENATRAN 63/09 e 59/07 e alterações ",Transitar com o veículo com excesso de peso - Por Eixo,959,7,202207,236384,235425,959
6407641b305a576376e6f615,Excesso de Peso,JULHO,2022,SC,"Lei 9503/97 Lei 10561/02 Res. CONTRAN nº 210/06, 211/06 e 258/07 e alterações Portaria DENATRAN 63/09 e 59/07 e alterações ",Transitar com o veículo com excesso de peso - Por Eixo,210,7,202207,236594,236384,210
6407641b305a576376e6f5f5,CMT - Capacidade Máxima de Tração,JULHO,2022,RJ,"Lei 9503/97 Lei 10561/02 Res. CONTRAN nº 210/06, 211/06 e 258/07 e alterações Portaria DENATRAN 63/09 e 59/07 e alterações ",Transitar com o veículo excedendo a CMT entre 601 e 1000 kg,2,7,202207,354392,354390,2
6407641b305a576376e6f5f7,CMT - Capacidade Máxima de Tração,JULHO,2022,RJ,"Lei 9503/97 Lei 10561/02 Res. CONTRAN nº 210/06, 211/06 e 258/07 e alterações Portaria DENATRAN 63/09 e 59/07 e alterações ",Transitar com o veículo excedendo a CMT em até 600 kg,8,7,202207,354400,354392,8
6407641b305a576376e6f5fe,Evasão de Balança,JULHO,2022,RJ,"Lei 9503 DE 23/09/1997 Transpor, sem autorização, bloqueio viário com ou sem sinalização ou dispositivos auxiliares, deixar de adentrar às áreas destinadas à pesagem de veículos ou evadir-se para não efetuar o pagamento do pedágio.",Art. 209 Deixar de adentrar as áreas destinadas à pesagem de veículos,3565,7,202207,357965,354400,3565
6407641b305a576376e6f600,Excesso de Peso,JULHO,2022,BA,"Lei 9503/97 Lei 10561/02 Res. CONTRAN nº 210/06, 211/06 e 258/07 e alterações Portaria DENATRAN 63/09 e 59/07 e alterações ",Transitar com o veículo com excesso de peso - PBT/PBTC,10,7,202207,357975,357965,10
6407641b305a576376e6f614,Excesso de Peso,JULHO,2022,SC,"Lei 9503/97 Lei 10561/02 Res. CONTRAN nº 210/06, 211/06 e 258/07 e alterações Portaria DENATRAN 63/09 e 59/07 e alterações ",Transitar com o veículo com excesso de peso - PBT/PBTC e Por Eixo,131,7,202207,358106,357975,131
6407641b305a576376e6f618,Excesso de Peso,JULHO,2022,SP,"Lei 9503/97 Lei 10561/02 Res. CONTRAN nº 210/06, 211/06 e 258/07 e alterações Portaria DENATRAN 63/09 e 59/07 e alterações ",Transitar com o veículo com excesso de peso - Por Eixo,125,7,202207,358231,358106,125
6407641b305a576376e6f602,Excesso de Peso,JULHO,2022,ES,"Lei 9503/97 Lei 10561/02 Res. CONTRAN nº 210/06, 211/06 e 258/07 e alterações Portaria DENATRAN 63/09 e 59/07 e alterações ",Transitar com o veículo com excesso de peso - PBT/PBTC e Por Eixo,178,7,202207,234804,234626,178
6407641b305a576376e6f611,Excesso de Peso,JULHO,2022,RS,"Lei 9503/97 Lei 10561/02 Res. CONTRAN nº 210/06, 211/06 e 258/07 e alterações Portaria DENATRAN 63/09 e 59/07 e alterações ",Transitar com o veículo com excesso de peso - PBT/PBTC,106,7,202207,306463,306357,106
6407641b305a576376e6f5f4,CMT - Capacidade Máxima de Tração,JULHO,2022,MT,"Lei 9503/97 Lei 10561/02 Res. CONTRAN nº 210/06, 211/06 e 258/07 e alterações Portaria DENATRAN 63/09 e 59/07 e alterações ",Transitar com o veículo excedendo a CMT acima de 1000 kg,1,7,202207,303964,303963,1
6407641b305a576376e6f5f3,CMT - Capacidade Máxima de Tração,JULHO,2022,MG,"Lei 9503/97 Lei 10561/02 Res. CONTRAN nº 210/06, 211/06 e 258/07 e alterações Portaria DENATRAN 63/09 e 59/07 e alterações ",Transitar com o veículo excedendo a CMT em até 600 kg,1,7,202207,303963,303962,1
6407641b305a576376e6f610,Excesso de Peso,JULHO,2022,RS,"Lei 9503/97 Lei 10561/02 Res. CONTRAN nº 210/06, 211/06 e 258/07 e alterações Portaria DENATRAN 63/09 e 59/07 e alterações ",Transitar com o veículo com excesso de peso - PBT/PBTC e Por Eixo,60,7,202207,306357,306297,60
6407641b305a576376e6f617,Excesso de Peso,JULHO,2022,SP,"Lei 9503/97 Lei 10561/02 Res. CONTRAN nº 210/06, 211/06 e 258/07 e alterações Portaria DENATRAN 63/09 e 59/07 e alterações ",Transitar com o veículo com excesso de peso - PBT/PBTC e Por Eixo,121,7,202207,314608,314487,121
6407641b305a576376e6f612,Excesso de Peso,JULHO,2022,RS,"Lei 9503/97 Lei 10561/02 Res. CONTRAN nº 210/06, 211/06 e 258/07 e alterações Portaria DENATRAN 63/09 e 59/07 e alterações ",Transitar com o veículo com excesso de peso - Por Eixo,316,7,202207,314487,314171,316
6407641b305a576376e6f609,Excesso de Peso,JULHO,2022,MG,"Lei 9503/97 Lei 10561/02 Res. CONTRAN nº 210/06, 211/06 e 258/07 e alterações Portaria DENATRAN 63/09 e 59/07 e alterações ",Transitar com o veículo com excesso de peso - Por Eixo,1142,7,202207,306297,305155,1142
6407641b305a576376e6f606,Excesso de Peso,JULHO,2022,GO,"Lei 9503/97 Lei 10561/02 Res. CONTRAN nº 210/06, 211/06 e 258/07 e alterações Portaria DENATRAN 63/09 e 59/07 e alterações ",Transitar com o veículo com excesso de peso - Por Eixo,229,7,202207,305155,304926,229
6407641b305a576376e6f605,Excesso de Peso,JULHO,2022,GO,"Lei 9503/97 Lei 10561/02 Res. CONTRAN nº 210/06, 211/06 e 258/07 e alterações Portaria DENATRAN 63/09 e 59/07 e alterações ",Transitar com o veículo com excesso de peso - PBT/PBTC,83,7,202207,304926,304843,83
6407641b305a576376e6f604,Excesso de Peso,JULHO,2022,GO,"Lei 9503/97 Lei 10561/02 Res. CONTRAN nº 210/06, 211/06 e 258/07 e alterações Portaria DENATRAN 63/09 e 59/07 e alterações ",Transitar com o veículo com excesso de peso - PBT/PBTC e Por Eixo,58,7,202207,304843,304785,58
6407641b305a576376e6f601,Excesso de Peso,JULHO,2022,ES,"Lei 9503/97 Lei 10561/02 Res. CONTRAN nº 210/06, 211/06 e 258/07 e alterações Portaria DENATRAN 63/09 e 59/07 e alterações ",Transitar com o veículo com excesso de peso - PBT/PBTC,142,7,202207,304785,304643,142
6407641b305a576376e6f5fb,Evasão de Balança,JULHO,2022,GO,"Lei 9503 DE 23/09/1997 Transpor, sem autorização, bloqueio viário com ou sem sinalização ou dispositivos auxiliares, deixar de adentrar às áreas destinadas à pesagem de veículos ou evadir-se para não efetuar o pagamento do pedágio.",Art. 209 Deixar de adentrar as áreas destinadas à pesagem de veículos,670,7,202207,304643,303973,670
6407641b305a576376e6f5fa,CMT - Capacidade Máxima de Tração,JULHO,2022,SP,"Lei 9503/97 Lei 10561/02 Res. CONTRAN nº 210/06, 211/06 e 258/07 e alterações Portaria DENATRAN 63/09 e 59/07 e alterações ",Transitar com o veículo excedendo a CMT acima de 1000 kg,2,7,202207,303973,303971,2
6407641b305a576376e6f5f9,CMT - Capacidade Máxima de Tração,JULHO,2022,SC,"Lei 9503/97 Lei 10561/02 Res. CONTRAN nº 210/06, 211/06 e 258/07 e alterações Portaria DENATRAN 63/09 e 59/07 e alterações ",Transitar com o veículo excedendo a CMT acima de 1000 kg,2,7,202207,303971,303969,2
6407641b305a576376e6f5f6,CMT - Capacidade Máxima de Tração,JULHO,2022,RJ,"Lei 9503/97 Lei 10561/02 Res. CONTRAN nº 210/06, 211/06 e 258/07 e alterações Portaria DENATRAN 63/09 e 59/07 e alterações ",Transitar com o veículo excedendo a CMT acima de 1000 kg,5,7,202207,303969,303964,5
6407641b305a576376e6f5f2,CMT - Capacidade Máxima de Tração,JULHO,2022,GO,"Lei 9503/97 Lei 10561/02 Res. CONTRAN nº 210/06, 211/06 e 258/07 e alterações Portaria DENATRAN 63/09 e 59/07 e alterações ",Transitar com o veículo excedendo a CMT acima de 1000 kg,1,7,202207,303962,303961,1
6407641b305a576376e6f5f1,CMT - Capacidade Máxima de Tração,JULHO,2022,ES,"Lei 9503/97 Lei 10561/02 Res. CONTRAN nº 210/06, 211/06 e 258/07 e alterações Portaria DENATRAN 63/09 e 59/07 e alterações ",Transitar com o veículo excedendo a CMT acima de 1000 kg,2,7,202207,303961,303959,2
6407641b305a576376e6f607,Excesso de Peso,JULHO,2022,MG,"Lei 9503/97 Lei 10561/02 Res. CONTRAN nº 210/06, 211/06 e 258/07 e alterações Portaria DENATRAN 63/09 e 59/07 e alterações ",Transitar com o veículo com excesso de peso - PBT/PBTC e Por Eixo,268,7,202207,235072,234804,268
6407641b305a576376e6f5ff,Evasão de Balança,JULHO,2022,SP,"Lei 9503 DE 23/09/1997 Transpor, sem autorização, bloqueio viário com ou sem sinalização ou dispositivos auxiliares, deixar de adentrar às áreas destinadas à pesagem de veículos ou evadir-se para não efetuar o pagamento do pedágio.",Art. 209 Deixar de adentrar as áreas destinadas à pesagem de veículos,539,7,202207,275795,275256,539
6407641b305a576376e6f60e,Excesso de Peso,JULHO,2022,RJ,"Lei 9503/97 Lei 10561/02 Res. CONTRAN nº 210/06, 211/06 e 258/07 e alterações Portaria DENATRAN 63/09 e 59/07 e alterações ",Transitar com o veículo com excesso de peso - PBT/PBTC,864,7,202207,277889,277025,864
6407641b305a576376e6f60d,Excesso de Peso,JULHO,2022,RJ,"Lei 9503/97 Lei 10561/02 Res. CONTRAN nº 210/06, 211/06 e 258/07 e alterações Portaria DENATRAN 63/09 e 59/07 e alterações ",Transitar com o veículo com excesso de peso - PBT/PBTC e Por Eixo,547,7,202207,277025,276478,547
6407641b305a576376e6f60b,Excesso de Peso,JULHO,2022,MT,"Lei 9503/97 Lei 10561/02 Res. CONTRAN nº 210/06, 211/06 e 258/07 e alterações Portaria DENATRAN 63/09 e 59/07 e alterações ",Transitar com o veículo com excesso de peso - PBT/PBTC,68,7,202207,276478,276410,68
6407641b305a576376e6f608,Excesso de Peso,JULHO,2022,MG,"Lei 9503/97 Lei 10561/02 Res. CONTRAN nº 210/06, 211/06 e 258/07 e alterações Portaria DENATRAN 63/09 e 59/07 e alterações ",Transitar com o veículo com excesso de peso - PBT/PBTC,292,7,202207,276410,276118,292
6407641b305a576376e6f603,Excesso de Peso,JULHO,2022,ES,"Lei 9503/97 Lei 10561/02 Res. CONTRAN nº 210/06, 211/06 e 258/07 e alterações Portaria DENATRAN 63/09 e 59/07 e alterações ",Transitar com o veículo com excesso de peso - Por Eixo,323,7,202207,276118,275795,323
6407641b305a576376e6f5fd,Evasão de Balança,JULHO,2022,MT,"Lei 9503 DE 23/09/1997 Transpor, sem autorização, bloqueio viário com ou sem sinalização ou dispositivos auxiliares, deixar de adentrar às áreas destinadas à pesagem de veículos ou evadir-se para não efetuar o pagamento do pedágio.",Art. 209 Deixar de adentrar as áreas destinadas à pesagem de veículos,1278,7,202207,275256,273978,1278
6407641b305a576376e6f613,Excesso de Peso,JULHO,2022,SC,"Lei 9503/97 Lei 10561/02 Res. CONTRAN nº 210/06, 211/06 e 258/07 e alterações Portaria DENATRAN 63/09 e 59/07 e alterações ",Transitar com o veículo com excesso de peso - PBT/PBTC,80,7,202207,277969,277889,80
6407641b305a576376e6f5f8,CMT - Capacidade Máxima de Tração,JULHO,2022,RS,"Lei 9503/97 Lei 10561/02 Res. CONTRAN nº 210/06, 211/06 e 258/07 e alterações Portaria DENATRAN 63/09 e 59/07 e alterações ",Transitar com o veículo excedendo a CMT acima de 1000 kg,1,7,202207,232317,232316,1
6407641b305a576376e6f5fc,Evasão de Balança,JULHO,2022,MG,"Lei 9503 DE 23/09/1997 Transpor, sem autorização, bloqueio viário com ou sem sinalização ou dispositivos auxiliares, deixar de adentrar às áreas destinadas à pesagem de veículos ou evadir-se para não efetuar o pagamento do pedágio.",Art. 209 Deixar de adentrar as áreas destinadas à pesagem de veículos,2309,7,202207,234626,232317,2309
6407641b305a576376e6f616,Excesso de Peso,JULHO,2022,SP,"Lei 9503/97 Lei 10561/02 Res. CONTRAN nº 210/06, 211/06 e 258/07 e alterações Portaria DENATRAN 63/09 e 59/07 e alterações ",Transitar com o veículo com excesso de peso - PBT/PBTC,97,7,202207,278066,277969,97
6407641b305a576376e6f63a,Excesso de Peso,AGOSTO,2022,MG,Lei 9503/97 Lei 10233/01 Res. CONTRAN nº 882/21 e alterações Portaria SENATRAN 268/22 e alterações ,Transitar com o veículo com excesso de peso - Por Eixo,49,8,202208,238117,238068,49
6407641b305a576376e6f631,Excesso de Peso,AGOSTO,2022,ES,Lei 9503/97 Lei 10233/01 Res. CONTRAN nº 882/21 e alterações Portaria SENATRAN 354/22 e 268/22 e alterações ,Transitar com o veículo com excesso de peso - PBT/PBTC e Por Eixo,247,8,202208,320705,320458,247
6407641b305a576376e6f630,Excesso de Peso,AGOSTO,2022,ES,Lei 9503/97 Lei 10233/01 Res. CONTRAN nº 882/21 e alterações Portaria SENATRAN 354/22 e 268/22 e alterações ,Transitar com o veículo com excesso de peso - PBT/PBTC,134,8,202208,320458,320324,134
6407641b305a576376e6f62e,Excesso de Peso,AGOSTO,2022,ES,Lei 9503/97 Lei 10233/01 Res. CONTRAN nº 882/21 e alterações Portaria SENATRAN 268/22 e alterações ,Transitar com o veículo com excesso de peso - PBT/PBTC e Por Eixo,18,8,202208,320324,320306,18
6407641b305a576376e6f62c,Excesso de Peso,AGOSTO,2022,ES,"Lei 9503/97 Lei 10561/02 Res. CONTRAN nº 210/06, 211/06 e 258/07 e alterações Portaria DENATRAN 63/09 e 59/07 e alterações ",Transitar com o veículo com excesso de peso - Por Eixo,1,8,202208,320306,320305,1
6407641b305a576376e6f628,Evasão de Balança,AGOSTO,2022,RJ,"Lei 9503 DE 23/09/1997 Transpor, sem autorização, bloqueio viário com ou sem sinalização ou dispositivos auxiliares, deixar de adentrar às áreas destinadas à pesagem de veículos ou evadir-se para não efetuar o pagamento do pedágio.",Art. 209 Deixar de adentrar as áreas destinadas à pesagem de veículos,5691,8,202208,320305,314614,5691
6407641b305a576376e6f620,CMT - Capacidade Máxima de Tração,AGOSTO,2022,RJ,Lei 9503/97 Lei 10233/01 Res. CONTRAN nº 882/21 e alterações Portaria SENATRAN 354/22 e 268/22 e alterações ,Transitar com o veículo excedendo a CMT acima de 1000 kg,2,8,202208,314614,314612,2
6407641b305a576376e6f61f,CMT - Capacidade Máxima de Tração,AGOSTO,2022,RJ,Lei 9503/97 Lei 10233/01 Res. CONTRAN nº 882/21 e alterações Portaria SENATRAN 354/22 e 268/22 e alterações ,Transitar com o veículo excedendo a CMT entre 601 e 1000 kg,1,8,202208,314612,314611,1
6407641b305a576376e6f61b,CMT - Capacidade Máxima de Tração,AGOSTO,2022,MG,Lei 9503/97 Lei 10233/01 Res. CONTRAN nº 882/21 e alterações Portaria SENATRAN 268/22 e alterações ,Transitar com o veículo excedendo a CMT acima de 1000 kg,2,8,202208,314611,314609,2
6407641b305a576376e6f637,Excesso de Peso,AGOSTO,2022,MG,Lei 9503/97 Lei 10233/01 Res. CONTRAN nº 882/21 e alterações Portaria SENATRAN 268/22 e alterações ,Transitar com o veículo com excesso de peso - PBT/PBTC,23,8,202208,320728,320705,23
6407641b305a576376e6f61a,CMT - Capacidade Máxima de Tração,AGOSTO,2022,MG,Lei 9503/97 Lei 10233/01 Res. CONTRAN nº 882/21 e alterações Portaria SENATRAN 268/22 e alterações ,Transitar com o veículo excedendo a CMT entre 601 e 1000 kg,1,8,202208,314609,314608,1
6407641b305a576376e6f65b,Excesso de Peso,AGOSTO,2022,SC,Lei 9503/97 Lei 10233/01 Res. CONTRAN nº 882/21 e alterações Portaria SENATRAN 354/22 e 268/22 e alterações ,Transitar com o veículo com excesso de peso - Por Eixo,130,8,202208,361729,361599,130
6407641b305a576376e6f65c,Excesso de Peso,AGOSTO,2022,SC,Lei 9503/97 Lei 10233/01 Res. CONTRAN nº 882/21 e alterações Portaria SENATRAN 354/22 e 268/22 e alterações ,Transitar com o veículo com excesso de peso - PBT/PBTC e Por Eixo,146,8,202208,361875,361729,146
6407641b305a576376e6f61e,CMT - Capacidade Máxima de Tração,AGOSTO,2022,RJ,Lei 9503/97 Lei 10233/01 Res. CONTRAN nº 882/21 e alterações Portaria SENATRAN 268/22 e alterações ,Transitar com o veículo excedendo a CMT entre 601 e 1000 kg,1,8,202208,236597,236596,1
6407641b305a576376e6f61c,CMT - Capacidade Máxima de Tração,AGOSTO,2022,MG,Lei 9503/97 Lei 10233/01 Res. CONTRAN nº 882/21 e alterações Portaria SENATRAN 354/22 e 268/22 e alterações ,Transitar com o veículo excedendo a CMT em até 600 kg,2,8,202208,236596,236594,2
6407641b305a576376e6f650,Excesso de Peso,AGOSTO,2022,RS,Lei 9503/97 Lei 10233/01 Res. CONTRAN nº 882/21 e alterações Portaria SENATRAN 268/22 e alterações ,Transitar com o veículo com excesso de peso - Por Eixo,29,8,202208,361563,361534,29
6407641b305a576376e6f654,Excesso de Peso,AGOSTO,2022,SC,"Lei 9503/97 Lei 10561/02 Res. CONTRAN nº 210/06, 211/06 e 258/07 e alterações Portaria DENATRAN 63/09 e 59/07 e alterações ",Transitar com o veículo com excesso de peso - PBT/PBTC,2,8,202208,361565,361563,2
6407641b305a576376e6f655,Excesso de Peso,AGOSTO,2022,SC,"Lei 9503/97 Lei 10561/02 Res. CONTRAN nº 210/06, 211/06 e 258/07 e alterações Portaria DENATRAN 63/09 e 59/07 e alterações ",Transitar com o veículo com excesso de peso - Por Eixo,3,8,202208,361568,361565,3
6407641b305a576376e6f656,Excesso de Peso,AGOSTO,2022,SC,Lei 9503/97 Lei 10233/01 Res. CONTRAN nº 882/21 e alterações Portaria SENATRAN 268/22 e alterações ,Transitar com o veículo com excesso de peso - PBT/PBTC,5,8,202208,361573,361568,5
6407641b305a576376e6f659,Excesso de Peso,AGOSTO,2022,SC,Lei 9503/97 Lei 10233/01 Res. CONTRAN nº 882/21 e alterações Portaria SENATRAN 268/22 e alterações ,Transitar com o veículo com excesso de peso - PBT/PBTC e Por Eixo,11,8,202208,361599,361588,11
6407641b305a576376e6f63f,Excesso de Peso,AGOSTO,2022,MT,Lei 9503/97 Lei 10233/01 Res. CONTRAN nº 882/21 e alterações Portaria SENATRAN 354/22 e 268/22 e alterações ,Transitar com o veículo com excesso de peso - PBT/PBTC,10,8,202208,320738,320728,10
6407641b305a576376e6f641,Excesso de Peso,AGOSTO,2022,MT,Lei 9503/97 Lei 10233/01 Res. CONTRAN nº 882/21 e alterações Portaria SENATRAN 354/22 e 268/22 e alterações ,Transitar com o veículo com excesso de peso - Por Eixo,110,8,202208,320848,320738,110
6407641b305a576376e6f647,Excesso de Peso,AGOSTO,2022,RJ,Lei 9503/97 Lei 10233/01 Res. CONTRAN nº 882/21 e alterações Portaria SENATRAN 268/22 e alterações ,Transitar com o veículo com excesso de peso - PBT/PBTC,83,8,202208,320931,320848,83
6407641b305a576376e6f63c,Excesso de Peso,AGOSTO,2022,MG,Lei 9503/97 Lei 10233/01 Res. CONTRAN nº 882/21 e alterações Portaria SENATRAN 354/22 e 268/22 e alterações ,Transitar com o veículo com excesso de peso - PBT/PBTC,205,8,202208,238322,238117,205
6407641b305a576376e6f63d,Excesso de Peso,AGOSTO,2022,MG,Lei 9503/97 Lei 10233/01 Res. CONTRAN nº 882/21 e alterações Portaria SENATRAN 354/22 e 268/22 e alterações ,Transitar com o veículo com excesso de peso - Por Eixo,813,8,202208,239135,238322,813
6407641b305a576376e6f644,Excesso de Peso,AGOSTO,2022,RJ,"Lei 9503/97 Lei 10561/02 Res. CONTRAN nº 210/06, 211/06 e 258/07 e alterações Portaria DENATRAN 63/09 e 59/07 e alterações ",Transitar com o veículo com excesso de peso - PBT/PBTC,52,8,202208,239187,239135,52
6407641b305a576376e6f64b,Excesso de Peso,AGOSTO,2022,RJ,Lei 9503/97 Lei 10233/01 Res. CONTRAN nº 882/21 e alterações Portaria SENATRAN 354/22 e 268/22 e alterações ,Transitar com o veículo com excesso de peso - Por Eixo,1099,8,202208,240286,239187,1099
6407641b305a576376e6f64f,Excesso de Peso,AGOSTO,2022,RS,Lei 9503/97 Lei 10233/01 Res. CONTRAN nº 882/21 e alterações Portaria SENATRAN 268/22 e alterações ,Transitar com o veículo com excesso de peso - PBT/PBTC,6,8,202208,240292,240286,6
6407641b305a576376e6f651,Excesso de Peso,AGOSTO,2022,RS,Lei 9503/97 Lei 10233/01 Res. CONTRAN nº 882/21 e alterações Portaria SENATRAN 354/22 e 268/22 e alterações ,Transitar com o veículo com excesso de peso - PBT/PBTC e Por Eixo,58,8,202208,240350,240292,58
6407641b305a576376e6f65a,Excesso de Peso,AGOSTO,2022,SC,Lei 9503/97 Lei 10233/01 Res. CONTRAN nº 882/21 e alterações Portaria SENATRAN 354/22 e 268/22 e alterações ,Transitar com o veículo com excesso de peso - PBT/PBTC,84,8,202208,240434,240350,84
6407641b305a576376e6f64c,Excesso de Peso,AGOSTO,2022,RS,"Lei 9503/97 Lei 10561/02 Res. CONTRAN nº 210/06, 211/06 e 258/07 e alterações Portaria DENATRAN 63/09 e 59/07 e alterações ",Transitar com o veículo com excesso de peso - PBT/PBTC e Por Eixo,1,8,202208,361534,361533,1
6407641b305a576376e6f64a,Excesso de Peso,AGOSTO,2022,RJ,Lei 9503/97 Lei 10233/01 Res. CONTRAN nº 882/21 e alterações Portaria SENATRAN 354/22 e 268/22 e alterações ,Transitar com o veículo com excesso de peso - PBT/PBTC,790,8,202208,361533,360743,790
6407641b305a576376e6f646,Excesso de Peso,AGOSTO,2022,RJ,"Lei 9503/97 Lei 10561/02 Res. CONTRAN nº 210/06, 211/06 e 258/07 e alterações Portaria DENATRAN 63/09 e 59/07 e alterações ",Transitar com o veículo com excesso de peso - Por Eixo,57,8,202208,360743,360686,57
6407641b305a576376e6f643,Excesso de Peso,AGOSTO,2022,RJ,"Lei 9503/97 Lei 10561/02 Res. CONTRAN nº 210/06, 211/06 e 258/07 e alterações Portaria DENATRAN 63/09 e 59/07 e alterações ",Transitar com o veículo com excesso de peso - PBT/PBTC e Por Eixo,26,8,202208,360686,360660,26
6407641b305a576376e6f642,Excesso de Peso,AGOSTO,2022,PR,Lei 9503/97 Lei 10233/01 Res. CONTRAN nº 882/21 e alterações Portaria SENATRAN 354/22 e 268/22 e alterações ,Transitar com o veículo com excesso de peso - Por Eixo,2,8,202208,360660,360658,2
6407641b305a576376e6f629,Evasão de Balança,AGOSTO,2022,SP,"Lei 9503 DE 23/09/1997 Transpor, sem autorização, bloqueio viário com ou sem sinalização ou dispositivos auxiliares, deixar de adentrar às áreas destinadas à pesagem de veículos ou evadir-se para não efetuar o pagamento do pedágio.",Art. 209 Deixar de adentrar as áreas destinadas à pesagem de veículos,1309,8,202208,238039,236730,1309
6407641b305a576376e6f627,Evasão de Balança,AGOSTO,2022,MT,"Lei 9503 DE 23/09/1997 Transpor, sem autorização, bloqueio viário com ou sem sinalização ou dispositivos auxiliares, deixar de adentrar às áreas destinadas à pesagem de veículos ou evadir-se para não efetuar o pagamento do pedágio.",Art. 209 Deixar de adentrar as áreas destinadas à pesagem de veículos,78,8,202208,236730,236652,78
6407641b305a576376e6f661,Excesso de Peso,AGOSTO,2022,SP,Lei 9503/97 Lei 10233/01 Res. CONTRAN nº 882/21 e alterações Portaria SENATRAN 354/22 e 268/22 e alterações ,Transitar com o veículo com excesso de peso - PBT/PBTC,116,8,202208,321269,321153,116
6407641b305a576376e6f625,Evasão de Balança,AGOSTO,2022,GO,"Lei 9503 DE 23/09/1997 Transpor, sem autorização, bloqueio viário com ou sem sinalização ou dispositivos auxiliares, deixar de adentrar às áreas destinadas à pesagem de veículos ou evadir-se para não efetuar o pagamento do pedágio.",Art. 209 Deixar de adentrar as áreas destinadas à pesagem de veículos,55,8,202208,236652,236597,55
6407641b305a576376e6f65f,Excesso de Peso,AGOSTO,2022,SP,Lei 9503/97 Lei 10233/01 Res. CONTRAN nº 882/21 e alterações Portaria SENATRAN 268/22 e alterações ,Transitar com o veículo com excesso de peso - PBT/PBTC,14,8,202208,321044,321030,14
6407641b305a576376e6f65d,Excesso de Peso,AGOSTO,2022,SP,Lei 9503/97 Lei 10233/01 Res. CONTRAN nº 882/21 e alterações Portaria SENATRAN 268/22 e alterações ,Transitar com o veículo com excesso de peso - Por Eixo,2,8,202208,321030,321028,2
6407641b305a576376e6f648,Excesso de Peso,AGOSTO,2022,RJ,Lei 9503/97 Lei 10233/01 Res. CONTRAN nº 882/21 e alterações Portaria SENATRAN 268/22 e alterações ,Transitar com o veículo com excesso de peso - Por Eixo,97,8,202208,321028,320931,97
6407641b305a576376e6f639,Excesso de Peso,AGOSTO,2022,MG,"Lei 9503/97 Lei 10561/02 Res. CONTRAN nº 210/06, 211/06 e 258/07 e alterações Portaria DENATRAN 63/09 e 59/07 e alterações ",Transitar com o veículo com excesso de peso - Por Eixo,29,8,202208,238068,238039,29
6407641b305a576376e6f660,Excesso de Peso,AGOSTO,2022,SP,Lei 9503/97 Lei 10233/01 Res. CONTRAN nº 882/21 e alterações Portaria SENATRAN 354/22 e 268/22 e alterações ,Transitar com o veículo com excesso de peso - PBT/PBTC e Por Eixo,109,8,202208,321153,321044,109
6407641b305a576376e6f657,Excesso de Peso,AGOSTO,2022,SC,Lei 9503/97 Lei 10233/01 Res. CONTRAN nº 882/21 e alterações Portaria SENATRAN 268/22 e alterações ,Transitar com o veículo com excesso de peso - Por Eixo,7,8,202208,361580,361573,7
6407641b305a576376e6f622,CMT - Capacidade Máxima de Tração,AGOSTO,2022,SC,Lei 9503/97 Lei 10233/01 Res. CONTRAN nº 882/21 e alterações Portaria SENATRAN 354/22 e 268/22 e alterações ,Transitar com o veículo excedendo a CMT entre 601 e 1000 kg,1,8,202208,278075,278074,1
6407641b305a576376e6f63b,Excesso de Peso,AGOSTO,2022,MG,Lei 9503/97 Lei 10233/01 Res. CONTRAN nº 882/21 e alterações Portaria SENATRAN 354/22 e 268/22 e alterações ,Transitar com o veículo com excesso de peso - PBT/PBTC e Por Eixo,169,8,202208,360658,360489,169
6407641b305a576376e6f662,Excesso de Peso,AGOSTO,2022,SP,Lei 9503/97 Lei 10233/01 Res. CONTRAN nº 882/21 e alterações Portaria SENATRAN 354/22 e 268/22 e alterações ,Transitar com o veículo com excesso de peso - Por Eixo,133,8,202208,306596,306463,133
6407641b305a576376e6f634,Excesso de Peso,AGOSTO,2022,GO,Lei 9503/97 Lei 10233/01 Res. CONTRAN nº 882/21 e alterações Portaria SENATRAN 268/22 e alterações ,Transitar com o veículo com excesso de peso - PBT/PBTC e Por Eixo,1,8,202208,278142,278141,1
6407641b305a576376e6f635,Excesso de Peso,AGOSTO,2022,MG,"Lei 9503/97 Lei 10561/02 Res. CONTRAN nº 210/06, 211/06 e 258/07 e alterações Portaria DENATRAN 63/09 e 59/07 e alterações ",Transitar com o veículo com excesso de peso - PBT/PBTC e Por Eixo,1,8,202208,278143,278142,1
6407641b305a576376e6f638,Excesso de Peso,AGOSTO,2022,MG,Lei 9503/97 Lei 10233/01 Res. CONTRAN nº 882/21 e alterações Portaria SENATRAN 268/22 e alterações ,Transitar com o veículo com excesso de peso - PBT/PBTC e Por Eixo,23,8,202208,278166,278143,23
6407641b305a576376e6f61d,CMT - Capacidade Máxima de Tração,AGOSTO,2022,MG,Lei 9503/97 Lei 10233/01 Res. CONTRAN nº 882/21 e alterações Portaria SENATRAN 354/22 e 268/22 e alterações ,Transitar com o veículo excedendo a CMT acima de 1000 kg,8,8,202208,278074,278066,8
6407641b305a576376e6f640,Excesso de Peso,AGOSTO,2022,MT,Lei 9503/97 Lei 10233/01 Res. CONTRAN nº 882/21 e alterações Portaria SENATRAN 354/22 e 268/22 e alterações ,Transitar com o veículo com excesso de peso - PBT/PBTC e Por Eixo,11,8,202208,278178,278167,11
6407641b305a576376e6f645,Excesso de Peso,AGOSTO,2022,RJ,Lei 9503/97 Lei 10233/01 Res. CONTRAN nº 882/21 e alterações Portaria SENATRAN 268/22 e alterações ,Transitar com o veículo com excesso de peso - PBT/PBTC e Por Eixo,52,8,202208,278230,278178,52
6407641b305a576376e6f649,Excesso de Peso,AGOSTO,2022,RJ,Lei 9503/97 Lei 10233/01 Res. CONTRAN nº 882/21 e alterações Portaria SENATRAN 354/22 e 268/22 e alterações ,Transitar com o veículo com excesso de peso - PBT/PBTC e Por Eixo,515,8,202208,278745,278230,515
6407641b305a576376e6f64d,Excesso de Peso,AGOSTO,2022,RS,"Lei 9503/97 Lei 10561/02 Res. CONTRAN nº 210/06, 211/06 e 258/07 e alterações Portaria DENATRAN 63/09 e 59/07 e alterações ",Transitar com o veículo com excesso de peso - Por Eixo,1,8,202208,278746,278745,1
6407641b305a576376e6f64e,Excesso de Peso,AGOSTO,2022,RS,Lei 9503/97 Lei 10233/01 Res. CONTRAN nº 882/21 e alterações Portaria SENATRAN 268/22 e alterações ,Transitar com o veículo com excesso de peso - PBT/PBTC e Por Eixo,3,8,202208,278749,278746,3
6407641b305a576376e6f652,Excesso de Peso,AGOSTO,2022,RS,Lei 9503/97 Lei 10233/01 Res. CONTRAN nº 882/21 e alterações Portaria SENATRAN 354/22 e 268/22 e alterações ,Transitar com o veículo com excesso de peso - PBT/PBTC,92,8,202208,278841,278749,92
6407641b305a576376e6f653,Excesso de Peso,AGOSTO,2022,RS,Lei 9503/97 Lei 10233/01 Res. CONTRAN nº 882/21 e alterações Portaria SENATRAN 354/22 e 268/22 e alterações ,Transitar com o veículo com excesso de peso - Por Eixo,354,8,202208,279195,278841,354
6407641b305a576376e6f65e,Excesso de Peso,AGOSTO,2022,SP,Lei 9503/97 Lei 10233/01 Res. CONTRAN nº 882/21 e alterações Portaria SENATRAN 268/22 e alterações ,Transitar com o veículo com excesso de peso - PBT/PBTC e Por Eixo,7,8,202208,279202,279195,7
6407641b305a576376e6f658,Excesso de Peso,AGOSTO,2022,SC,"Lei 9503/97 Lei 10561/02 Res. CONTRAN nº 210/06, 211/06 e 258/07 e alterações Portaria DENATRAN 63/09 e 59/07 e alterações ",Transitar com o veículo com excesso de peso - PBT/PBTC e Por Eixo,8,8,202208,361588,361580,8
6407641b305a576376e6f636,Excesso de Peso,AGOSTO,2022,MG,"Lei 9503/97 Lei 10561/02 Res. CONTRAN nº 210/06, 211/06 e 258/07 e alterações Portaria DENATRAN 63/09 e 59/07 e alterações ",Transitar com o veículo com excesso de peso - PBT/PBTC,4,8,202208,360489,360485,4
6407641b305a576376e6f62f,Excesso de Peso,AGOSTO,2022,ES,Lei 9503/97 Lei 10233/01 Res. CONTRAN nº 882/21 e alterações Portaria SENATRAN 268/22 e alterações ,Transitar com o veículo com excesso de peso - Por Eixo,29,8,202208,278141,278112,29
6407641b305a576376e6f63e,Excesso de Peso,AGOSTO,2022,MT,Lei 9503/97 Lei 10233/01 Res. CONTRAN nº 882/21 e alterações Portaria SENATRAN 268/22 e alterações ,Transitar com o veículo com excesso de peso - PBT/PBTC e Por Eixo,1,8,202208,278167,278166,1
6407641b305a576376e6f632,Excesso de Peso,AGOSTO,2022,ES,Lei 9503/97 Lei 10233/01 Res. CONTRAN nº 882/21 e alterações Portaria SENATRAN 354/22 e 268/22 e alterações ,Transitar com o veículo com excesso de peso - Por Eixo,376,8,202208,360484,360108,376
6407641b305a576376e6f623,CMT - Capacidade Máxima de Tração,AGOSTO,2022,SC,Lei 9503/97 Lei 10233/01 Res. CONTRAN nº 882/21 e alterações Portaria SENATRAN 354/22 e 268/22 e alterações ,Transitar com o veículo excedendo a CMT acima de 1000 kg,10,8,202208,278085,278075,10
6407641b305a576376e6f62a,Excesso de Peso,AGOSTO,2022,BA,Lei 9503/97 Lei 10233/01 Res. CONTRAN nº 882/21 e alterações Portaria SENATRAN 354/22 e 268/22 e alterações ,Transitar com o veículo com excesso de peso - PBT/PBTC,8,8,202208,278093,278085,8
6407641b305a576376e6f62b,Excesso de Peso,AGOSTO,2022,ES,"Lei 9503/97 Lei 10561/02 Res. CONTRAN nº 210/06, 211/06 e 258/07 e alterações Portaria DENATRAN 63/09 e 59/07 e alterações ",Transitar com o veículo com excesso de peso - PBT/PBTC e Por Eixo,1,8,202208,278094,278093,1
6407641b305a576376e6f62d,Excesso de Peso,AGOSTO,2022,ES,Lei 9503/97 Lei 10233/01 Res. CONTRAN nº 882/21 e alterações Portaria SENATRAN 268/22 e alterações ,Transitar com o veículo com excesso de peso - PBT/PBTC,18,8,202208,278112,278094,18
6407641b305a576376e6f619,CMT - Capacidade Máxima de Tração,AGOSTO,2022,ES,Lei 9503/97 Lei 10233/01 Res. CONTRAN nº 882/21 e alterações Portaria SENATRAN 354/22 e 268/22 e alterações ,Transitar com o veículo excedendo a CMT acima de 1000 kg,4,8,202208,358235,358231,4
6407641b305a576376e6f633,Excesso de Peso,AGOSTO,2022,GO,Lei 9503/97 Lei 10233/01 Res. CONTRAN nº 882/21 e alterações Portaria SENATRAN 268/22 e alterações ,Transitar com o veículo com excesso de peso - PBT/PBTC,1,8,202208,360485,360484,1
6407641b305a576376e6f624,CMT - Capacidade Máxima de Tração,AGOSTO,2022,SP,Lei 9503/97 Lei 10233/01 Res. CONTRAN nº 882/21 e alterações Portaria SENATRAN 354/22 e 268/22 e alterações ,Transitar com o veículo excedendo a CMT acima de 1000 kg,1,8,202208,358238,358237,1
6407641b305a576376e6f621,CMT - Capacidade Máxima de Tração,AGOSTO,2022,RJ,Lei 9503/97 Lei 10233/01 Res. CONTRAN nº 882/21 e alterações Portaria SENATRAN 354/22 e 268/22 e alterações ,Transitar com o veículo excedendo a CMT em até 600 kg,2,8,202208,358237,358235,2
6407641b305a576376e6f626,Evasão de Balança,AGOSTO,2022,MG,"Lei 9503 DE 23/09/1997 Transpor, sem autorização, bloqueio viário com ou sem sinalização ou dispositivos auxiliares, deixar de adentrar às áreas destinadas à pesagem de veículos ou evadir-se para não efetuar o pagamento do pedágio.",Art. 209 Deixar de adentrar as áreas destinadas à pesagem de veículos,1870,8,202208,360108,358238,1870
6407641b305a576376e6f66a,CMT - Capacidade Máxima de Tração,SETEMBRO,2022,RS,Lei 9503/97 Lei 10233/01 Res. CONTRAN nº 882/21 e alterações Portaria SENATRAN 354/22 e 268/22 e alterações ,Transitar com o veículo excedendo a CMT em até 600 kg,2,9,202209,306617,306615,2
6407641b305a576376e6f677,Excesso de Peso,SETEMBRO,2022,RJ,Lei 9503/97 Lei 10233/01 Res. CONTRAN nº 882/21 e alterações Portaria SENATRAN 354/22 e 268/22 e alterações ,Transitar com o veículo com excesso de peso - PBT/PBTC e Por Eixo,190,9,202209,243698,243508,190
6407641b305a576376e6f67c,Excesso de Peso,SETEMBRO,2022,RS,Lei 9503/97 Lei 10233/01 Res. CONTRAN nº 882/21 e alterações Portaria SENATRAN 354/22 e 268/22 e alterações ,Transitar com o veículo com excesso de peso - Por Eixo,308,9,202209,244006,243698,308
6407641b305a576376e6f67d,Excesso de Peso,SETEMBRO,2022,SC,Lei 9503/97 Lei 10233/01 Res. CONTRAN nº 882/21 e alterações Portaria SENATRAN 354/22 e 268/22 e alterações ,Transitar com o veículo com excesso de peso - PBT/PBTC,100,9,202209,244106,244006,100
6407641b305a576376e6f681,Excesso de Peso,SETEMBRO,2022,SP,Lei 9503/97 Lei 10233/01 Res. CONTRAN nº 882/21 e alterações Portaria SENATRAN 354/22 e 268/22 e alterações ,Transitar com o veículo com excesso de peso - Por Eixo,152,9,202209,244258,244106,152
6407641b305a576376e6f682,Excesso de Peso,SETEMBRO,2022,SP,Lei 9503/97 Lei 10233/01 Res. CONTRAN nº 882/21 e alterações Portaria SENATRAN 354/22 e 268/22 e alterações ,Transitar com o veículo com excesso de peso - PBT/PBTC,241,9,202209,244499,244258,241
6407641b305a576376e6f680,Excesso de Peso,SETEMBRO,2022,SP,Lei 9503/97 Lei 10233/01 Res. CONTRAN nº 882/21 e alterações Portaria SENATRAN 354/22 e 268/22 e alterações ,Transitar com o veículo com excesso de peso - PBT/PBTC e Por Eixo,140,9,202209,363591,363451,140
6407641b305a576376e6f67f,Excesso de Peso,SETEMBRO,2022,SC,Lei 9503/97 Lei 10233/01 Res. CONTRAN nº 882/21 e alterações Portaria SENATRAN 354/22 e 268/22 e alterações ,Transitar com o veículo com excesso de peso - Por Eixo,247,9,202209,310474,310227,247
6407641b305a576376e6f664,CMT - Capacidade Máxima de Tração,SETEMBRO,2022,ES,Lei 9503/97 Lei 10233/01 Res. CONTRAN nº 882/21 e alterações Portaria SENATRAN 354/22 e 268/22 e alterações ,Transitar com o veículo excedendo a CMT em até 600 kg,6,9,202209,240440,240434,6
6407641b305a576376e6f66d,Evasão de Balança,SETEMBRO,2022,MG,"Lei 9503 DE 23/09/1997 Transpor, sem autorização, bloqueio viário com ou sem sinalização ou dispositivos auxiliares, deixar de adentrar às áreas destinadas à pesagem de veículos ou evadir-se para não efetuar o pagamento do pedágio.",Art. 209 Deixar de adentrar as áreas destinadas à pesagem de veículos,1868,9,202209,308485,306617,1868
6407641b305a576376e6f670,Evasão de Balança,SETEMBRO,2022,SP,"Lei 9503 DE 23/09/1997 Transpor, sem autorização, bloqueio viário com ou sem sinalização ou dispositivos auxiliares, deixar de adentrar às áreas destinadas à pesagem de veículos ou evadir-se para não efetuar o pagamento do pedágio.",Art. 209 Deixar de adentrar as áreas destinadas à pesagem de veículos,1600,9,202209,242041,240441,1600
6407641b305a576376e6f67e,Excesso de Peso,SETEMBRO,2022,SC,Lei 9503/97 Lei 10233/01 Res. CONTRAN nº 882/21 e alterações Portaria SENATRAN 354/22 e 268/22 e alterações ,Transitar com o veículo com excesso de peso - PBT/PBTC e Por Eixo,157,9,202209,310227,310070,157
6407641b305a576376e6f67a,Excesso de Peso,SETEMBRO,2022,RS,Lei 9503/97 Lei 10233/01 Res. CONTRAN nº 882/21 e alterações Portaria SENATRAN 354/22 e 268/22 e alterações ,Transitar com o veículo com excesso de peso - PBT/PBTC e Por Eixo,51,9,202209,310070,310019,51
6407641b305a576376e6f679,Excesso de Peso,SETEMBRO,2022,RJ,Lei 9503/97 Lei 10233/01 Res. CONTRAN nº 882/21 e alterações Portaria SENATRAN 354/22 e 268/22 e alterações ,Transitar com o veículo com excesso de peso - Por Eixo,627,9,202209,310019,309392,627
6407641b305a576376e6f674,Excesso de Peso,SETEMBRO,2022,MG,Lei 9503/97 Lei 10233/01 Res. CONTRAN nº 882/21 e alterações Portaria SENATRAN 354/22 e 268/22 e alterações ,Transitar com o veículo com excesso de peso - PBT/PBTC,305,9,202209,309392,309087,305
6407641b305a576376e6f669,CMT - Capacidade Máxima de Tração,SETEMBRO,2022,RS,Lei 9503/97 Lei 10233/01 Res. CONTRAN nº 882/21 e alterações Portaria SENATRAN 354/22 e 268/22 e alterações ,Transitar com o veículo excedendo a CMT acima de 1000 kg,1,9,202209,240441,240440,1
6407641b305a576376e6f66e,Evasão de Balança,SETEMBRO,2022,MT,"Lei 9503 DE 23/09/1997 Transpor, sem autorização, bloqueio viário com ou sem sinalização ou dispositivos auxiliares, deixar de adentrar às áreas destinadas à pesagem de veículos ou evadir-se para não efetuar o pagamento do pedágio.",Art. 209 Deixar de adentrar as áreas destinadas à pesagem de veículos,602,9,202209,309087,308485,602
6407641b305a576376e6f668,CMT - Capacidade Máxima de Tração,SETEMBRO,2022,RJ,Lei 9503/97 Lei 10233/01 Res. CONTRAN nº 882/21 e alterações Portaria SENATRAN 354/22 e 268/22 e alterações ,Transitar com o veículo excedendo a CMT em até 600 kg,1,9,202209,306615,306614,1
6407641b305a576376e6f665,CMT - Capacidade Máxima de Tração,SETEMBRO,2022,ES,Lei 9503/97 Lei 10233/01 Res. CONTRAN nº 882/21 e alterações Portaria SENATRAN 354/22 e 268/22 e alterações ,Transitar com o veículo excedendo a CMT acima de 1000 kg,18,9,202209,306614,306596,18
6407641b305a576376e6f666,CMT - Capacidade Máxima de Tração,SETEMBRO,2022,MG,Lei 9503/97 Lei 10233/01 Res. CONTRAN nº 882/21 e alterações Portaria SENATRAN 354/22 e 268/22 e alterações ,Transitar com o veículo excedendo a CMT em até 600 kg,1,9,202209,361876,361875,1
6407641b305a576376e6f667,CMT - Capacidade Máxima de Tração,SETEMBRO,2022,MG,Lei 9503/97 Lei 10233/01 Res. CONTRAN nº 882/21 e alterações Portaria SENATRAN 354/22 e 268/22 e alterações ,Transitar com o veículo excedendo a CMT acima de 1000 kg,3,9,202209,361879,361876,3
6407641b305a576376e6f66b,CMT - Capacidade Máxima de Tração,SETEMBRO,2022,SC,Lei 9503/97 Lei 10233/01 Res. CONTRAN nº 882/21 e alterações Portaria SENATRAN 354/22 e 268/22 e alterações ,Transitar com o veículo excedendo a CMT acima de 1000 kg,6,9,202209,361885,361879,6
6407641b305a576376e6f673,Excesso de Peso,SETEMBRO,2022,ES,Lei 9503/97 Lei 10233/01 Res. CONTRAN nº 882/21 e alterações Portaria SENATRAN 354/22 e 268/22 e alterações ,Transitar com o veículo com excesso de peso - Por Eixo,1017,9,202209,362902,361885,1017
6407641b305a576376e6f672,Excesso de Peso,SETEMBRO,2022,ES,Lei 9503/97 Lei 10233/01 Res. CONTRAN nº 882/21 e alterações Portaria SENATRAN 354/22 e 268/22 e alterações ,Transitar com o veículo com excesso de peso - PBT/PBTC e Por Eixo,475,9,202209,242516,242041,475
6407641b305a576376e6f676,Excesso de Peso,SETEMBRO,2022,MG,Lei 9503/97 Lei 10233/01 Res. CONTRAN nº 882/21 e alterações Portaria SENATRAN 354/22 e 268/22 e alterações ,Transitar com o veículo com excesso de peso - Por Eixo,992,9,202209,243508,242516,992
6407641b305a576376e6f67b,Excesso de Peso,SETEMBRO,2022,RS,Lei 9503/97 Lei 10233/01 Res. CONTRAN nº 882/21 e alterações Portaria SENATRAN 354/22 e 268/22 e alterações ,Transitar com o veículo com excesso de peso - PBT/PBTC,61,9,202209,363451,363390,61
6407641b305a576376e6f675,Excesso de Peso,SETEMBRO,2022,MG,Lei 9503/97 Lei 10233/01 Res. CONTRAN nº 882/21 e alterações Portaria SENATRAN 354/22 e 268/22 e alterações ,Transitar com o veículo com excesso de peso - PBT/PBTC e Por Eixo,371,9,202209,326440,326069,371
6407641b305a576376e6f678,Excesso de Peso,SETEMBRO,2022,RJ,Lei 9503/97 Lei 10233/01 Res. CONTRAN nº 882/21 e alterações Portaria SENATRAN 354/22 e 268/22 e alterações ,Transitar com o veículo com excesso de peso - PBT/PBTC,488,9,202209,363390,362902,488
6407641b305a576376e6f671,Excesso de Peso,SETEMBRO,2022,ES,Lei 9503/97 Lei 10233/01 Res. CONTRAN nº 882/21 e alterações Portaria SENATRAN 354/22 e 268/22 e alterações ,Transitar com o veículo com excesso de peso - PBT/PBTC,354,9,202209,326069,325715,354
6407641b305a576376e6f66f,Evasão de Balança,SETEMBRO,2022,RJ,"Lei 9503 DE 23/09/1997 Transpor, sem autorização, bloqueio viário com ou sem sinalização ou dispositivos auxiliares, deixar de adentrar às áreas destinadas à pesagem de veículos ou evadir-se para não efetuar o pagamento do pedágio.",Art. 209 Deixar de adentrar as áreas destinadas à pesagem de veículos,4443,9,202209,325715,321272,4443
6407641b305a576376e6f66c,Evasão de Balança,SETEMBRO,2022,GO,"Lei 9503 DE 23/09/1997 Transpor, sem autorização, bloqueio viário com ou sem sinalização ou dispositivos auxiliares, deixar de adentrar às áreas destinadas à pesagem de veículos ou evadir-se para não efetuar o pagamento do pedágio.",Art. 209 Deixar de adentrar as áreas destinadas à pesagem de veículos,1,9,202209,321272,321271,1
6407641b305a576376e6f663,CMT - Capacidade Máxima de Tração,SETEMBRO,2022,ES,Lei 9503/97 Lei 10233/01 Res. CONTRAN nº 882/21 e alterações Portaria SENATRAN 354/22 e 268/22 e alterações ,Transitar com o veículo excedendo a CMT entre 601 e 1000 kg,2,9,202209,321271,321269,2
6407641b305a576376e6f68e,Evasão de Balança,OUTUBRO,2022,GO,"Lei 9503 DE 23/09/1997 Transpor, sem autorização, bloqueio viário com ou sem sinalização ou dispositivos auxiliares, deixar de adentrar às áreas destinadas à pesagem de veículos ou evadir-se para não efetuar o pagamento do pedágio.",Art. 209 Deixar de adentrar as áreas destinadas à pesagem de veículos,2,10,202210,363594,363592,2
6407641b305a576376e6f6a5,Excesso de Peso,OUTUBRO,2022,SC,Lei 9503/97 Lei 10233/01 Res. CONTRAN nº 882/21 e alterações Portaria SENATRAN 354/22 e 268/22 e alterações ,Transitar com o veículo com excesso de peso - PBT/PBTC,79,10,202210,368522,368443,79
6407641b305a576376e6f6a2,Excesso de Peso,OUTUBRO,2022,RS,Lei 9503/97 Lei 10233/01 Res. CONTRAN nº 882/21 e alterações Portaria SENATRAN 354/22 e 268/22 e alterações ,Transitar com o veículo com excesso de peso - PBT/PBTC e Por Eixo,277,10,202210,368443,368166,277
6407641b305a576376e6f6a0,Excesso de Peso,OUTUBRO,2022,RJ,Lei 9503/97 Lei 10233/01 Res. CONTRAN nº 882/21 e alterações Portaria SENATRAN 354/22 e 268/22 e alterações ,Transitar com o veículo com excesso de peso - PBT/PBTC,639,10,202210,368166,367527,639
6407641b305a576376e6f69d,Excesso de Peso,OUTUBRO,2022,PR,Lei 9503/97 Lei 10233/01 Res. CONTRAN nº 882/21 e alterações Portaria SENATRAN 354/22 e 268/22 e alterações ,Transitar com o veículo com excesso de peso - PBT/PBTC,21,10,202210,367527,367506,21
6407641b305a576376e6f695,Excesso de Peso,OUTUBRO,2022,ES,Lei 9503/97 Lei 10233/01 Res. CONTRAN nº 882/21 e alterações Portaria SENATRAN 354/22 e 268/22 e alterações ,Transitar com o veículo com excesso de peso - Por Eixo,931,10,202210,367506,366575,931
6407641b305a576376e6f691,Evasão de Balança,OUTUBRO,2022,RJ,"Lei 9503 DE 23/09/1997 Transpor, sem autorização, bloqueio viário com ou sem sinalização ou dispositivos auxiliares, deixar de adentrar às áreas destinadas à pesagem de veículos ou evadir-se para não efetuar o pagamento do pedágio.",Art. 209 Deixar de adentrar as áreas destinadas à pesagem de veículos,1617,10,202210,366229,364612,1617
6407641b305a576376e6f68f,Evasão de Balança,OUTUBRO,2022,MG,"Lei 9503 DE 23/09/1997 Transpor, sem autorização, bloqueio viário com ou sem sinalização ou dispositivos auxiliares, deixar de adentrar às áreas destinadas à pesagem de veículos ou evadir-se para não efetuar o pagamento do pedágio.",Art. 209 Deixar de adentrar as áreas destinadas à pesagem de veículos,1018,10,202210,364612,363594,1018
6407641b305a576376e6f688,CMT - Capacidade Máxima de Tração,OUTUBRO,2022,MT,Lei 9503/97 Lei 10233/01 Res. CONTRAN nº 882/21 e alterações Portaria SENATRAN 354/22 e 268/22 e alterações ,Transitar com o veículo excedendo a CMT acima de 1000 kg,1,10,202210,363592,363591,1
6407641b305a576376e6f694,Excesso de Peso,OUTUBRO,2022,ES,Lei 9503/97 Lei 10233/01 Res. CONTRAN nº 882/21 e alterações Portaria SENATRAN 354/22 e 268/22 e alterações ,Transitar com o veículo com excesso de peso - PBT/PBTC e Por Eixo,346,10,202210,366575,366229,346
6407641b305a576376e6f686,CMT - Capacidade Máxima de Tração,OUTUBRO,2022,MG,Lei 9503/97 Lei 10233/01 Res. CONTRAN nº 882/21 e alterações Portaria SENATRAN 354/22 e 268/22 e alterações ,Transitar com o veículo excedendo a CMT em até 600 kg,3,10,202210,310482,310479,3
6407641b305a576376e6f68b,CMT - Capacidade Máxima de Tração,OUTUBRO,2022,RJ,Lei 9503/97 Lei 10233/01 Res. CONTRAN nº 882/21 e alterações Portaria SENATRAN 354/22 e 268/22 e alterações ,Transitar com o veículo excedendo a CMT acima de 1000 kg,6,10,202210,310488,310482,6
6407641b305a576376e6f6a6,Excesso de Peso,OUTUBRO,2022,SC,Lei 9503/97 Lei 10233/01 Res. CONTRAN nº 882/21 e alterações Portaria SENATRAN 354/22 e 268/22 e alterações ,Transitar com o veículo com excesso de peso - PBT/PBTC e Por Eixo,103,10,202210,330574,330471,103
6407641b305a576376e6f69f,Excesso de Peso,OUTUBRO,2022,RJ,Lei 9503/97 Lei 10233/01 Res. CONTRAN nº 882/21 e alterações Portaria SENATRAN 354/22 e 268/22 e alterações ,Transitar com o veículo com excesso de peso - PBT/PBTC e Por Eixo,371,10,202210,330471,330100,371
6407641b305a576376e6f698,Excesso de Peso,OUTUBRO,2022,MG,Lei 9503/97 Lei 10233/01 Res. CONTRAN nº 882/21 e alterações Portaria SENATRAN 354/22 e 268/22 e alterações ,Transitar com o veículo com excesso de peso - Por Eixo,865,10,202210,330033,329168,865
6407641b305a576376e6f692,Evasão de Balança,OUTUBRO,2022,SP,"Lei 9503 DE 23/09/1997 Transpor, sem autorização, bloqueio viário com ou sem sinalização ou dispositivos auxiliares, deixar de adentrar às áreas destinadas à pesagem de veículos ou evadir-se para não efetuar o pagamento do pedágio.",Art. 209 Deixar de adentrar as áreas destinadas à pesagem de veículos,2483,10,202210,329168,326685,2483
6407641b305a576376e6f690,Evasão de Balança,OUTUBRO,2022,MT,"Lei 9503 DE 23/09/1997 Transpor, sem autorização, bloqueio viário com ou sem sinalização ou dispositivos auxiliares, deixar de adentrar às áreas destinadas à pesagem de veículos ou evadir-se para não efetuar o pagamento do pedágio.",Art. 209 Deixar de adentrar as áreas destinadas à pesagem de veículos,219,10,202210,326685,326466,219
6407641b305a576376e6f68d,CMT - Capacidade Máxima de Tração,OUTUBRO,2022,RS,Lei 9503/97 Lei 10233/01 Res. CONTRAN nº 882/21 e alterações Portaria SENATRAN 354/22 e 268/22 e alterações ,Transitar com o veículo excedendo a CMT em até 600 kg,4,10,202210,326466,326462,4
6407641b305a576376e6f68c,CMT - Capacidade Máxima de Tração,OUTUBRO,2022,RS,Lei 9503/97 Lei 10233/01 Res. CONTRAN nº 882/21 e alterações Portaria SENATRAN 354/22 e 268/22 e alterações ,Transitar com o veículo excedendo a CMT acima de 1000 kg,3,10,202210,326462,326459,3
6407641b305a576376e6f687,CMT - Capacidade Máxima de Tração,OUTUBRO,2022,MG,Lei 9503/97 Lei 10233/01 Res. CONTRAN nº 882/21 e alterações Portaria SENATRAN 354/22 e 268/22 e alterações ,Transitar com o veículo excedendo a CMT acima de 1000 kg,15,10,202210,326459,326444,15
6407641b305a576376e6f684,CMT - Capacidade Máxima de Tração,OUTUBRO,2022,ES,Lei 9503/97 Lei 10233/01 Res. CONTRAN nº 882/21 e alterações Portaria SENATRAN 354/22 e 268/22 e alterações ,Transitar com o veículo excedendo a CMT acima de 1000 kg,4,10,202210,326444,326440,4
6407641b305a576376e6f689,CMT - Capacidade Máxima de Tração,OUTUBRO,2022,RJ,Lei 9503/97 Lei 10233/01 Res. CONTRAN nº 882/21 e alterações Portaria SENATRAN 354/22 e 268/22 e alterações ,Transitar com o veículo excedendo a CMT entre 601 e 1000 kg,5,10,202210,244504,244499,5
6407641b305a576376e6f683,CMT - Capacidade Máxima de Tração,OUTUBRO,2022,ES,Lei 9503/97 Lei 10233/01 Res. CONTRAN nº 882/21 e alterações Portaria SENATRAN 354/22 e 268/22 e alterações ,Transitar com o veículo excedendo a CMT em até 600 kg,2,10,202210,310476,310474,2
6407641b305a576376e6f685,CMT - Capacidade Máxima de Tração,OUTUBRO,2022,MG,Lei 9503/97 Lei 10233/01 Res. CONTRAN nº 882/21 e alterações Portaria SENATRAN 354/22 e 268/22 e alterações ,Transitar com o veículo excedendo a CMT entre 601 e 1000 kg,3,10,202210,310479,310476,3
6407641b305a576376e6f693,Excesso de Peso,OUTUBRO,2022,ES,Lei 9503/97 Lei 10233/01 Res. CONTRAN nº 882/21 e alterações Portaria SENATRAN 354/22 e 268/22 e alterações ,Transitar com o veículo com excesso de peso - PBT/PBTC,318,10,202210,310806,310488,318
6407641b305a576376e6f697,Excesso de Peso,OUTUBRO,2022,MG,Lei 9503/97 Lei 10233/01 Res. CONTRAN nº 882/21 e alterações Portaria SENATRAN 354/22 e 268/22 e alterações ,Transitar com o veículo com excesso de peso - PBT/PBTC e Por Eixo,364,10,202210,311170,310806,364
6407641b305a576376e6f69a,Excesso de Peso,OUTUBRO,2022,MT,Lei 9503/97 Lei 10233/01 Res. CONTRAN nº 882/21 e alterações Portaria SENATRAN 354/22 e 268/22 e alterações ,Transitar com o veículo com excesso de peso - PBT/PBTC e Por Eixo,101,10,202210,311271,311170,101
6407641b305a576376e6f69c,Excesso de Peso,OUTUBRO,2022,PR,Lei 9503/97 Lei 10233/01 Res. CONTRAN nº 882/21 e alterações Portaria SENATRAN 354/22 e 268/22 e alterações ,Transitar com o veículo com excesso de peso - PBT/PBTC e Por Eixo,20,10,202210,311291,311271,20
6407641b305a576376e6f69e,Excesso de Peso,OUTUBRO,2022,PR,Lei 9503/97 Lei 10233/01 Res. CONTRAN nº 882/21 e alterações Portaria SENATRAN 354/22 e 268/22 e alterações ,Transitar com o veículo com excesso de peso - Por Eixo,21,10,202210,311312,311291,21
6407641b305a576376e6f6a7,Excesso de Peso,OUTUBRO,2022,SC,Lei 9503/97 Lei 10233/01 Res. CONTRAN nº 882/21 e alterações Portaria SENATRAN 354/22 e 268/22 e alterações ,Transitar com o veículo com excesso de peso - Por Eixo,242,10,202210,330816,330574,242
6407641b305a576376e6f6a8,Excesso de Peso,OUTUBRO,2022,SP,Lei 9503/97 Lei 10233/01 Res. CONTRAN nº 882/21 e alterações Portaria SENATRAN 354/22 e 268/22 e alterações ,Transitar com o veículo com excesso de peso - PBT/PBTC e Por Eixo,166,10,202210,330982,330816,166
6407641b305a576376e6f699,Excesso de Peso,OUTUBRO,2022,MT,Lei 9503/97 Lei 10233/01 Res. CONTRAN nº 882/21 e alterações Portaria SENATRAN 354/22 e 268/22 e alterações ,Transitar com o veículo com excesso de peso - PBT/PBTC,67,10,202210,330100,330033,67
6407641b305a576376e6f6aa,Excesso de Peso,OUTUBRO,2022,SP,Lei 9503/97 Lei 10233/01 Res. CONTRAN nº 882/21 e alterações Portaria SENATRAN 354/22 e 268/22 e alterações ,Transitar com o veículo com excesso de peso - Por Eixo,376,10,202210,331650,331274,376
6407641b305a576376e6f68a,CMT - Capacidade Máxima de Tração,OUTUBRO,2022,RJ,Lei 9503/97 Lei 10233/01 Res. CONTRAN nº 882/21 e alterações Portaria SENATRAN 354/22 e 268/22 e alterações ,Transitar com o veículo excedendo a CMT em até 600 kg,6,10,202210,244510,244504,6
6407641b305a576376e6f696,Excesso de Peso,OUTUBRO,2022,MG,Lei 9503/97 Lei 10233/01 Res. CONTRAN nº 882/21 e alterações Portaria SENATRAN 354/22 e 268/22 e alterações ,Transitar com o veículo com excesso de peso - PBT/PBTC,291,10,202210,244801,244510,291
6407641b305a576376e6f69b,Excesso de Peso,OUTUBRO,2022,MT,Lei 9503/97 Lei 10233/01 Res. CONTRAN nº 882/21 e alterações Portaria SENATRAN 354/22 e 268/22 e alterações ,Transitar com o veículo com excesso de peso - Por Eixo,628,10,202210,245429,244801,628
6407641b305a576376e6f6a1,Excesso de Peso,OUTUBRO,2022,RJ,Lei 9503/97 Lei 10233/01 Res. CONTRAN nº 882/21 e alterações Portaria SENATRAN 354/22 e 268/22 e alterações ,Transitar com o veículo com excesso de peso - Por Eixo,778,10,202210,246207,245429,778
6407641b305a576376e6f6a3,Excesso de Peso,OUTUBRO,2022,RS,Lei 9503/97 Lei 10233/01 Res. CONTRAN nº 882/21 e alterações Portaria SENATRAN 354/22 e 268/22 e alterações ,Transitar com o veículo com excesso de peso - PBT/PBTC,288,10,202210,246495,246207,288
6407641b305a576376e6f6a4,Excesso de Peso,OUTUBRO,2022,RS,Lei 9503/97 Lei 10233/01 Res. CONTRAN nº 882/21 e alterações Portaria SENATRAN 354/22 e 268/22 e alterações ,Transitar com o veículo com excesso de peso - Por Eixo,621,10,202210,247116,246495,621
6407641b305a576376e6f6a9,Excesso de Peso,OUTUBRO,2022,SP,Lei 9503/97 Lei 10233/01 Res. CONTRAN nº 882/21 e alterações Portaria SENATRAN 354/22 e 268/22 e alterações ,Transitar com o veículo com excesso de peso - PBT/PBTC,292,10,202210,331274,330982,292
6407641b305a576376e6f6bc,Evasão de Balança,NOVEMBRO,2022,SP,"Lei 9503 DE 23/09/1997 Transpor, sem autorização, bloqueio viário com ou sem sinalização ou dispositivos auxiliares, deixar de adentrar às áreas destinadas à pesagem de veículos ou evadir-se para não efetuar o pagamento do pedágio.",Art. 209 Deixar de adentrar as áreas destinadas à pesagem de veículos,2402,11,202211,252782,250380,2402
6407641b305a576376e6f6bb,Evasão de Balança,NOVEMBRO,2022,RJ,"Lei 9503 DE 23/09/1997 Transpor, sem autorização, bloqueio viário com ou sem sinalização ou dispositivos auxiliares, deixar de adentrar às áreas destinadas à pesagem de veículos ou evadir-se para não efetuar o pagamento do pedágio.",Art. 209 Deixar de adentrar as áreas destinadas à pesagem de veículos,2064,11,202211,250380,248316,2064
6407641b305a576376e6f6ba,Evasão de Balança,NOVEMBRO,2022,MT,"Lei 9503 DE 23/09/1997 Transpor, sem autorização, bloqueio viário com ou sem sinalização ou dispositivos auxiliares, deixar de adentrar às áreas destinadas à pesagem de veículos ou evadir-se para não efetuar o pagamento do pedágio.",Art. 209 Deixar de adentrar as áreas destinadas à pesagem de veículos,1184,11,202211,248316,247132,1184
6407641b305a576376e6f6b3,CMT - Capacidade Máxima de Tração,NOVEMBRO,2022,RJ,Lei 9503/97 Lei 10233/01 Res. CONTRAN nº 882/21 e alterações Portaria SENATRAN 354/22 e 268/22 e alterações ,Transitar com o veículo excedendo a CMT entre 601 e 1000 kg,5,11,202211,311318,311313,5
6407641b305a576376e6f6ab,CMT - Capacidade Máxima de Tração,NOVEMBRO,2022,ES,Lei 9503/97 Lei 10233/01 Res. CONTRAN nº 882/21 e alterações Portaria SENATRAN 354/22 e 268/22 e alterações ,Transitar com o veículo excedendo a CMT acima de 1000 kg,1,11,202211,311313,311312,1
6407641b305a576376e6f6c6,Excesso de Peso,NOVEMBRO,2022,MT,Lei 9503/97 Lei 10233/01 Res. CONTRAN nº 882/21 e alterações Portaria SENATRAN 354/22 e 268/22 e alterações ,Transitar com o veículo com excesso de peso - PBT/PBTC,107,11,202211,252889,252782,107
6407641b305a576376e6f6b4,CMT - Capacidade Máxima de Tração,NOVEMBRO,2022,RJ,Lei 9503/97 Lei 10233/01 Res. CONTRAN nº 882/21 e alterações Portaria SENATRAN 354/22 e 268/22 e alterações ,Transitar com o veículo excedendo a CMT acima de 1000 kg,11,11,202211,311329,311318,11
6407641b305a576376e6f6b6,CMT - Capacidade Máxima de Tração,NOVEMBRO,2022,RS,Lei 9503/97 Lei 10233/01 Res. CONTRAN nº 882/21 e alterações Portaria SENATRAN 354/22 e 268/22 e alterações ,Transitar com o veículo excedendo a CMT entre 601 e 1000 kg,1,11,202211,247132,247131,1
6407641b305a576376e6f6c1,Excesso de Peso,NOVEMBRO,2022,GO,Lei 9503/97 Lei 10233/01 Res. CONTRAN nº 882/21 e alterações Portaria SENATRAN 354/22 e 268/22 e alterações ,Transitar com o veículo com excesso de peso - PBT/PBTC,113,11,202211,369319,369206,113
6407641b305a576376e6f6bf,Excesso de Peso,NOVEMBRO,2022,ES,Lei 9503/97 Lei 10233/01 Res. CONTRAN nº 882/21 e alterações Portaria SENATRAN 354/22 e 268/22 e alterações ,Transitar com o veículo com excesso de peso - Por Eixo,590,11,202211,369134,368544,590
6407641b305a576376e6f6cc,Excesso de Peso,NOVEMBRO,2022,RJ,Lei 9503/97 Lei 10233/01 Res. CONTRAN nº 882/21 e alterações Portaria SENATRAN 354/22 e 268/22 e alterações ,Transitar com o veículo com excesso de peso - PBT/PBTC e Por Eixo,421,11,202211,254000,253579,421
6407641b305a576376e6f6c0,Excesso de Peso,NOVEMBRO,2022,GO,Lei 9503/97 Lei 10233/01 Res. CONTRAN nº 882/21 e alterações Portaria SENATRAN 354/22 e 268/22 e alterações ,Transitar com o veículo com excesso de peso - PBT/PBTC e Por Eixo,72,11,202211,369206,369134,72
6407641b305a576376e6f6b5,CMT - Capacidade Máxima de Tração,NOVEMBRO,2022,RJ,Lei 9503/97 Lei 10233/01 Res. CONTRAN nº 882/21 e alterações Portaria SENATRAN 354/22 e 268/22 e alterações ,Transitar com o veículo excedendo a CMT em até 600 kg,22,11,202211,368544,368522,22
6407641b305a576376e6f6d0,Excesso de Peso,NOVEMBRO,2022,RS,Lei 9503/97 Lei 10233/01 Res. CONTRAN nº 882/21 e alterações Portaria SENATRAN 354/22 e 268/22 e alterações ,Transitar com o veículo com excesso de peso - PBT/PBTC e Por Eixo,565,11,202211,254565,254000,565
6407641b305a576376e6f6d1,Excesso de Peso,NOVEMBRO,2022,RS,Lei 9503/97 Lei 10233/01 Res. CONTRAN nº 882/21 e alterações Portaria SENATRAN 354/22 e 268/22 e alterações ,Transitar com o veículo com excesso de peso - Por Eixo,1295,11,202211,255860,254565,1295
6407641b305a576376e6f6d3,Excesso de Peso,NOVEMBRO,2022,SC,Lei 9503/97 Lei 10233/01 Res. CONTRAN nº 882/21 e alterações Portaria SENATRAN 354/22 e 268/22 e alterações ,Transitar com o veículo com excesso de peso - PBT/PBTC e Por Eixo,99,11,202211,255959,255860,99
6407641b305a576376e6f6ad,CMT - Capacidade Máxima de Tração,NOVEMBRO,2022,GO,Lei 9503/97 Lei 10233/01 Res. CONTRAN nº 882/21 e alterações Portaria SENATRAN 354/22 e 268/22 e alterações ,Transitar com o veículo excedendo a CMT em até 600 kg,6,11,202211,247122,247116,6
6407641b305a576376e6f6b7,CMT - Capacidade Máxima de Tração,NOVEMBRO,2022,RS,Lei 9503/97 Lei 10233/01 Res. CONTRAN nº 882/21 e alterações Portaria SENATRAN 354/22 e 268/22 e alterações ,Transitar com o veículo excedendo a CMT acima de 1000 kg,3,11,202211,311332,311329,3
6407641b305a576376e6f6c8,Excesso de Peso,NOVEMBRO,2022,MT,Lei 9503/97 Lei 10233/01 Res. CONTRAN nº 882/21 e alterações Portaria SENATRAN 354/22 e 268/22 e alterações ,Transitar com o veículo com excesso de peso - Por Eixo,690,11,202211,253579,252889,690
6407641b305a576376e6f6b8,CMT - Capacidade Máxima de Tração,NOVEMBRO,2022,SC,Lei 9503/97 Lei 10233/01 Res. CONTRAN nº 882/21 e alterações Portaria SENATRAN 354/22 e 268/22 e alterações ,Transitar com o veículo excedendo a CMT entre 601 e 1000 kg,1,11,202211,311333,311332,1
6407641b305a576376e6f6c5,Excesso de Peso,NOVEMBRO,2022,MG,Lei 9503/97 Lei 10233/01 Res. CONTRAN nº 882/21 e alterações Portaria SENATRAN 354/22 e 268/22 e alterações ,Transitar com o veículo com excesso de peso - Por Eixo,952,11,202211,370570,369618,952
6407641b305a576376e6f6be,Excesso de Peso,NOVEMBRO,2022,ES,Lei 9503/97 Lei 10233/01 Res. CONTRAN nº 882/21 e alterações Portaria SENATRAN 354/22 e 268/22 e alterações ,Transitar com o veículo com excesso de peso - PBT/PBTC e Por Eixo,210,11,202211,311701,311491,210
6407641b305a576376e6f6d7,Excesso de Peso,NOVEMBRO,2022,SP,Lei 9503/97 Lei 10233/01 Res. CONTRAN nº 882/21 e alterações Portaria SENATRAN 354/22 e 268/22 e alterações ,Transitar com o veículo com excesso de peso - Por Eixo,190,11,202211,332836,332646,190
6407641b305a576376e6f6ca,Excesso de Peso,NOVEMBRO,2022,PR,Lei 9503/97 Lei 10233/01 Res. CONTRAN nº 882/21 e alterações Portaria SENATRAN 354/22 e 268/22 e alterações ,Transitar com o veículo com excesso de peso - Por Eixo,374,11,202211,332646,332272,374
6407641b305a576376e6f6c4,Excesso de Peso,NOVEMBRO,2022,MG,Lei 9503/97 Lei 10233/01 Res. CONTRAN nº 882/21 e alterações Portaria SENATRAN 354/22 e 268/22 e alterações ,Transitar com o veículo com excesso de peso - PBT/PBTC e Por Eixo,401,11,202211,332272,331871,401
6407641b305a576376e6f6bd,Excesso de Peso,NOVEMBRO,2022,ES,Lei 9503/97 Lei 10233/01 Res. CONTRAN nº 882/21 e alterações Portaria SENATRAN 354/22 e 268/22 e alterações ,Transitar com o veículo com excesso de peso - PBT/PBTC,207,11,202211,331871,331664,207
6407641b305a576376e6f6b2,CMT - Capacidade Máxima de Tração,NOVEMBRO,2022,MT,Lei 9503/97 Lei 10233/01 Res. CONTRAN nº 882/21 e alterações Portaria SENATRAN 354/22 e 268/22 e alterações ,Transitar com o veículo excedendo a CMT em até 600 kg,1,11,202211,331664,331663,1
6407641b305a576376e6f6b0,CMT - Capacidade Máxima de Tração,NOVEMBRO,2022,MG,Lei 9503/97 Lei 10233/01 Res. CONTRAN nº 882/21 e alterações Portaria SENATRAN 354/22 e 268/22 e alterações ,Transitar com o veículo excedendo a CMT entre 601 e 1000 kg,2,11,202211,331663,331661,2
6407641b305a576376e6f6b9,Evasão de Balança,NOVEMBRO,2022,MG,"Lei 9503 DE 23/09/1997 Transpor, sem autorização, bloqueio viário com ou sem sinalização ou dispositivos auxiliares, deixar de adentrar às áreas destinadas à pesagem de veículos ou evadir-se para não efetuar o pagamento do pedágio.",Art. 209 Deixar de adentrar as áreas destinadas à pesagem de veículos,158,11,202211,311491,311333,158
6407641b305a576376e6f6ac,CMT - Capacidade Máxima de Tração,NOVEMBRO,2022,ES,Lei 9503/97 Lei 10233/01 Res. CONTRAN nº 882/21 e alterações Portaria SENATRAN 354/22 e 268/22 e alterações ,Transitar com o veículo excedendo a CMT entre 601 e 1000 kg,4,11,202211,331654,331650,4
6407641b305a576376e6f6d4,Excesso de Peso,NOVEMBRO,2022,SC,Lei 9503/97 Lei 10233/01 Res. CONTRAN nº 882/21 e alterações Portaria SENATRAN 354/22 e 268/22 e alterações ,Transitar com o veículo com excesso de peso - Por Eixo,204,11,202211,373658,373454,204
6407641b305a576376e6f6d2,Excesso de Peso,NOVEMBRO,2022,SC,Lei 9503/97 Lei 10233/01 Res. CONTRAN nº 882/21 e alterações Portaria SENATRAN 354/22 e 268/22 e alterações ,Transitar com o veículo com excesso de peso - PBT/PBTC,88,11,202211,373454,373366,88
6407641b305a576376e6f6ae,CMT - Capacidade Máxima de Tração,NOVEMBRO,2022,GO,Lei 9503/97 Lei 10233/01 Res. CONTRAN nº 882/21 e alterações Portaria SENATRAN 354/22 e 268/22 e alterações ,Transitar com o veículo excedendo a CMT acima de 1000 kg,7,11,202211,331661,331654,7
6407641b305a576376e6f6ce,Excesso de Peso,NOVEMBRO,2022,RJ,Lei 9503/97 Lei 10233/01 Res. CONTRAN nº 882/21 e alterações Portaria SENATRAN 354/22 e 268/22 e alterações ,Transitar com o veículo com excesso de peso - Por Eixo,855,11,202211,372841,371986,855
6407641b305a576376e6f6c3,Excesso de Peso,NOVEMBRO,2022,MG,Lei 9503/97 Lei 10233/01 Res. CONTRAN nº 882/21 e alterações Portaria SENATRAN 354/22 e 268/22 e alterações ,Transitar com o veículo com excesso de peso - PBT/PBTC,347,11,202211,312048,311701,347
6407641b305a576376e6f6cf,Excesso de Peso,NOVEMBRO,2022,RS,Lei 9503/97 Lei 10233/01 Res. CONTRAN nº 882/21 e alterações Portaria SENATRAN 354/22 e 268/22 e alterações ,Transitar com o veículo com excesso de peso - PBT/PBTC,525,11,202211,373366,372841,525
6407641b305a576376e6f6d6,Excesso de Peso,NOVEMBRO,2022,SP,Lei 9503/97 Lei 10233/01 Res. CONTRAN nº 882/21 e alterações Portaria SENATRAN 354/22 e 268/22 e alterações ,Transitar com o veículo com excesso de peso - PBT/PBTC,111,11,202211,312260,312149,111
6407641b305a576376e6f6c2,Excesso de Peso,NOVEMBRO,2022,GO,Lei 9503/97 Lei 10233/01 Res. CONTRAN nº 882/21 e alterações Portaria SENATRAN 354/22 e 268/22 e alterações ,Transitar com o veículo com excesso de peso - Por Eixo,299,11,202211,369618,369319,299
6407641b305a576376e6f6b1,CMT - Capacidade Máxima de Tração,NOVEMBRO,2022,MG,Lei 9503/97 Lei 10233/01 Res. CONTRAN nº 882/21 e alterações Portaria SENATRAN 354/22 e 268/22 e alterações ,Transitar com o veículo excedendo a CMT acima de 1000 kg,8,11,202211,247131,247123,8
6407641b305a576376e6f6d5,Excesso de Peso,NOVEMBRO,2022,SP,Lei 9503/97 Lei 10233/01 Res. CONTRAN nº 882/21 e alterações Portaria SENATRAN 354/22 e 268/22 e alterações ,Transitar com o veículo com excesso de peso - PBT/PBTC e Por Eixo,101,11,202211,312149,312048,101
6407641b305a576376e6f6c9,Excesso de Peso,NOVEMBRO,2022,PR,Lei 9503/97 Lei 10233/01 Res. CONTRAN nº 882/21 e alterações Portaria SENATRAN 354/22 e 268/22 e alterações ,Transitar com o veículo com excesso de peso - PBT/PBTC e Por Eixo,282,11,202211,370976,370694,282
6407641b305a576376e6f6cb,Excesso de Peso,NOVEMBRO,2022,PR,Lei 9503/97 Lei 10233/01 Res. CONTRAN nº 882/21 e alterações Portaria SENATRAN 354/22 e 268/22 e alterações ,Transitar com o veículo com excesso de peso - PBT/PBTC,380,11,202211,371356,370976,380
6407641b305a576376e6f6cd,Excesso de Peso,NOVEMBRO,2022,RJ,Lei 9503/97 Lei 10233/01 Res. CONTRAN nº 882/21 e alterações Portaria SENATRAN 354/22 e 268/22 e alterações ,Transitar com o veículo com excesso de peso - PBT/PBTC,630,11,202211,371986,371356,630
6407641b305a576376e6f6c7,Excesso de Peso,NOVEMBRO,2022,MT,Lei 9503/97 Lei 10233/01 Res. CONTRAN nº 882/21 e alterações Portaria SENATRAN 354/22 e 268/22 e alterações ,Transitar com o veículo com excesso de peso - PBT/PBTC e Por Eixo,124,11,202211,370694,370570,124
6407641b305a576376e6f6af,CMT - Capacidade Máxima de Tração,NOVEMBRO,2022,MG,Lei 9503/97 Lei 10233/01 Res. CONTRAN nº 882/21 e alterações Portaria SENATRAN 354/22 e 268/22 e alterações ,Transitar com o veículo excedendo a CMT em até 600 kg,1,11,202211,247123,247122,1
6407641b305a576376e6f6e2,CMT - Capacidade Máxima de Tração,DEZEMBRO,2022,RJ,Lei 9503/97 Lei 10233/01 Res. CONTRAN nº 882/21 e alterações Portaria SENATRAN 354/22 e 268/22 e alterações ,Transitar com o veículo excedendo a CMT em até 600 kg,6,12,202212,373667,373661,6
6407641b305a576376e6f6e3,CMT - Capacidade Máxima de Tração,DEZEMBRO,2022,RJ,Lei 9503/97 Lei 10233/01 Res. CONTRAN nº 882/21 e alterações Portaria SENATRAN 354/22 e 268/22 e alterações ,Transitar com o veículo excedendo a CMT acima de 1000 kg,7,12,202212,373674,373667,7
6407641b305a576376e6f6de,CMT - Capacidade Máxima de Tração,DEZEMBRO,2022,MG,Lei 9503/97 Lei 10233/01 Res. CONTRAN nº 882/21 e alterações Portaria SENATRAN 354/22 e 268/22 e alterações ,Transitar com o veículo excedendo a CMT em até 600 kg,3,12,202212,373661,373658,3
6407641b305a576376e6f6e6,Evasão de Balança,DEZEMBRO,2022,GO,"Lei 9503 DE 23/09/1997 Transpor, sem autorização, bloqueio viário com ou sem sinalização ou dispositivos auxiliares, deixar de adentrar às áreas destinadas à pesagem de veículos ou evadir-se para não efetuar o pagamento do pedágio.",Art. 209 Deixar de adentrar as áreas destinadas à pesagem de veículos,429,12,202212,374103,373674,429
6407641b305a576376e6f6ed,Excesso de Peso,DEZEMBRO,2022,ES,Lei 9503/97 Lei 10233/01 Res. CONTRAN nº 882/21 e alterações Portaria SENATRAN 354/22 e 268/22 e alterações ,Transitar com o veículo com excesso de peso - Por Eixo,442,12,202212,374545,374103,442
6407641b305a576376e6f6ee,Excesso de Peso,DEZEMBRO,2022,GO,Lei 9503/97 Lei 10233/01 Res. CONTRAN nº 882/21 e alterações Portaria SENATRAN 354/22 e 268/22 e alterações ,Transitar com o veículo com excesso de peso - PBT/PBTC e Por Eixo,59,12,202212,374604,374545,59
6407641b305a576376e6f6f0,Excesso de Peso,DEZEMBRO,2022,GO,Lei 9503/97 Lei 10233/01 Res. CONTRAN nº 882/21 e alterações Portaria SENATRAN 354/22 e 268/22 e alterações ,Transitar com o veículo com excesso de peso - Por Eixo,175,12,202212,374779,374604,175
6407641b305a576376e6f6f4,Excesso de Peso,DEZEMBRO,2022,MT,Lei 9503/97 Lei 10233/01 Res. CONTRAN nº 882/21 e alterações Portaria SENATRAN 354/22 e 268/22 e alterações ,Transitar com o veículo com excesso de peso - PBT/PBTC,54,12,202212,374833,374779,54
6407641b305a576376e6f6f9,Excesso de Peso,DEZEMBRO,2022,PR,Lei 9503/97 Lei 10233/01 Res. CONTRAN nº 882/21 e alterações Portaria SENATRAN 354/22 e 268/22 e alterações ,Transitar com o veículo com excesso de peso - Por Eixo,360,12,202212,375193,374833,360
6407641b305a576376e6f6ff,Excesso de Peso,DEZEMBRO,2022,RS,Lei 9503/97 Lei 10233/01 Res. CONTRAN nº 882/21 e alterações Portaria SENATRAN 354/22 e 268/22 e alterações ,Transitar com o veículo com excesso de peso - Por Eixo,1044,12,202212,376237,375193,1044
6407641b305a576376e6f700,Excesso de Peso,DEZEMBRO,2022,SC,Lei 9503/97 Lei 10233/01 Res. CONTRAN nº 882/21 e alterações Portaria SENATRAN 354/22 e 268/22 e alterações ,Transitar com o veículo com excesso de peso - PBT/PBTC,86,12,202212,376323,376237,86
6407641b305a576376e6f705,Excesso de Peso,DEZEMBRO,2022,SP,Lei 9503/97 Lei 10233/01 Res. CONTRAN nº 882/21 e alterações Portaria SENATRAN 354/22 e 268/22 e alterações ,Transitar com o veículo com excesso de peso - Por Eixo,34,12,202212,335066,335032,34
6407641b305a576376e6f6dc,CMT - Capacidade Máxima de Tração,DEZEMBRO,2022,GO,Lei 9503/97 Lei 10233/01 Res. CONTRAN nº 882/21 e alterações Portaria SENATRAN 354/22 e 268/22 e alterações ,Transitar com o veículo excedendo a CMT em até 600 kg,9,12,202212,255971,255962,9
6407641b305a576376e6f6fb,Excesso de Peso,DEZEMBRO,2022,RJ,Lei 9503/97 Lei 10233/01 Res. CONTRAN nº 882/21 e alterações Portaria SENATRAN 354/22 e 268/22 e alterações ,Transitar com o veículo com excesso de peso - PBT/PBTC,361,12,202212,334579,334218,361
6407641b305a576376e6f6f6,Excesso de Peso,DEZEMBRO,2022,MT,Lei 9503/97 Lei 10233/01 Res. CONTRAN nº 882/21 e alterações Portaria SENATRAN 354/22 e 268/22 e alterações ,Transitar com o veículo com excesso de peso - Por Eixo,481,12,202212,334218,333737,481
6407641b305a576376e6f6f3,Excesso de Peso,DEZEMBRO,2022,MG,Lei 9503/97 Lei 10233/01 Res. CONTRAN nº 882/21 e alterações Portaria SENATRAN 354/22 e 268/22 e alterações ,Transitar com o veículo com excesso de peso - Por Eixo,731,12,202212,333737,333006,731
6407641b305a576376e6f6ec,Excesso de Peso,DEZEMBRO,2022,ES,Lei 9503/97 Lei 10233/01 Res. CONTRAN nº 882/21 e alterações Portaria SENATRAN 354/22 e 268/22 e alterações ,Transitar com o veículo com excesso de peso - PBT/PBTC e Por Eixo,162,12,202212,333006,332844,162
6407641b305a576376e6f6e5,CMT - Capacidade Máxima de Tração,DEZEMBRO,2022,SC,Lei 9503/97 Lei 10233/01 Res. CONTRAN nº 882/21 e alterações Portaria SENATRAN 354/22 e 268/22 e alterações ,Transitar com o veículo excedendo a CMT acima de 1000 kg,1,12,202212,332844,332843,1
6407641b305a576376e6f6e0,CMT - Capacidade Máxima de Tração,DEZEMBRO,2022,PR,Lei 9503/97 Lei 10233/01 Res. CONTRAN nº 882/21 e alterações Portaria SENATRAN 354/22 e 268/22 e alterações ,Transitar com o veículo excedendo a CMT em até 600 kg,1,12,202212,332843,332842,1
6407641b305a576376e6f6db,CMT - Capacidade Máxima de Tração,DEZEMBRO,2022,GO,Lei 9503/97 Lei 10233/01 Res. CONTRAN nº 882/21 e alterações Portaria SENATRAN 354/22 e 268/22 e alterações ,Transitar com o veículo excedendo a CMT acima de 1000 kg,4,12,202212,332842,332838,4
6407641b305a576376e6f6da,CMT - Capacidade Máxima de Tração,DEZEMBRO,2022,GO,Lei 9503/97 Lei 10233/01 Res. CONTRAN nº 882/21 e alterações Portaria SENATRAN 354/22 e 268/22 e alterações ,Transitar com o veículo excedendo a CMT entre 601 e 1000 kg,2,12,202212,332838,332836,2
6407641b305a576376e6f701,Excesso de Peso,DEZEMBRO,2022,SC,Lei 9503/97 Lei 10233/01 Res. CONTRAN nº 882/21 e alterações Portaria SENATRAN 354/22 e 268/22 e alterações ,Transitar com o veículo com excesso de peso - PBT/PBTC e Por Eixo,174,12,202212,376497,376323,174
6407641b305a576376e6f703,Excesso de Peso,DEZEMBRO,2022,SP,Lei 9503/97 Lei 10233/01 Res. CONTRAN nº 882/21 e alterações Portaria SENATRAN 354/22 e 268/22 e alterações ,Transitar com o veículo com excesso de peso - PBT/PBTC,4,12,202212,314171,314167,4
6407641b305a576376e6f702,Excesso de Peso,DEZEMBRO,2022,SC,Lei 9503/97 Lei 10233/01 Res. CONTRAN nº 882/21 e alterações Portaria SENATRAN 354/22 e 268/22 e alterações ,Transitar com o veículo com excesso de peso - Por Eixo,246,12,202212,314167,313921,246
6407641b305a576376e6f6fc,Excesso de Peso,DEZEMBRO,2022,RJ,Lei 9503/97 Lei 10233/01 Res. CONTRAN nº 882/21 e alterações Portaria SENATRAN 354/22 e 268/22 e alterações ,Transitar com o veículo com excesso de peso - Por Eixo,528,12,202212,313921,313393,528
6407641b305a576376e6f6fa,Excesso de Peso,DEZEMBRO,2022,RJ,Lei 9503/97 Lei 10233/01 Res. CONTRAN nº 882/21 e alterações Portaria SENATRAN 354/22 e 268/22 e alterações ,Transitar com o veículo com excesso de peso - PBT/PBTC e Por Eixo,227,12,202212,313393,313166,227
6407641b305a576376e6f6f5,Excesso de Peso,DEZEMBRO,2022,MT,Lei 9503/97 Lei 10233/01 Res. CONTRAN nº 882/21 e alterações Portaria SENATRAN 354/22 e 268/22 e alterações ,Transitar com o veículo com excesso de peso - PBT/PBTC e Por Eixo,90,12,202212,313166,313076,90
6407641b305a576376e6f6f2,Excesso de Peso,DEZEMBRO,2022,MG,Lei 9503/97 Lei 10233/01 Res. CONTRAN nº 882/21 e alterações Portaria SENATRAN 354/22 e 268/22 e alterações ,Transitar com o veículo com excesso de peso - PBT/PBTC,344,12,202212,313076,312732,344
6407641b305a576376e6f6f1,Excesso de Peso,DEZEMBRO,2022,MG,Lei 9503/97 Lei 10233/01 Res. CONTRAN nº 882/21 e alterações Portaria SENATRAN 354/22 e 268/22 e alterações ,Transitar com o veículo com excesso de peso - PBT/PBTC e Por Eixo,315,12,202212,312732,312417,315
6407641b305a576376e6f6ea,Evasão de Balança,DEZEMBRO,2022,SP,"Lei 9503 DE 23/09/1997 Transpor, sem autorização, bloqueio viário com ou sem sinalização ou dispositivos auxiliares, deixar de adentrar às áreas destinadas à pesagem de veículos ou evadir-se para não efetuar o pagamento do pedágio.",Art. 209 Deixar de adentrar as áreas destinadas à pesagem de veículos,84,12,202212,312417,312333,84
6407641b305a576376e6f6dd,CMT - Capacidade Máxima de Tração,DEZEMBRO,2022,MG,Lei 9503/97 Lei 10233/01 Res. CONTRAN nº 882/21 e alterações Portaria SENATRAN 354/22 e 268/22 e alterações ,Transitar com o veículo excedendo a CMT entre 601 e 1000 kg,3,12,202212,255974,255971,3
6407641b305a576376e6f6e4,CMT - Capacidade Máxima de Tração,DEZEMBRO,2022,RS,Lei 9503/97 Lei 10233/01 Res. CONTRAN nº 882/21 e alterações Portaria SENATRAN 354/22 e 268/22 e alterações ,Transitar com o veículo excedendo a CMT acima de 1000 kg,3,12,202212,255977,255974,3
6407641b305a576376e6f6e8,Evasão de Balança,DEZEMBRO,2022,MT,"Lei 9503 DE 23/09/1997 Transpor, sem autorização, bloqueio viário com ou sem sinalização ou dispositivos auxiliares, deixar de adentrar às áreas destinadas à pesagem de veículos ou evadir-se para não efetuar o pagamento do pedágio.",Art. 209 Deixar de adentrar as áreas destinadas à pesagem de veículos,238,12,202212,256215,255977,238
6407641b305a576376e6f6e9,Evasão de Balança,DEZEMBRO,2022,RJ,"Lei 9503 DE 23/09/1997 Transpor, sem autorização, bloqueio viário com ou sem sinalização ou dispositivos auxiliares, deixar de adentrar às áreas destinadas à pesagem de veículos ou evadir-se para não efetuar o pagamento do pedágio.",Art. 209 Deixar de adentrar as áreas destinadas à pesagem de veículos,1789,12,202212,258004,256215,1789
6407641b305a576376e6f6eb,Excesso de Peso,DEZEMBRO,2022,ES,Lei 9503/97 Lei 10233/01 Res. CONTRAN nº 882/21 e alterações Portaria SENATRAN 354/22 e 268/22 e alterações ,Transitar com o veículo com excesso de peso - PBT/PBTC,153,12,202212,258157,258004,153
6407641b305a576376e6f6ef,Excesso de Peso,DEZEMBRO,2022,GO,Lei 9503/97 Lei 10233/01 Res. CONTRAN nº 882/21 e alterações Portaria SENATRAN 354/22 e 268/22 e alterações ,Transitar com o veículo com excesso de peso - PBT/PBTC,86,12,202212,258243,258157,86
6407641b305a576376e6f6d8,CMT - Capacidade Máxima de Tração,DEZEMBRO,2022,ES,Lei 9503/97 Lei 10233/01 Res. CONTRAN nº 882/21 e alterações Portaria SENATRAN 354/22 e 268/22 e alterações ,Transitar com o veículo excedendo a CMT em até 600 kg,3,12,202212,255962,255959,3
6407641b305a576376e6f6f7,Excesso de Peso,DEZEMBRO,2022,PR,Lei 9503/97 Lei 10233/01 Res. CONTRAN nº 882/21 e alterações Portaria SENATRAN 354/22 e 268/22 e alterações ,Transitar com o veículo com excesso de peso - PBT/PBTC e Por Eixo,224,12,202212,258467,258243,224
6407641b305a576376e6f6fe,Excesso de Peso,DEZEMBRO,2022,RS,Lei 9503/97 Lei 10233/01 Res. CONTRAN nº 882/21 e alterações Portaria SENATRAN 354/22 e 268/22 e alterações ,Transitar com o veículo com excesso de peso - PBT/PBTC,471,12,202212,259187,258716,471
6407641b305a576376e6f6fd,Excesso de Peso,DEZEMBRO,2022,RS,Lei 9503/97 Lei 10233/01 Res. CONTRAN nº 882/21 e alterações Portaria SENATRAN 354/22 e 268/22 e alterações ,Transitar com o veículo com excesso de peso - PBT/PBTC e Por Eixo,453,12,202212,335032,334579,453
6407641b305a576376e6f6d9,CMT - Capacidade Máxima de Tração,DEZEMBRO,2022,ES,Lei 9503/97 Lei 10233/01 Res. CONTRAN nº 882/21 e alterações Portaria SENATRAN 354/22 e 268/22 e alterações ,Transitar com o veículo excedendo a CMT acima de 1000 kg,5,12,202212,312265,312260,5
6407641b305a576376e6f6df,CMT - Capacidade Máxima de Tração,DEZEMBRO,2022,MG,Lei 9503/97 Lei 10233/01 Res. CONTRAN nº 882/21 e alterações Portaria SENATRAN 354/22 e 268/22 e alterações ,Transitar com o veículo excedendo a CMT acima de 1000 kg,5,12,202212,312270,312265,5
6407641b305a576376e6f6e1,CMT - Capacidade Máxima de Tração,DEZEMBRO,2022,RJ,Lei 9503/97 Lei 10233/01 Res. CONTRAN nº 882/21 e alterações Portaria SENATRAN 354/22 e 268/22 e alterações ,Transitar com o veículo excedendo a CMT entre 601 e 1000 kg,2,12,202212,312272,312270,2
6407641b305a576376e6f6e7,Evasão de Balança,DEZEMBRO,2022,MG,"Lei 9503 DE 23/09/1997 Transpor, sem autorização, bloqueio viário com ou sem sinalização ou dispositivos auxiliares, deixar de adentrar às áreas destinadas à pesagem de veículos ou evadir-se para não efetuar o pagamento do pedágio.",Art. 209 Deixar de adentrar as áreas destinadas à pesagem de veículos,61,12,202212,312333,312272,61
6407641b305a576376e6f6f8,Excesso de Peso,DEZEMBRO,2022,PR,Lei 9503/97 Lei 10233/01 Res. CONTRAN nº 882/21 e alterações Portaria SENATRAN 354/22 e 268/22 e alterações ,Transitar com o veículo com excesso de peso - PBT/PBTC,249,12,202212,258716,258467,249
6407641b305a576376e6f704,Excesso de Peso,DEZEMBRO,2022,SP,Lei 9503/97 Lei 10233/01 Res. CONTRAN nº 882/21 e alterações Portaria SENATRAN 354/22 e 268/22 e alterações ,Transitar com o veículo com excesso de peso - PBT/PBTC e Por Eixo,18,12,202212,376515,376497,18
