date,city_ibge_code,epidemiological_week,cumulative_confirmed,previous_period,diff_by_period
2020-03-08,2704302,202011,1,0,1
2020-03-09,2704302,202011,1,1,0
2020-03-10,2704302,202011,1,1,0
2020-03-11,2704302,202011,1,1,0
2020-03-12,2704302,202011,1,1,0
2020-03-13,2704302,202011,1,1,0
2020-03-14,2704302,202011,1,1,0
2020-03-15,2704302,202012,1,1,0
2020-03-16,2704302,202012,1,1,0
2020-03-17,2704302,202012,1,1,0
2020-03-17,1200401,202012,4,1,3
2020-03-18,1200401,202012,4,4,0
2020-03-18,2704302,202012,4,4,0
2020-03-19,2704302,202012,7,4,3
2020-03-19,1200401,202012,8,7,1
2020-03-20,2704302,202012,10,8,2
2020-03-20,1200401,202012,13,10,3
2020-03-21,2704302,202012,14,13,1
2020-03-21,1200401,202012,18,14,4
2020-03-22,2704302,202013,18,18,0
2020-03-22,1200401,202013,18,18,0
2020-03-23,2704302,202013,19,18,1
2020-03-23,1200401,202013,25,19,6
2020-03-24,1200401,202013,29,25,4
2020-03-24,2704302,202013,31,29,2
2020-03-25,1200401,202013,33,31,2
2020-03-25,2707503,202013,34,33,1
2020-03-25,2704302,202013,34,34,0
2020-03-26,1200401,202013,34,34,0
2020-03-26,2707503,202013,34,34,0
2020-03-26,2704302,202013,34,34,0
2020-03-27,1200401,202013,36,34,2
2020-03-27,2707503,202013,36,36,0
2020-03-27,2704302,202013,37,36,1
2020-03-28,2707503,202013,37,37,0
2020-03-28,2704302,202013,39,37,2
2020-03-28,1200401,202013,39,39,0
2020-03-29,2704302,202014,38,39,-1
2020-03-29,1200401,202014,44,38,6
2020-03-29,1200807,202014,45,44,1
2020-03-29,1200013,202014,47,45,2
2020-03-29,2707503,202014,47,47,0
2020-03-30,2704302,202014,47,47,0
2020-03-30,2707503,202014,47,47,0
2020-03-30,1200401,202014,50,47,3
2020-03-30,1200807,202014,50,50,0
2020-03-30,1200013,202014,54,50,4
2020-03-31,2704302,202014,55,54,1
2020-03-31,2707503,202014,55,55,0
2020-03-31,1200401,202014,55,55,0
2020-03-31,1200807,202014,55,55,0
2020-03-31,1200013,202014,56,55,1
2020-04-01,2704302,202014,56,56,0
2020-04-01,2707503,202014,56,56,0
2020-04-01,1200401,202014,56,56,0
2020-04-01,1200807,202014,56,56,0
2020-04-01,1200013,202014,57,56,1
2020-04-02,1200807,202014,57,57,0
2020-04-02,1200401,202014,59,57,2
2020-04-02,1200013,202014,59,59,0
2020-04-03,1200013,202014,60,59,1
2020-04-03,1200807,202014,60,60,0
2020-04-03,1200401,202014,60,60,0
2020-04-04,1200013,202014,60,60,0
2020-04-04,1200807,202014,60,60,0
2020-04-04,1200401,202014,60,60,0
2020-04-05,1200013,202015,60,60,0
2020-04-05,1200807,202015,60,60,0
2020-04-05,1200401,202015,62,60,2
2020-04-06,1200013,202015,62,62,0
2020-04-06,1200401,202015,63,62,1
2020-04-06,1200807,202015,63,63,0
2020-04-06,1200385,202015,64,63,1
2020-04-07,1200013,202015,64,64,0
2020-04-07,1200385,202015,64,64,0
2020-04-07,1200807,202015,64,64,0
2020-04-07,1200401,202015,64,64,0
2020-04-08,1200013,202015,64,64,0
2020-04-08,1200138,202015,65,64,1
2020-04-08,1200385,202015,66,65,1
2020-04-08,1200807,202015,66,66,0
2020-04-08,1200401,202015,72,66,6
2020-04-09,1200807,202015,72,72,0
2020-04-09,1200385,202015,73,72,1
2020-04-09,1200013,202015,73,73,0
2020-04-09,1200401,202015,76,73,3
2020-04-09,1200138,202015,76,76,0
2020-04-10,1200013,202015,76,76,0
2020-04-10,1200385,202015,77,76,1
2020-04-10,1200807,202015,77,77,0
2020-04-10,1200401,202015,84,77,7
2020-04-10,1200138,202015,84,84,0
2020-04-11,1200138,202015,84,84,0
2020-04-11,1200807,202015,84,84,0
2020-04-11,1200401,202015,86,84,2
2020-04-11,1200013,202015,86,86,0
2020-04-11,1200385,202015,86,86,0
2020-04-12,1200013,202016,87,86,1
2020-04-12,1200138,202016,87,87,0
2020-04-12,1200385,202016,88,87,1
2020-04-12,1200807,202016,88,88,0
2020-04-12,1200401,202016,91,88,3
2020-04-13,1200138,202016,91,91,0
2020-04-13,1200013,202016,92,91,1
2020-04-13,1200385,202016,94,92,2
2020-04-13,1200401,202016,102,94,8
2020-04-13,1200203,202016,104,102,2
2020-04-13,1200807,202016,104,104,0
2020-04-14,1200013,202016,104,104,0
2020-04-14,1200138,202016,104,104,0
2020-04-14,1200203,202016,104,104,0
2020-04-14,1200385,202016,107,104,3
2020-04-14,1200807,202016,107,107,0
2020-04-14,1200401,202016,113,107,6
2020-04-15,1200807,202016,113,113,0
2020-04-15,1200013,202016,113,113,0
2020-04-15,1200138,202016,113,113,0
2020-04-15,1200203,202016,113,113,0
2020-04-15,1200401,202016,115,113,2
2020-04-15,1200385,202016,115,115,0
2020-04-16,1200013,202016,116,115,1
2020-04-16,1200138,202016,116,116,0
2020-04-16,1200385,202016,119,116,3
2020-04-16,1200807,202016,119,119,0
2020-04-16,1200401,202016,129,119,10
2020-04-16,1200203,202016,129,129,0
2020-04-17,1200807,202016,129,129,0
2020-04-17,1200013,202016,129,129,0
2020-04-17,1200138,202016,129,129,0
2020-04-17,1200203,202016,129,129,0
2020-04-17,1200401,202016,148,129,19
2020-04-17,1200385,202016,149,148,1
2020-04-18,1200013,202016,149,149,0
2020-04-18,1200138,202016,149,149,0
2020-04-18,1200203,202016,149,149,0
2020-04-18,1200385,202016,149,149,0
2020-04-18,1200401,202016,156,149,7
2020-04-18,1200807,202016,156,156,0
2020-04-19,1200138,202017,156,156,0
2020-04-19,1200385,202017,161,156,5
2020-04-19,1200807,202017,161,161,0
2020-04-19,1200401,202017,172,161,11
2020-04-19,1200450,202017,174,172,2
2020-04-19,1200013,202017,174,174,0
2020-04-19,1200203,202017,177,174,3
2020-04-20,1200450,202017,177,177,0
2020-04-20,1200013,202017,177,177,0
2020-04-20,1200138,202017,177,177,0
2020-04-20,1200203,202017,177,177,0
2020-04-20,1200385,202017,177,177,0
2020-04-20,1200807,202017,177,177,0
2020-04-20,1200401,202017,190,177,13
2020-04-21,1200138,202017,190,190,0
2020-04-21,1200203,202017,190,190,0
2020-04-21,1200385,202017,191,190,1
2020-04-21,1200013,202017,191,191,0
2020-04-21,1200401,202017,209,191,18
2020-04-21,1200450,202017,209,209,0
2020-04-21,1200807,202017,209,209,0
2020-04-22,1200401,202017,227,209,18
2020-04-22,1200013,202017,227,227,0
2020-04-22,1200138,202017,227,227,0
2020-04-22,1200203,202017,227,227,0
2020-04-22,1200385,202017,228,227,1
2020-04-22,1200450,202017,228,228,0
2020-04-22,1200807,202017,228,228,0
2020-04-23,1200013,202017,228,228,0
2020-04-23,1200138,202017,228,228,0
2020-04-23,1200203,202017,228,228,0
2020-04-23,1200385,202017,228,228,0
2020-04-23,1200807,202017,228,228,0
2020-04-23,1200401,202017,241,228,13
2020-04-23,1200450,202017,241,241,0
2020-04-24,1200013,202017,241,241,0
2020-04-24,1200138,202017,241,241,0
2020-04-24,1200385,202017,242,241,1
2020-04-24,1200807,202017,242,242,0
2020-04-24,1200401,202017,248,242,6
2020-04-24,1200450,202017,248,248,0
2020-04-24,1200203,202017,248,248,0
2020-04-25,1200450,202017,248,248,0
2020-04-25,1200013,202017,248,248,0
2020-04-25,1200138,202017,248,248,0
2020-04-25,1200203,202017,248,248,0
2020-04-25,1200385,202017,248,248,0
2020-04-25,1200807,202017,248,248,0
2020-04-25,1200401,202017,272,248,24
2020-04-26,1200013,202018,272,272,0
2020-04-26,1200203,202018,272,272,0
2020-04-26,1200138,202018,272,272,0
2020-04-26,1200401,202018,292,272,20
2020-04-26,1200385,202018,292,292,0
2020-04-26,1200450,202018,292,292,0
2020-04-26,1200807,202018,293,292,1
2020-04-27,1200138,202018,293,293,0
2020-04-27,1200203,202018,293,293,0
2020-04-27,1200385,202018,293,293,0
2020-04-27,1200807,202018,293,293,0
2020-04-27,1200401,202018,314,293,21
2020-04-27,1200450,202018,314,314,0
2020-04-27,1200013,202018,315,314,1
2020-04-28,1200807,202018,315,315,0
2020-04-28,1200013,202018,315,315,0
2020-04-28,1200138,202018,315,315,0
2020-04-28,1200203,202018,315,315,0
2020-04-28,1200385,202018,315,315,0
2020-04-28,1200450,202018,315,315,0
2020-04-28,1200401,202018,331,315,16
2020-04-29,1200013,202018,331,331,0
2020-04-29,1200138,202018,332,331,1
2020-04-29,1200203,202018,332,332,0
2020-04-29,1200336,202018,333,332,1
2020-04-29,1200385,202018,336,333,3
2020-04-29,1200807,202018,336,336,0
2020-04-29,1200401,202018,364,336,28
2020-04-29,1200450,202018,365,364,1
2020-04-29,1200708,202018,368,365,3
2020-04-30,1200385,202018,368,368,0
2020-04-30,1200401,202018,412,368,44
2020-04-30,1200013,202018,412,412,0
2020-04-30,1200138,202018,412,412,0
2020-04-30,1200807,202018,412,412,0
2020-04-30,1200203,202018,412,412,0
2020-04-30,1200336,202018,413,412,1
2020-04-30,1200708,202018,418,413,5
2020-04-30,1200450,202018,418,418,0
2020-05-01,1200807,202018,418,418,0
2020-05-01,1200013,202018,418,418,0
2020-05-01,1200054,202018,419,418,1
2020-05-01,1200138,202018,419,419,0
2020-05-01,1200203,202018,426,419,7
2020-05-01,1200336,202018,426,426,0
2020-05-01,1200450,202018,427,426,1
2020-05-01,1200708,202018,428,427,1
2020-05-01,1200385,202018,437,428,9
2020-05-01,1200401,202018,501,437,64
2020-05-02,1200013,202018,501,501,0
2020-05-02,1200054,202018,501,501,0
2020-05-02,1200203,202018,498,501,-3
2020-05-02,1200138,202018,498,498,0
2020-05-02,1200336,202018,499,498,1
2020-05-02,1200385,202018,499,499,0
2020-05-02,1200401,202018,565,499,66
2020-05-02,1200450,202018,565,565,0
2020-05-02,1200609,202018,566,565,1
2020-05-02,1200708,202018,566,566,0
2020-05-02,1200302,202018,567,566,1
2020-05-02,1200807,202018,567,567,0
2020-05-03,1200450,202019,569,567,2
2020-05-03,1200013,202019,571,569,2
2020-05-03,1200054,202019,571,571,0
2020-05-03,1200138,202019,571,571,0
2020-05-03,1200203,202019,571,571,0
2020-05-03,1200302,202019,571,571,0
2020-05-03,1200401,202019,664,571,93
2020-05-03,1200807,202019,664,664,0
2020-05-03,1200336,202019,664,664,0
2020-05-03,1200385,202019,671,664,7
2020-05-03,1200708,202019,671,671,0
2020-05-03,1200609,202019,672,671,1
2020-05-04,1200054,202019,672,672,0
2020-05-04,1200013,202019,672,672,0
2020-05-04,1200203,202019,674,672,2
2020-05-04,1200302,202019,674,674,0
2020-05-04,1200336,202019,673,674,-1
2020-05-04,1200385,202019,673,673,0
2020-05-04,1200807,202019,673,673,0
2020-05-04,1200401,202019,741,673,68
2020-05-04,1200500,202019,743,741,2
2020-05-04,1200450,202019,747,743,4
2020-05-04,1200609,202019,747,747,0
2020-05-04,1200708,202019,747,747,0
2020-05-04,1200138,202019,747,747,0
2020-05-05,1200054,202019,747,747,0
2020-05-05,1200138,202019,747,747,0
2020-05-05,1200203,202019,758,747,11
2020-05-05,1200302,202019,758,758,0
2020-05-05,1200336,202019,758,758,0
2020-05-05,1200385,202019,762,758,4
2020-05-05,1200807,202019,762,762,0
2020-05-05,1200401,202019,823,762,61
2020-05-05,1200500,202019,823,823,0
2020-05-05,1200450,202019,824,823,1
2020-05-05,1200609,202019,830,824,6
2020-05-05,1200708,202019,830,830,0
2020-05-05,1200013,202019,831,830,1
2020-05-06,1200336,202019,831,831,0
2020-05-06,1200203,202019,835,831,4
2020-05-06,1200054,202019,835,835,0
2020-05-06,1200013,202019,834,835,-1
2020-05-06,1200138,202019,835,834,1
2020-05-06,1200302,202019,835,835,0
2020-05-06,1200385,202019,843,835,8
2020-05-06,1200807,202019,844,843,1
2020-05-06,1200401,202019,956,844,112
2020-05-06,1200500,202019,956,956,0
2020-05-06,1200450,202019,957,956,1
2020-05-06,1200609,202019,957,957,0
2020-05-06,1200708,202019,957,957,0
2020-05-07,1200401,202019,1024,957,67
2020-05-07,1200336,202019,1025,1024,1
2020-05-07,1200500,202019,1025,1025,0
2020-05-07,1200450,202019,1024,1025,-1
2020-05-07,1200609,202019,1024,1024,0
2020-05-07,1200708,202019,1024,1024,0
2020-05-07,1200138,202019,1025,1024,1
2020-05-07,1200252,202019,1027,1025,2
2020-05-07,1200203,202019,1027,1027,0
2020-05-07,1200807,202019,1027,1027,0
2020-05-07,1200054,202019,1027,1027,0
2020-05-07,1200013,202019,1027,1027,0
2020-05-07,1200302,202019,1027,1027,0
2020-05-07,1200385,202019,1028,1027,1
2020-05-08,1200500,202019,1028,1028,0
2020-05-08,1200013,202019,1030,1028,2
2020-05-08,1200054,202019,1030,1030,0
2020-05-08,1200138,202019,1030,1030,0
2020-05-08,1200179,202019,1031,1030,1
2020-05-08,1200203,202019,1052,1031,21
2020-05-08,1200252,202019,1052,1052,0
2020-05-08,1200302,202019,1052,1052,0
2020-05-08,1200336,202019,1052,1052,0
2020-05-08,1200385,202019,1060,1052,8
2020-05-08,1200807,202019,1065,1060,5
2020-05-08,1200708,202019,1066,1065,1
2020-05-08,1200609,202019,1067,1066,1
2020-05-08,1200401,202019,1186,1067,119
2020-05-08,1200435,202019,1187,1186,1
2020-05-08,1200450,202019,1191,1187,4
2020-05-09,1200609,202019,1198,1191,7
2020-05-09,1200708,202019,1199,1198,1
2020-05-09,1200450,202019,1199,1199,0
2020-05-09,1200500,202019,1202,1199,3
2020-05-09,1200435,202019,1202,1202,0
2020-05-09,1200401,202019,1332,1202,130
2020-05-09,1200385,202019,1338,1332,6
2020-05-09,1200336,202019,1338,1338,0
2020-05-09,1200302,202019,1338,1338,0
2020-05-09,1200807,202019,1338,1338,0
2020-05-09,1200203,202019,1337,1338,-1
2020-05-09,1200179,202019,1337,1337,0
2020-05-09,1200138,202019,1337,1337,0
2020-05-09,1200104,202019,1338,1337,1
2020-05-09,1200054,202019,1338,1338,0
2020-05-09,1200013,202019,1349,1338,11
2020-05-09,1200252,202019,1349,1349,0
2020-05-10,1200336,202020,1349,1349,0
2020-05-10,1200500,202020,1349,1349,0
2020-05-10,1200435,202020,1349,1349,0
2020-05-10,1200401,202020,1417,1349,68
2020-05-10,1200807,202020,1417,1417,0
2020-05-10,1200385,202020,1417,1417,0
2020-05-10,1200302,202020,1417,1417,0
2020-05-10,1200609,202020,1417,1417,0
2020-05-10,1200203,202020,1446,1417,29
2020-05-10,1200179,202020,1446,1446,0
2020-05-10,1200138,202020,1446,1446,0
2020-05-10,1200104,202020,1446,1446,0
2020-05-10,1200054,202020,1446,1446,0
2020-05-10,1200013,202020,1448,1446,2
2020-05-10,1200450,202020,1461,1448,13
2020-05-10,1200252,202020,1461,1461,0
2020-05-10,1200708,202020,1461,1461,0
2020-05-11,1200013,202020,1461,1461,0
2020-05-11,1200708,202020,1461,1461,0
2020-05-11,1200450,202020,1462,1461,1
2020-05-11,1200500,202020,1468,1462,6
2020-05-11,1200435,202020,1468,1468,0
2020-05-11,1200401,202020,1468,1468,0
2020-05-11,1200807,202020,1468,1468,0
2020-05-11,1200385,202020,1468,1468,0
2020-05-11,1200609,202020,1468,1468,0
2020-05-11,1200336,202020,1468,1468,0
2020-05-11,1200252,202020,1468,1468,0
2020-05-11,1200203,202020,1474,1468,6
2020-05-11,1200179,202020,1474,1474,0
2020-05-11,1200138,202020,1474,1474,0
2020-05-11,1200104,202020,1474,1474,0
2020-05-11,1200054,202020,1474,1474,0
2020-05-11,1200302,202020,1474,1474,0
2020-05-12,1200450,202020,1486,1474,12
2020-05-12,1200500,202020,1492,1486,6
2020-05-12,1200054,202020,1492,1492,0
2020-05-12,1200708,202020,1493,1492,1
2020-05-12,1200435,202020,1493,1493,0
2020-05-12,1200427,202020,1497,1493,4
2020-05-12,1200401,202020,1568,1497,71
2020-05-12,1200807,202020,1571,1568,3
2020-05-12,1200385,202020,1585,1571,14
2020-05-12,1200013,202020,1586,1585,1
2020-05-12,1200336,202020,1586,1586,0
2020-05-12,1200302,202020,1586,1586,0
2020-05-12,1200252,202020,1586,1586,0
2020-05-12,1200203,202020,1590,1586,4
2020-05-12,1200179,202020,1590,1590,0
2020-05-12,1200138,202020,1594,1590,4
2020-05-12,1200104,202020,1596,1594,2
2020-05-12,1200351,202020,1599,1596,3
2020-05-12,1200609,202020,1604,1599,5
2020-05-13,1200427,202020,1605,1604,1
2020-05-13,1200450,202020,1605,1605,0
2020-05-13,1200708,202020,1606,1605,1
2020-05-13,1200609,202020,1607,1606,1
2020-05-13,1200500,202020,1607,1607,0
2020-05-13,1200435,202020,1607,1607,0
2020-05-13,1200401,202020,1651,1607,44
2020-05-13,1200807,202020,1651,1651,0
2020-05-13,1200336,202020,1651,1651,0
2020-05-13,1200351,202020,1651,1651,0
2020-05-13,1200385,202020,1652,1651,1
2020-05-13,1200252,202020,1652,1652,0
2020-05-13,1200203,202020,1692,1652,40
2020-05-13,1200179,202020,1692,1692,0
2020-05-13,1200138,202020,1700,1692,8
2020-05-13,1200104,202020,1700,1700,0
2020-05-13,1200054,202020,1700,1700,0
2020-05-13,1200013,202020,1708,1700,8
2020-05-13,1200302,202020,1708,1708,0
2020-05-14,1200302,202020,1708,1708,0
2020-05-14,1200401,202020,1712,1708,4
2020-05-14,1200385,202020,1718,1712,6
2020-05-14,1200336,202020,1718,1718,0
2020-05-14,1200351,202020,1723,1718,5
2020-05-14,1200252,202020,1724,1723,1
2020-05-14,1200500,202020,1726,1724,2
2020-05-14,1200179,202020,1726,1726,0
2020-05-14,1200138,202020,1726,1726,0
2020-05-14,1200104,202020,1726,1726,0
2020-05-14,1200054,202020,1726,1726,0
2020-05-14,1200013,202020,1734,1726,8
2020-05-14,1200427,202020,1733,1734,-1
2020-05-14,1200203,202020,1752,1733,19
2020-05-14,1200435,202020,1753,1752,1
2020-05-14,1200807,202020,1753,1753,0
2020-05-14,1200609,202020,1753,1753,0
2020-05-14,1200708,202020,1753,1753,0
2020-05-14,1200450,202020,1754,1753,1
2020-05-15,1200807,202020,1755,1754,1
2020-05-15,1200302,202020,1755,1755,0
2020-05-15,1200351,202020,1758,1755,3
2020-05-15,1200336,202020,1758,1758,0
2020-05-15,1200385,202020,1759,1758,1
2020-05-15,1200401,202020,1765,1759,6
2020-05-15,1200427,202020,1766,1765,1
2020-05-15,1200435,202020,1766,1766,0
2020-05-15,1200500,202020,1768,1766,2
2020-05-15,1200450,202020,1764,1768,-4
2020-05-15,1200179,202020,1765,1764,1
2020-05-15,1200609,202020,1768,1765,3
2020-05-15,1200708,202020,1768,1768,0
2020-05-15,1200138,202020,1769,1768,1
2020-05-15,1200104,202020,1769,1769,0
2020-05-15,1200054,202020,1769,1769,0
2020-05-15,1200013,202020,1781,1769,12
2020-05-15,1200252,202020,1781,1781,0
2020-05-15,1200203,202020,1799,1781,18
2020-05-16,1200336,202020,1801,1799,2
2020-05-16,1200807,202020,1802,1801,1
2020-05-16,1200013,202020,1810,1802,8
2020-05-16,1200054,202020,1810,1810,0
2020-05-16,1200104,202020,1809,1810,-1
2020-05-16,1200138,202020,1810,1809,1
2020-05-16,1200179,202020,1810,1810,0
2020-05-16,1200203,202020,1858,1810,48
2020-05-16,1200252,202020,1859,1858,1
2020-05-16,1200385,202020,1861,1859,2
2020-05-16,1200302,202020,1862,1861,1
2020-05-16,1200351,202020,1863,1862,1
2020-05-16,1200401,202020,1869,1863,6
2020-05-16,1200427,202020,1868,1869,-1
2020-05-16,1200435,202020,1868,1868,0
2020-05-16,1200500,202020,1871,1868,3
2020-05-16,1200450,202020,1872,1871,1
2020-05-16,1200609,202020,1881,1872,9
2020-05-16,1200708,202020,1881,1881,0
2020-05-17,1200427,202021,1880,1881,-1
2020-05-17,1200401,202021,1994,1880,114
2020-05-17,1200336,202021,1994,1994,0
2020-05-17,1200435,202021,1994,1994,0
2020-05-17,1200500,202021,1997,1994,3
2020-05-17,1200450,202021,1999,1997,2
2020-05-17,1200609,202021,1998,1999,-1
2020-05-17,1200708,202021,1998,1998,0
2020-05-17,1200351,202021,1997,1998,-1
2020-05-17,1200179,202021,1997,1997,0
2020-05-17,1200252,202021,2006,1997,9
2020-05-17,1200203,202021,2007,2006,1
2020-05-17,1200807,202021,2007,2007,0
2020-05-17,1200138,202021,2006,2007,-1
2020-05-17,1200104,202021,2008,2006,2
2020-05-17,1200054,202021,2008,2008,0
2020-05-17,1200013,202021,2008,2008,0
2020-05-17,1200302,202021,2008,2008,0
2020-05-17,1200385,202021,2010,2008,2
2020-05-18,1200302,202021,2010,2010,0
2020-05-18,1200013,202021,2017,2010,7
2020-05-18,1200351,202021,2017,2017,0
2020-05-18,1200336,202021,2017,2017,0
2020-05-18,1200385,202021,2016,2017,-1
2020-05-18,1200807,202021,2016,2016,0
2020-05-18,1200203,202021,2020,2016,4
2020-05-18,1200427,202021,2019,2020,-1
2020-05-18,1200435,202021,2019,2019,0
2020-05-18,1200500,202021,2026,2019,7
2020-05-18,1200450,202021,2031,2026,5
2020-05-18,1200609,202021,2031,2031,0
2020-05-18,1200708,202021,2032,2031,1
2020-05-18,1200179,202021,2038,2032,6
2020-05-18,1200138,202021,2038,2038,0
2020-05-18,1200104,202021,2039,2038,1
2020-05-18,1200054,202021,2039,2039,0
2020-05-18,1200252,202021,2041,2039,2
2020-05-18,1200401,202021,2248,2041,207
2020-05-19,1200179,202021,2250,2248,2
2020-05-19,1200427,202021,2250,2250,0
2020-05-19,1200708,202021,2250,2250,0
2020-05-19,1200609,202021,2274,2250,24
2020-05-19,1200450,202021,2284,2274,10
2020-05-19,1200500,202021,2291,2284,7
2020-05-19,1200435,202021,2291,2291,0
2020-05-19,1200401,202021,2448,2291,157
2020-05-19,1200807,202021,2453,2448,5
2020-05-19,1200336,202021,2454,2453,1
2020-05-19,1200385,202021,2469,2454,15
2020-05-19,1200302,202021,2469,2469,0
2020-05-19,1200252,202021,2469,2469,0
2020-05-19,1200203,202021,2489,2469,20
2020-05-19,1200138,202021,2490,2489,1
2020-05-19,1200104,202021,2491,2490,1
2020-05-19,1200054,202021,2492,2491,1
2020-05-19,1200013,202021,2492,2492,0
2020-05-19,1200351,202021,2496,2492,4
2020-05-20,1200203,202021,2496,2496,0
2020-05-20,1200252,202021,2496,2496,0
2020-05-20,1200179,202021,2496,2496,0
2020-05-20,1200500,202021,2496,2496,0
2020-05-20,1200054,202021,2496,2496,0
2020-05-20,1200013,202021,2496,2496,0
2020-05-20,1200302,202021,2496,2496,0
2020-05-20,1200138,202021,2496,2496,0
2020-05-20,1200351,202021,2496,2496,0
2020-05-20,1200336,202021,2496,2496,0
2020-05-20,1200385,202021,2496,2496,0
2020-05-20,1200450,202021,2496,2496,0
2020-05-20,1200609,202021,2496,2496,0
2020-05-20,1200708,202021,2496,2496,0
2020-05-20,1200435,202021,2496,2496,0
2020-05-20,1200104,202021,2496,2496,0
2020-05-20,1200807,202021,2496,2496,0
2020-05-20,1200401,202021,2496,2496,0
2020-05-20,1200427,202021,2496,2496,0
2020-05-21,1200450,202021,2517,2496,21
2020-05-21,1200013,202021,2542,2517,25
2020-05-21,1200054,202021,2547,2542,5
2020-05-21,1200104,202021,2564,2547,17
2020-05-21,1200138,202021,2567,2564,3
2020-05-21,1200179,202021,2570,2567,3
2020-05-21,1200203,202021,2664,2570,94
2020-05-21,1200252,202021,2684,2664,20
2020-05-21,1200302,202021,2684,2684,0
2020-05-21,1200351,202021,2695,2684,11
2020-05-21,1200708,202021,2700,2695,5
2020-05-21,1200385,202021,2726,2700,26
2020-05-21,1200807,202021,2734,2726,8
2020-05-21,1200401,202021,3039,2734,305
2020-05-21,1200427,202021,3041,3039,2
2020-05-21,1200435,202021,3041,3041,0
2020-05-21,1200500,202021,3081,3041,40
2020-05-21,1200609,202021,3116,3081,35
2020-05-21,1200336,202021,3117,3116,1
2020-05-22,1200708,202021,3118,3117,1
2020-05-22,1200054,202021,3118,3118,0
2020-05-22,1200609,202021,3131,3118,13
2020-05-22,1200500,202021,3149,3131,18
2020-05-22,1200435,202021,3149,3149,0
2020-05-22,1200427,202021,3152,3149,3
2020-05-22,1200401,202021,3220,3152,68
2020-05-22,1200807,202021,3221,3220,1
2020-05-22,1200385,202021,3222,3221,1
2020-05-22,1200336,202021,3222,3222,0
2020-05-22,1200450,202021,3231,3222,9
2020-05-22,1200302,202021,3231,3231,0
2020-05-22,1200252,202021,3231,3231,0
2020-05-22,1200203,202021,3319,3231,88
2020-05-22,1200179,202021,3319,3319,0
2020-05-22,1200138,202021,3322,3319,3
2020-05-22,1200104,202021,3328,3322,6
2020-05-22,1200013,202021,3348,3328,20
2020-05-22,1200351,202021,3357,3348,9
2020-05-23,1200401,202021,3779,3357,422
2020-05-23,1200807,202021,3784,3779,5
2020-05-23,1200385,202021,3788,3784,4
2020-05-23,1200336,202021,3789,3788,1
2020-05-23,1200351,202021,3795,3789,6
2020-05-23,1200302,202021,3795,3795,0
2020-05-23,1200138,202021,3798,3795,3
2020-05-23,1200203,202021,3812,3798,14
2020-05-23,1200179,202021,3816,3812,4
2020-05-23,1200104,202021,3812,3816,-4
2020-05-23,1200054,202021,3812,3812,0
2020-05-23,1200013,202021,3822,3812,10
2020-05-23,1200427,202021,3822,3822,0
2020-05-23,1200252,202021,3827,3822,5
2020-05-23,1200435,202021,3827,3827,0
2020-05-23,1200500,202021,3845,3827,18
2020-05-23,1200609,202021,3876,3845,31
2020-05-23,1200708,202021,3881,3876,5
2020-05-23,1200450,202021,3881,3881,0
2020-05-24,1200385,202022,3886,3881,5
2020-05-24,1200302,202022,3886,3886,0
2020-05-24,1200344,202022,3887,3886,1
2020-05-24,1200351,202022,3887,3887,0
2020-05-24,1200336,202022,3889,3887,2
2020-05-24,1200807,202022,3896,3889,7
2020-05-24,1200401,202022,4141,3896,245
2020-05-24,1200427,202022,4141,4141,0
2020-05-24,1200435,202022,4141,4141,0
2020-05-24,1200500,202022,4155,4141,14
2020-05-24,1200450,202022,4155,4155,0
2020-05-24,1200609,202022,4155,4155,0
2020-05-24,1200708,202022,4156,4155,1
2020-05-24,1200179,202022,4163,4156,7
2020-05-24,1200138,202022,4165,4163,2
2020-05-24,1200104,202022,4165,4165,0
2020-05-24,1200054,202022,4165,4165,0
2020-05-24,1200013,202022,4165,4165,0
2020-05-24,1200252,202022,4165,4165,0
2020-05-24,1200203,202022,4174,4165,9
2020-05-25,1200385,202022,4174,4174,0
2020-05-25,1200013,202022,4174,4174,0
2020-05-25,1200054,202022,4174,4174,0
2020-05-25,1200336,202022,4174,4174,0
2020-05-25,1200104,202022,4180,4174,6
2020-05-25,1200138,202022,4180,4180,0
2020-05-25,1200179,202022,4180,4180,0
2020-05-25,1200203,202022,4181,4180,1
2020-05-25,1200351,202022,4182,4181,1
2020-05-25,1200252,202022,4187,4182,5
2020-05-25,1200302,202022,4187,4187,0
2020-05-25,1200500,202022,4199,4187,12
2020-05-25,1200401,202022,4493,4199,294
2020-05-25,1200427,202022,4493,4493,0
2020-05-25,1200609,202022,4493,4493,0
2020-05-25,1200708,202022,4493,4493,0
2020-05-25,1200435,202022,4493,4493,0
2020-05-25,1200807,202022,4503,4493,10
2020-05-25,1200450,202022,4516,4503,13
2020-05-26,1200013,202022,4519,4516,3
2020-05-26,1200054,202022,4520,4519,1
2020-05-26,1200104,202022,4513,4520,-7
2020-05-26,1200138,202022,4517,4513,4
2020-05-26,1200179,202022,4521,4517,4
2020-05-26,1200203,202022,4538,4521,17
2020-05-26,1200302,202022,4542,4538,4
2020-05-26,1200252,202022,4548,4542,6
2020-05-26,1200385,202022,4561,4548,13
2020-05-26,1200807,202022,4567,4561,6
2020-05-26,1200393,202022,4568,4567,1
2020-05-26,1200401,202022,4787,4568,219
2020-05-26,1200427,202022,4787,4787,0
2020-05-26,1200435,202022,4788,4787,1
2020-05-26,1200500,202022,4789,4788,1
2020-05-26,1200450,202022,4789,4789,0
2020-05-26,1200609,202022,4795,4789,6
2020-05-26,1200708,202022,4796,4795,1
2020-05-26,1200351,202022,4796,4796,0
2020-05-26,1200336,202022,4796,4796,0
2020-05-27,1200203,202022,4821,4796,25
2020-05-27,1200179,202022,4822,4821,1
2020-05-27,1200013,202022,4835,4822,13
2020-05-27,1200138,202022,4840,4835,5
2020-05-27,1200054,202022,4851,4840,11
2020-05-27,1200104,202022,4861,4851,10
2020-05-27,1200252,202022,4866,4861,5
2020-05-27,1200302,202022,4867,4866,1
2020-05-27,1200351,202022,4886,4867,19
2020-05-27,1200336,202022,4890,4886,4
2020-05-27,1200385,202022,4890,4890,0
2020-05-27,1200807,202022,4904,4890,14
2020-05-27,1200393,202022,4905,4904,1
2020-05-27,1200401,202022,5170,4905,265
2020-05-27,1200427,202022,5172,5170,2
2020-05-27,1200435,202022,5177,5172,5
2020-05-27,1200500,202022,5210,5177,33
2020-05-27,1200450,202022,5215,5210,5
2020-05-27,1200609,202022,5262,5215,47
2020-05-27,1200708,202022,5266,5262,4
2020-05-28,1200708,202022,5269,5266,3
2020-05-28,1200013,202022,5274,5269,5
2020-05-28,1200054,202022,5277,5274,3
2020-05-28,1200104,202022,5277,5277,0
2020-05-28,1200500,202022,5295,5277,18
2020-05-28,1200435,202022,5298,5295,3
2020-05-28,1200427,202022,5298,5298,0
2020-05-28,1200401,202022,5439,5298,141
2020-05-28,1200393,202022,5439,5439,0
2020-05-28,1200807,202022,5439,5439,0
2020-05-28,1200450,202022,5439,5439,0
2020-05-28,1200385,202022,5443,5439,4
2020-05-28,1200351,202022,5454,5443,11
2020-05-28,1200302,202022,5454,5454,0
2020-05-28,1200252,202022,5455,5454,1
2020-05-28,1200203,202022,5578,5455,123
2020-05-28,1200179,202022,5584,5578,6
2020-05-28,1200138,202022,5587,5584,3
2020-05-28,1200336,202022,5591,5587,4
2020-05-28,1200609,202022,5615,5591,24
2020-05-29,1200393,202022,5615,5615,0
2020-05-29,1200427,202022,5618,5615,3
2020-05-29,1200708,202022,5623,5618,5
2020-05-29,1200609,202022,5634,5623,11
2020-05-29,1200450,202022,5653,5634,19
2020-05-29,1200500,202022,5667,5653,14
2020-05-29,1200435,202022,5667,5667,0
2020-05-29,1200401,202022,5802,5667,135
2020-05-29,1200807,202022,5807,5802,5
2020-05-29,1200336,202022,5812,5807,5
2020-05-29,1200385,202022,5814,5812,2
2020-05-29,1200302,202022,5815,5814,1
2020-05-29,1200252,202022,5817,5815,2
2020-05-29,1200203,202022,5838,5817,21
2020-05-29,1200179,202022,5839,5838,1
2020-05-29,1200138,202022,5841,5839,2
2020-05-29,1200104,202022,5842,5841,1
2020-05-29,1200054,202022,5843,5842,1
2020-05-29,1200013,202022,5851,5843,8
2020-05-29,1200351,202022,5856,5851,5
2020-05-30,1200203,202022,5899,5856,43
2020-05-30,1200302,202022,5904,5899,5
2020-05-30,1200252,202022,5905,5904,1
2020-05-30,1200179,202022,5909,5905,4
2020-05-30,1200401,202022,6034,5909,125
2020-05-30,1200104,202022,6034,6034,0
2020-05-30,1200054,202022,6036,6034,2
2020-05-30,1200013,202022,6036,6036,0
2020-05-30,1200344,202022,6037,6036,1
2020-05-30,1200138,202022,6042,6037,5
2020-05-30,1200393,202022,6042,6042,0
2020-05-30,1200336,202022,6043,6042,1
2020-05-30,1200807,202022,6043,6043,0
2020-05-30,1200427,202022,6045,6043,2
2020-05-30,1200435,202022,6046,6045,1
2020-05-30,1200500,202022,6053,6046,7
2020-05-30,1200450,202022,6055,6053,2
2020-05-30,1200609,202022,6059,6055,4
2020-05-30,1200708,202022,6062,6059,3
2020-05-30,1200385,202022,6081,6062,19
2020-05-30,1200351,202022,6087,6081,6
2020-05-31,1200807,202023,6101,6087,14
2020-05-31,1200708,202023,6101,6101,0
2020-05-31,1200609,202023,6103,6101,2
2020-05-31,1200450,202023,6105,6103,2
2020-05-31,1200500,202023,6109,6105,4
2020-05-31,1200435,202023,6109,6109,0
2020-05-31,1200427,202023,6111,6109,2
2020-05-31,1200013,202023,6111,6111,0
2020-05-31,1200054,202023,6113,6111,2
2020-05-31,1200393,202023,6113,6113,0
2020-05-31,1200104,202023,6115,6113,2
2020-05-31,1200179,202023,6115,6115,0
2020-05-31,1200203,202023,6147,6115,32
2020-05-31,1200252,202023,6147,6147,0
2020-05-31,1200401,202023,6231,6147,84
2020-05-31,1200344,202023,6231,6231,0
2020-05-31,1200351,202023,6231,6231,0
2020-05-31,1200336,202023,6232,6231,1
2020-05-31,1200385,202023,6233,6232,1
2020-05-31,1200138,202023,6234,6233,1
2020-05-31,1200302,202023,6234,6234,0
2020-06-01,1200351,202023,6234,6234,0
2020-06-01,1200435,202023,6234,6234,0
2020-06-01,1200708,202023,6234,6234,0
2020-06-01,1200609,202023,6234,6234,0
2020-06-01,1200450,202023,6234,6234,0
2020-06-01,1200500,202023,6234,6234,0
2020-06-01,1200427,202023,6234,6234,0
2020-06-01,1200401,202023,6319,6234,85
2020-06-01,1200393,202023,6319,6319,0
2020-06-01,1200385,202023,6320,6319,1
2020-06-01,1200336,202023,6320,6320,0
2020-06-01,1200807,202023,6320,6320,0
2020-06-01,1200302,202023,6320,6320,0
2020-06-01,1200252,202023,6338,6320,18
2020-06-01,1200203,202023,6339,6338,1
2020-06-01,1200179,202023,6339,6339,0
2020-06-01,1200138,202023,6339,6339,0
2020-06-01,1200104,202023,6340,6339,1
2020-06-01,1200054,202023,6341,6340,1
2020-06-01,1200013,202023,6341,6341,0
2020-06-01,1200344,202023,6341,6341,0
2020-06-02,1200302,202023,6344,6341,3
2020-06-02,1200336,202023,6345,6344,1
2020-06-02,1200351,202023,6349,6345,4
2020-06-02,1200344,202023,6351,6349,2
2020-06-02,1200252,202023,6352,6351,1
2020-06-02,1200393,202023,6352,6352,0
2020-06-02,1200138,202023,6352,6352,0
2020-06-02,1200104,202023,6351,6352,-1
2020-06-02,1200054,202023,6358,6351,7
2020-06-02,1200013,202023,6358,6358,0
2020-06-02,1200385,202023,6361,6358,3
2020-06-02,1200179,202023,6364,6361,3
2020-06-02,1200807,202023,6374,6364,10
2020-06-02,1200203,202023,6373,6374,-1
2020-06-02,1200427,202023,6378,6373,5
2020-06-02,1200500,202023,6397,6378,19
2020-06-02,1200450,202023,6400,6397,3
2020-06-02,1200609,202023,6428,6400,28
2020-06-02,1200708,202023,6429,6428,1
2020-06-02,1200401,202023,6477,6429,48
2020-06-02,1200435,202023,6480,6477,3
2020-06-03,1200013,202023,6482,6480,2
2020-06-03,1200054,202023,6490,6482,8
2020-06-03,1200104,202023,6507,6490,17
2020-06-03,1200138,202023,6506,6507,-1
2020-06-03,1200179,202023,6508,6506,2
2020-06-03,1200203,202023,6545,6508,37
2020-06-03,1200252,202023,6555,6545,10
2020-06-03,1200328,202023,6556,6555,1
2020-06-03,1200302,202023,6564,6556,8
2020-06-03,1200351,202023,6568,6564,4
2020-06-03,1200336,202023,6577,6568,9
2020-06-03,1200385,202023,6578,6577,1
2020-06-03,1200807,202023,6581,6578,3
2020-06-03,1200393,202023,6581,6581,0
2020-06-03,1200401,202023,6633,6581,52
2020-06-03,1200427,202023,6639,6633,6
2020-06-03,1200435,202023,6639,6639,0
2020-06-03,1200500,202023,6641,6639,2
2020-06-03,1200450,202023,6641,6641,0
2020-06-03,1200609,202023,6685,6641,44
2020-06-03,1200708,202023,6694,6685,9
2020-06-03,1200344,202023,6694,6694,0
2020-06-04,1200104,202023,6694,6694,0
2020-06-04,1200179,202023,6694,6694,0
2020-06-04,1200138,202023,6694,6694,0
2020-06-04,1200013,202023,6694,6694,0
2020-06-04,1200054,202023,6694,6694,0
2020-06-04,1200807,202023,6694,6694,0
2020-06-04,1200500,202023,6694,6694,0
2020-06-04,1200435,202023,6694,6694,0
2020-06-04,1200427,202023,6694,6694,0
2020-06-04,1200401,202023,6694,6694,0
2020-06-04,1200393,202023,6694,6694,0
2020-06-04,1200708,202023,6694,6694,0
2020-06-04,1200450,202023,6694,6694,0
2020-06-04,1200385,202023,6694,6694,0
2020-06-04,1200351,202023,6694,6694,0
2020-06-04,1200344,202023,6694,6694,0
2020-06-04,1200328,202023,6694,6694,0
2020-06-04,1200302,202023,6694,6694,0
2020-06-04,1200252,202023,6694,6694,0
2020-06-04,1200203,202023,6694,6694,0
2020-06-04,1200336,202023,6694,6694,0
2020-06-04,1200609,202023,6694,6694,0
2020-06-05,1200427,202023,6696,6694,2
2020-06-05,1200401,202023,6855,6696,159
2020-06-05,1200013,202023,6860,6855,5
2020-06-05,1200104,202023,6900,6860,40
2020-06-05,1200435,202023,6930,6900,30
2020-06-05,1200393,202023,6930,6930,0
2020-06-05,1200450,202023,6949,6930,19
2020-06-05,1200609,202023,6993,6949,44
2020-06-05,1200708,202023,7017,6993,24
2020-06-05,1200807,202023,7033,7017,16
2020-06-05,1200385,202023,7046,7033,13
2020-06-05,1200054,202023,7059,7046,13
2020-06-05,1200336,202023,7083,7059,24
2020-06-05,1200344,202023,7098,7083,15
2020-06-05,1200328,202023,7098,7098,0
2020-06-05,1200302,202023,7107,7098,9
2020-06-05,1200252,202023,7108,7107,1
2020-06-05,1200203,202023,7249,7108,141
2020-06-05,1200179,202023,7265,7249,16
2020-06-05,1200138,202023,7286,7265,21
2020-06-05,1200351,202023,7292,7286,6
2020-06-05,1200500,202023,7299,7292,7
2020-06-06,1200500,202023,7302,7299,3
2020-06-06,1200708,202023,7310,7302,8
2020-06-06,1200435,202023,7311,7310,1
2020-06-06,1200427,202023,7318,7311,7
2020-06-06,1200401,202023,7356,7318,38
2020-06-06,1200393,202023,7356,7356,0
2020-06-06,1200807,202023,7360,7356,4
2020-06-06,1200385,202023,7364,7360,4
2020-06-06,1200336,202023,7372,7364,8
2020-06-06,1200351,202023,7378,7372,6
2020-06-06,1200344,202023,7379,7378,1
2020-06-06,1200328,202023,7382,7379,3
2020-06-06,1200302,202023,7384,7382,2
2020-06-06,1200252,202023,7388,7384,4
2020-06-06,1200203,202023,7490,7388,102
2020-06-06,1200179,202023,7493,7490,3
2020-06-06,1200138,202023,7496,7493,3
2020-06-06,1200104,202023,7513,7496,17
2020-06-06,1200013,202023,7513,7513,0
2020-06-06,1200450,202023,7514,7513,1
2020-06-06,1200609,202023,7537,7514,23
2020-06-06,1200054,202023,7540,7537,3
2020-06-07,1200336,202024,7539,7540,-1
2020-06-07,1200807,202024,7539,7539,0
2020-06-07,1200393,202024,7539,7539,0
2020-06-07,1200401,202024,7598,7539,59
2020-06-07,1200427,202024,7599,7598,1
2020-06-07,1200435,202024,7601,7599,2
2020-06-07,1200500,202024,7601,7601,0
2020-06-07,1200450,202024,7602,7601,1
2020-06-07,1200609,202024,7604,7602,2
2020-06-07,1200708,202024,7604,7604,0
2020-06-07,1200351,202024,7605,7604,1
2020-06-07,1200344,202024,7606,7605,1
2020-06-07,1200328,202024,7606,7606,0
2020-06-07,1200302,202024,7614,7606,8
2020-06-07,1200252,202024,7615,7614,1
2020-06-07,1200203,202024,7992,7615,377
2020-06-07,1200179,202024,7992,7992,0
2020-06-07,1200138,202024,7997,7992,5
2020-06-07,1200104,202024,7997,7997,0
2020-06-07,1200054,202024,7997,7997,0
2020-06-07,1200013,202024,7997,7997,0
2020-06-07,1200385,202024,7998,7997,1
2020-06-08,1200500,202024,8008,7998,10
2020-06-08,1200401,202024,8092,8008,84
2020-06-08,1200708,202024,8092,8092,0
2020-06-08,1200609,202024,8093,8092,1
2020-06-08,1200450,202024,8094,8093,1
2020-06-08,1200435,202024,8094,8094,0
2020-06-08,1200427,202024,8093,8094,-1
2020-06-08,1200393,202024,8093,8093,0
2020-06-08,1200807,202024,8095,8093,2
2020-06-08,1200385,202024,8098,8095,3
2020-06-08,1200351,202024,8098,8098,0
2020-06-08,1200336,202024,8098,8098,0
2020-06-08,1200328,202024,8098,8098,0
2020-06-08,1200302,202024,8098,8098,0
2020-06-08,1200252,202024,8098,8098,0
2020-06-08,1200203,202024,8122,8098,24
2020-06-08,1200179,202024,8123,8122,1
2020-06-08,1200138,202024,8123,8123,0
2020-06-08,1200104,202024,8140,8123,17
2020-06-08,1200054,202024,8141,8140,1
2020-06-08,1200013,202024,8142,8141,1
2020-06-08,1200344,202024,8142,8142,0
2020-06-09,1200203,202024,8215,8142,73
2020-06-09,1200328,202024,8215,8215,0
2020-06-09,1200302,202024,8223,8215,8
2020-06-09,1200252,202024,8230,8223,7
2020-06-09,1200179,202024,8238,8230,8
2020-06-09,1200385,202024,8240,8238,2
2020-06-09,1200104,202024,8264,8240,24
2020-06-09,1200054,202024,8273,8264,9
2020-06-09,1200013,202024,8274,8273,1
2020-06-09,1200344,202024,8282,8274,8
2020-06-09,1200138,202024,8293,8282,11
2020-06-09,1200336,202024,8305,8293,12
2020-06-09,1200807,202024,8321,8305,16
2020-06-09,1200351,202024,8325,8321,4
2020-06-09,1200393,202024,8325,8325,0
2020-06-09,1200401,202024,8399,8325,74
2020-06-09,1200427,202024,8401,8399,2
2020-06-09,1200435,202024,8415,8401,14
2020-06-09,1200500,202024,8420,8415,5
2020-06-09,1200450,202024,8428,8420,8
2020-06-09,1200609,202024,8454,8428,26
2020-06-09,1200708,202024,8472,8454,18
2020-06-10,1200708,202024,8477,8472,5
2020-06-10,1200013,202024,8477,8477,0
2020-06-10,1200054,202024,8487,8477,10
2020-06-10,1200104,202024,8511,8487,24
2020-06-10,1200138,202024,8513,8511,2
2020-06-10,1200179,202024,8513,8513,0
2020-06-10,1200203,202024,8687,8513,174
2020-06-10,1200807,202024,8688,8687,1
2020-06-10,1200450,202024,8689,8688,1
2020-06-10,1200500,202024,8697,8689,8
2020-06-10,1200435,202024,8705,8697,8
2020-06-10,1200427,202024,8705,8705,0
2020-06-10,1200401,202024,8719,8705,14
2020-06-10,1200393,202024,8719,8719,0
2020-06-10,1200252,202024,8719,8719,0
2020-06-10,1200609,202024,8742,8719,23
2020-06-10,1200336,202024,8749,8742,7
2020-06-10,1200351,202024,8752,8749,3
2020-06-10,1200344,202024,8755,8752,3
2020-06-10,1200328,202024,8755,8755,0
2020-06-10,1200302,202024,8761,8755,6
2020-06-10,1200385,202024,8761,8761,0
2020-06-11,1200054,202024,8761,8761,0
2020-06-11,1200013,202024,8761,8761,0
2020-06-11,1200104,202024,8752,8761,-9
2020-06-11,1200500,202024,8763,8752,11
2020-06-11,1200138,202024,8766,8763,3
2020-06-11,1200450,202024,8766,8766,0
2020-06-11,1200401,202024,8997,8766,231
2020-06-11,1200609,202024,9003,8997,6
2020-06-11,1200708,202024,9019,9003,16
2020-06-11,1200393,202024,9019,9019,0
2020-06-11,1200807,202024,9019,9019,0
2020-06-11,1200435,202024,9027,9019,8
2020-06-11,1200385,202024,9033,9027,6
2020-06-11,1200351,202024,9033,9033,0
2020-06-11,1200344,202024,9034,9033,1
2020-06-11,1200328,202024,9037,9034,3
2020-06-11,1200302,202024,9042,9037,5
2020-06-11,1200252,202024,9051,9042,9
2020-06-11,1200203,202024,9085,9051,34
2020-06-11,1200179,202024,9095,9085,10
2020-06-11,1200336,202024,9097,9095,2
2020-06-11,1200427,202024,9106,9097,9
2020-06-12,1200393,202024,9106,9106,0
2020-06-12,1200013,202024,9111,9106,5
2020-06-12,1200054,202024,9120,9111,9
2020-06-12,1200104,202024,9139,9120,19
2020-06-12,1200138,202024,9139,9139,0
2020-06-12,1200179,202024,9140,9139,1
2020-06-12,1200203,202024,9149,9140,9
2020-06-12,1200252,202024,9149,9149,0
2020-06-12,1200302,202024,9149,9149,0
2020-06-12,1200328,202024,9151,9149,2
2020-06-12,1200344,202024,9151,9151,0
2020-06-12,1200351,202024,9156,9151,5
2020-06-12,1200385,202024,9161,9156,5
2020-06-12,1200336,202024,9161,9161,0
2020-06-12,1200807,202024,9163,9161,2
2020-06-12,1200500,202024,9188,9163,25
2020-06-12,1200609,202024,9191,9188,3
2020-06-12,1200427,202024,9191,9191,0
2020-06-12,1200708,202024,9200,9191,9
2020-06-12,1200435,202024,9200,9200,0
2020-06-12,1200401,202024,9285,9200,85
2020-06-12,1200450,202024,9310,9285,25
2020-06-13,1200013,202024,9310,9310,0
2020-06-13,1200054,202024,9310,9310,0
2020-06-13,1200104,202024,9310,9310,0
2020-06-13,1200138,202024,9313,9310,3
2020-06-13,1200179,202024,9324,9313,11
2020-06-13,1200203,202024,9342,9324,18
2020-06-13,1200252,202024,9342,9342,0
2020-06-13,1200328,202024,9344,9342,2
2020-06-13,1200302,202024,9357,9344,13
2020-06-13,1200336,202024,9364,9357,7
2020-06-13,1200385,202024,9373,9364,9
2020-06-13,1200807,202024,9380,9373,7
2020-06-13,1200393,202024,9380,9380,0
2020-06-13,1200401,202024,9509,9380,129
2020-06-13,1200427,202024,9509,9509,0
2020-06-13,1200435,202024,9509,9509,0
2020-06-13,1200500,202024,9523,9509,14
2020-06-13,1200450,202024,9530,9523,7
2020-06-13,1200609,202024,9532,9530,2
2020-06-13,1200708,202024,9544,9532,12
2020-06-13,1200351,202024,9547,9544,3
2020-06-13,1200344,202024,9549,9547,2
2020-06-14,1200179,202025,9551,9549,2
2020-06-14,1200138,202025,9553,9551,2
2020-06-14,1200104,202025,9574,9553,21
2020-06-14,1200013,202025,9580,9574,6
2020-06-14,1200054,202025,9587,9580,7
2020-06-14,1200807,202025,9587,9587,0
2020-06-14,1200500,202025,9602,9587,15
2020-06-14,1200435,202025,9603,9602,1
2020-06-14,1200427,202025,9606,9603,3
2020-06-14,1200401,202025,9635,9606,29
2020-06-14,1200393,202025,9636,9635,1
2020-06-14,1200708,202025,9637,9636,1
2020-06-14,1200450,202025,9637,9637,0
2020-06-14,1200385,202025,9637,9637,0
2020-06-14,1200351,202025,9637,9637,0
2020-06-14,1200344,202025,9637,9637,0
2020-06-14,1200328,202025,9638,9637,1
2020-06-14,1200302,202025,9639,9638,1
2020-06-14,1200252,202025,9647,9639,8
2020-06-14,1200203,202025,9657,9647,10
2020-06-14,1200336,202025,9657,9657,0
2020-06-14,1200609,202025,9657,9657,0
2020-06-15,1200427,202025,9659,9657,2
2020-06-15,1200401,202025,9760,9659,101
2020-06-15,1200013,202025,9760,9760,0
2020-06-15,1200104,202025,9766,9760,6
2020-06-15,1200435,202025,9766,9766,0
2020-06-15,1200393,202025,9766,9766,0
2020-06-15,1200450,202025,9767,9766,1
2020-06-15,1200609,202025,9767,9767,0
2020-06-15,1200708,202025,9768,9767,1
2020-06-15,1200807,202025,9777,9768,9
2020-06-15,1200385,202025,9777,9777,0
2020-06-15,1200054,202025,9777,9777,0
2020-06-15,1200336,202025,9777,9777,0
2020-06-15,1200344,202025,9777,9777,0
2020-06-15,1200328,202025,9778,9777,1
2020-06-15,1200302,202025,9778,9778,0
2020-06-15,1200252,202025,9778,9778,0
2020-06-15,1200203,202025,9784,9778,6
2020-06-15,1200179,202025,9785,9784,1
2020-06-15,1200138,202025,9784,9785,-1
2020-06-15,1200351,202025,9784,9784,0
2020-06-15,1200500,202025,9786,9784,2
2020-06-16,1200385,202025,9792,9786,6
2020-06-16,1200401,202025,9957,9792,165
2020-06-16,1200708,202025,9956,9957,-1
2020-06-16,1200609,202025,9958,9956,2
2020-06-16,1200450,202025,9959,9958,1
2020-06-16,1200500,202025,9960,9959,1
2020-06-16,1200435,202025,9962,9960,2
2020-06-16,1200427,202025,9964,9962,2
2020-06-16,1200393,202025,9965,9964,1
2020-06-16,1200807,202025,9965,9965,0
2020-06-16,1200351,202025,9967,9965,2
2020-06-16,1200336,202025,9968,9967,1
2020-06-16,1200328,202025,9969,9968,1
2020-06-16,1200302,202025,9982,9969,13
2020-06-16,1200252,202025,9982,9982,0
2020-06-16,1200203,202025,10006,9982,24
2020-06-16,1200179,202025,10007,10006,1
2020-06-16,1200138,202025,10013,10007,6
2020-06-16,1200104,202025,10013,10013,0
2020-06-16,1200054,202025,10017,10013,4
2020-06-16,1200013,202025,10017,10017,0
2020-06-16,1200344,202025,10018,10017,1
2020-06-17,1200203,202025,10032,10018,14
2020-06-17,1200328,202025,10035,10032,3
2020-06-17,1200252,202025,10036,10035,1
2020-06-17,1200179,202025,10036,10036,0
2020-06-17,1200385,202025,10036,10036,0
2020-06-17,1200104,202025,10059,10036,23
2020-06-17,1200054,202025,10069,10059,10
2020-06-17,1200013,202025,10071,10069,2
2020-06-17,1200344,202025,10076,10071,5
2020-06-17,1200138,202025,10082,10076,6
2020-06-17,1200336,202025,10086,10082,4
2020-06-17,1200351,202025,10090,10086,4
2020-06-17,1200302,202025,10100,10090,10
2020-06-17,1200807,202025,10110,10100,10
2020-06-17,1200393,202025,10112,10110,2
2020-06-17,1200401,202025,10244,10112,132
2020-06-17,1200427,202025,10250,10244,6
2020-06-17,1200435,202025,10256,10250,6
2020-06-17,1200500,202025,10299,10256,43
2020-06-17,1200450,202025,10311,10299,12
2020-06-17,1200609,202025,10328,10311,17
2020-06-17,1200708,202025,10354,10328,26
2020-06-18,1200013,202025,10355,10354,1
2020-06-18,1200054,202025,10374,10355,19
2020-06-18,1200104,202025,10374,10374,0
2020-06-18,1200138,202025,10389,10374,15
2020-06-18,1200179,202025,10397,10389,8
2020-06-18,1200609,202025,10445,10397,48
2020-06-18,1200252,202025,10445,10445,0
2020-06-18,1200302,202025,10461,10445,16
2020-06-18,1200328,202025,10467,10461,6
2020-06-18,1200344,202025,10469,10467,2
2020-06-18,1200351,202025,10470,10469,1
2020-06-18,1200336,202025,10475,10470,5
2020-06-18,1200385,202025,10476,10475,1
2020-06-18,1200807,202025,10480,10476,4
2020-06-18,1200393,202025,10488,10480,8
2020-06-18,1200401,202025,10547,10488,59
2020-06-18,1200427,202025,10554,10547,7
2020-06-18,1200435,202025,10570,10554,16
2020-06-18,1200500,202025,10590,10570,20
2020-06-18,1200450,202025,10590,10590,0
2020-06-18,1200708,202025,10601,10590,11
2020-06-18,1200203,202025,10679,10601,78
2020-06-19,1200435,202025,10679,10679,0
2020-06-19,1200401,202025,10830,10679,151
2020-06-19,1200708,202025,10835,10830,5
2020-06-19,1200609,202025,10888,10835,53
2020-06-19,1200450,202025,10901,10888,13
2020-06-19,1200500,202025,10920,10901,19
2020-06-19,1200427,202025,10931,10920,11
2020-06-19,1200393,202025,10943,10931,12
2020-06-19,1200807,202025,10946,10943,3
2020-06-19,1200385,202025,10949,10946,3
2020-06-19,1200351,202025,10951,10949,2
2020-06-19,1200336,202025,10952,10951,1
2020-06-19,1200328,202025,10956,10952,4
2020-06-19,1200302,202025,10968,10956,12
2020-06-19,1200252,202025,10981,10968,13
2020-06-19,1200203,202025,10995,10981,14
2020-06-19,1200179,202025,10998,10995,3
2020-06-19,1200138,202025,10998,10998,0
2020-06-19,1200104,202025,10998,10998,0
2020-06-19,1200054,202025,11001,10998,3
2020-06-19,1200013,202025,11001,11001,0
2020-06-19,1200344,202025,11002,11001,1
2020-06-20,1200203,202025,11026,11002,24
2020-06-20,1200328,202025,11026,11026,0
2020-06-20,1200302,202025,11043,11026,17
2020-06-20,1200252,202025,11043,11043,0
2020-06-20,1200179,202025,11045,11043,2
2020-06-20,1200351,202025,11045,11045,0
2020-06-20,1200104,202025,11045,11045,0
2020-06-20,1200054,202025,11053,11045,8
2020-06-20,1200013,202025,11053,11053,0
2020-06-20,1200344,202025,11054,11053,1
2020-06-20,1200138,202025,11058,11054,4
2020-06-20,1200336,202025,11066,11058,8
2020-06-20,1200385,202025,11070,11066,4
2020-06-20,1200393,202025,11091,11070,21
2020-06-20,1200401,202025,11197,11091,106
2020-06-20,1200427,202025,11198,11197,1
2020-06-20,1200435,202025,11222,11198,24
2020-06-20,1200500,202025,11249,11222,27
2020-06-20,1200450,202025,11249,11249,0
2020-06-20,1200609,202025,11260,11249,11
2020-06-20,1200708,202025,11265,11260,5
2020-06-20,1200807,202025,11278,11265,13
2020-06-21,1200708,202026,11278,11278,0
2020-06-21,1200013,202026,11278,11278,0
2020-06-21,1200054,202026,11278,11278,0
2020-06-21,1200104,202026,11278,11278,0
2020-06-21,1200138,202026,11282,11278,4
2020-06-21,1200179,202026,11287,11282,5
2020-06-21,1200203,202026,11287,11287,0
2020-06-21,1200302,202026,11287,11287,0
2020-06-21,1200450,202026,11287,11287,0
2020-06-21,1200500,202026,11287,11287,0
2020-06-21,1200435,202026,11287,11287,0
2020-06-21,1200427,202026,11290,11287,3
2020-06-21,1200401,202026,11370,11290,80
2020-06-21,1200252,202026,11370,11370,0
2020-06-21,1200393,202026,11370,11370,0
2020-06-21,1200385,202026,11379,11370,9
2020-06-21,1200336,202026,11379,11379,0
2020-06-21,1200351,202026,11379,11379,0
2020-06-21,1200344,202026,11379,11379,0
2020-06-21,1200328,202026,11379,11379,0
2020-06-21,1200807,202026,11392,11379,13
2020-06-21,1200609,202026,11396,11392,4
2020-06-22,1200013,202026,11400,11396,4
2020-06-22,1200054,202026,11402,11400,2
2020-06-22,1200104,202026,11427,11402,25
2020-06-22,1200708,202026,11429,11427,2
2020-06-22,1200450,202026,11436,11429,7
2020-06-22,1200500,202026,11436,11436,0
2020-06-22,1200435,202026,11436,11436,0
2020-06-22,1200427,202026,11436,11436,0
2020-06-22,1200401,202026,11503,11436,67
2020-06-22,1200393,202026,11503,11503,0
2020-06-22,1200807,202026,11514,11503,11
2020-06-22,1200385,202026,11515,11514,1
2020-06-22,1200336,202026,11515,11515,0
2020-06-22,1200351,202026,11515,11515,0
2020-06-22,1200344,202026,11515,11515,0
2020-06-22,1200328,202026,11518,11515,3
2020-06-22,1200302,202026,11518,11518,0
2020-06-22,1200252,202026,11524,11518,6
2020-06-22,1200203,202026,11544,11524,20
2020-06-22,1200179,202026,11549,11544,5
2020-06-22,1200138,202026,11553,11549,4
2020-06-22,1200609,202026,11554,11553,1
2020-06-23,1200807,202026,11556,11554,2
2020-06-23,1200393,202026,11558,11556,2
2020-06-23,1200054,202026,11558,11558,0
2020-06-23,1200401,202026,11682,11558,124
2020-06-23,1200427,202026,11684,11682,2
2020-06-23,1200385,202026,11684,11684,0
2020-06-23,1200500,202026,11715,11684,31
2020-06-23,1200450,202026,11716,11715,1
2020-06-23,1200609,202026,11731,11716,15
2020-06-23,1200708,202026,11738,11731,7
2020-06-23,1200336,202026,11743,11738,5
2020-06-23,1200351,202026,11751,11743,8
2020-06-23,1200344,202026,11752,11751,1
2020-06-23,1200328,202026,11752,11752,0
2020-06-23,1200302,202026,11765,11752,13
2020-06-23,1200252,202026,11765,11765,0
2020-06-23,1200203,202026,11802,11765,37
2020-06-23,1200179,202026,11802,11802,0
2020-06-23,1200138,202026,11812,11802,10
2020-06-23,1200104,202026,11818,11812,6
2020-06-23,1200013,202026,11818,11818,0
2020-06-23,1200435,202026,11825,11818,7
2020-06-24,1200336,202026,11830,11825,5
2020-06-24,1200401,202026,11886,11830,56
2020-06-24,1200708,202026,11902,11886,16
2020-06-24,1200609,202026,11906,11902,4
2020-06-24,1200450,202026,11914,11906,8
2020-06-24,1200500,202026,11931,11914,17
2020-06-24,1200435,202026,11932,11931,1
2020-06-24,1200427,202026,11933,11932,1
2020-06-24,1200393,202026,11935,11933,2
2020-06-24,1200807,202026,11940,11935,5
2020-06-24,1200351,202026,11945,11940,5
2020-06-24,1200385,202026,11958,11945,13
2020-06-24,1200328,202026,11958,11958,0
2020-06-24,1200302,202026,11978,11958,20
2020-06-24,1200252,202026,11986,11978,8
2020-06-24,1200203,202026,12008,11986,22
2020-06-24,1200179,202026,12008,12008,0
2020-06-24,1200138,202026,12011,12008,3
2020-06-24,1200104,202026,12031,12011,20
2020-06-24,1200054,202026,12037,12031,6
2020-06-24,1200013,202026,12037,12037,0
2020-06-24,1200344,202026,12037,12037,0
2020-06-25,1200203,202026,12070,12037,33
2020-06-25,1200328,202026,12070,12070,0
2020-06-25,1200302,202026,12086,12070,16
2020-06-25,1200179,202026,12092,12086,6
2020-06-25,1200385,202026,12093,12092,1
2020-06-25,1200104,202026,12093,12093,0
2020-06-25,1200054,202026,12093,12093,0
2020-06-25,1200013,202026,12093,12093,0
2020-06-25,1200344,202026,12097,12093,4
2020-06-25,1200138,202026,12099,12097,2
2020-06-25,1200336,202026,12107,12099,8
2020-06-25,1200351,202026,12113,12107,6
2020-06-25,1200252,202026,12114,12113,1
2020-06-25,1200807,202026,12126,12114,12
2020-06-25,1200393,202026,12126,12126,0
2020-06-25,1200401,202026,12274,12126,148
2020-06-25,1200427,202026,12276,12274,2
2020-06-25,1200435,202026,12285,12276,9
2020-06-25,1200500,202026,12313,12285,28
2020-06-25,1200450,202026,12317,12313,4
2020-06-25,1200609,202026,12320,12317,3
2020-06-25,1200708,202026,12319,12320,-1
2020-06-26,1200013,202026,12326,12319,7
2020-06-26,1200054,202026,12350,12326,24
2020-06-26,1200104,202026,12378,12350,28
2020-06-26,1200138,202026,12387,12378,9
2020-06-26,1200179,202026,12394,12387,7
2020-06-26,1200609,202026,12448,12394,54
2020-06-26,1200252,202026,12448,12448,0
2020-06-26,1200302,202026,12460,12448,12
2020-06-26,1200328,202026,12460,12460,0
2020-06-26,1200344,202026,12460,12460,0
2020-06-26,1200351,202026,12462,12460,2
2020-06-26,1200336,202026,12463,12462,1
2020-06-26,1200385,202026,12468,12463,5
2020-06-26,1200807,202026,12476,12468,8
2020-06-26,1200393,202026,12476,12476,0
2020-06-26,1200401,202026,12594,12476,118
2020-06-26,1200427,202026,12601,12594,7
2020-06-26,1200435,202026,12603,12601,2
2020-06-26,1200500,202026,12623,12603,20
2020-06-26,1200450,202026,12631,12623,8
2020-06-26,1200708,202026,12635,12631,4
2020-06-26,1200203,202026,12659,12635,24
2020-06-27,1200435,202026,12662,12659,3
2020-06-27,1200013,202026,12662,12662,0
2020-06-27,1200708,202026,12662,12662,0
2020-06-27,1200609,202026,12665,12662,3
2020-06-27,1200450,202026,12666,12665,1
2020-06-27,1200500,202026,12696,12666,30
2020-06-27,1200401,202026,12845,12696,149
2020-06-27,1200393,202026,12845,12845,0
2020-06-27,1200807,202026,12859,12845,14
2020-06-27,1200385,202026,12861,12859,2
2020-06-27,1200336,202026,12865,12861,4
2020-06-27,1200427,202026,12866,12865,1
2020-06-27,1200344,202026,12866,12866,0
2020-06-27,1200328,202026,12871,12866,5
2020-06-27,1200302,202026,12886,12871,15
2020-06-27,1200252,202026,12886,12886,0
2020-06-27,1200203,202026,12909,12886,23
2020-06-27,1200179,202026,12914,12909,5
2020-06-27,1200138,202026,12923,12914,9
2020-06-27,1200104,202026,12928,12923,5
2020-06-27,1200054,202026,12928,12928,0
2020-06-27,1200351,202026,12928,12928,0
2020-06-28,1200344,202027,12928,12928,0
2020-06-28,1200328,202027,12928,12928,0
2020-06-28,1200302,202027,12929,12928,1
2020-06-28,1200252,202027,12929,12929,0
2020-06-28,1200203,202027,12948,12929,19
2020-06-28,1200013,202027,12948,12948,0
2020-06-28,1200138,202027,12957,12948,9
2020-06-28,1200104,202027,12957,12957,0
2020-06-28,1200054,202027,12960,12957,3
2020-06-28,1200351,202027,12960,12960,0
2020-06-28,1200179,202027,12962,12960,2
2020-06-28,1200336,202027,12962,12962,0
2020-06-28,1200385,202027,12970,12962,8
2020-06-28,1200393,202027,12970,12970,0
2020-06-28,1200401,202027,13063,12970,93
2020-06-28,1200427,202027,13062,13063,-1
2020-06-28,1200435,202027,13062,13062,0
2020-06-28,1200500,202027,13065,13062,3
2020-06-28,1200450,202027,13066,13065,1
2020-06-28,1200609,202027,13069,13066,3
2020-06-28,1200708,202027,13070,13069,1
2020-06-28,1200807,202027,13073,13070,3
2020-06-29,1200708,202027,13082,13073,9
2020-06-29,1200013,202027,13082,13082,0
2020-06-29,1200054,202027,13082,13082,0
2020-06-29,1200104,202027,13106,13082,24
2020-06-29,1200138,202027,13106,13106,0
2020-06-29,1200179,202027,13106,13106,0
2020-06-29,1200203,202027,13108,13106,2
2020-06-29,1200302,202027,13109,13108,1
2020-06-29,1200450,202027,13109,13109,0
2020-06-29,1200500,202027,13109,13109,0
2020-06-29,1200435,202027,13109,13109,0
2020-06-29,1200427,202027,13109,13109,0
2020-06-29,1200401,202027,13141,13109,32
2020-06-29,1200252,202027,13150,13141,9
2020-06-29,1200393,202027,13150,13150,0
2020-06-29,1200385,202027,13150,13150,0
2020-06-29,1200336,202027,13150,13150,0
2020-06-29,1200351,202027,13150,13150,0
2020-06-29,1200344,202027,13150,13150,0
2020-06-29,1200328,202027,13150,13150,0
2020-06-29,1200807,202027,13159,13150,9
2020-06-29,1200609,202027,13161,13159,2
2020-06-30,1200013,202027,13161,13161,0
2020-06-30,1200054,202027,13162,13161,1
2020-06-30,1200104,202027,13162,13162,0
2020-06-30,1200179,202027,13164,13162,2
2020-06-30,1200252,202027,13164,13164,0
2020-06-30,1200302,202027,13164,13164,0
2020-06-30,1200328,202027,13164,13164,0
2020-06-30,1200344,202027,13164,13164,0
2020-06-30,1200351,202027,13164,13164,0
2020-06-30,1200336,202027,13164,13164,0
2020-06-30,1200385,202027,13170,13164,6
2020-06-30,1200807,202027,13173,13170,3
2020-06-30,1200393,202027,13173,13173,0
2020-06-30,1200401,202027,13254,13173,81
2020-06-30,1200427,202027,13254,13254,0
2020-06-30,1200435,202027,13254,13254,0
2020-06-30,1200500,202027,13255,13254,1
2020-06-30,1200203,202027,13263,13255,8
2020-06-30,1200450,202027,13263,13263,0
2020-06-30,1200609,202027,13265,13263,2
2020-06-30,1200708,202027,13265,13265,0
2020-06-30,1200138,202027,13268,13265,3
2020-07-01,1200013,202027,13270,13268,2
2020-07-01,1200054,202027,13281,13270,11
2020-07-01,1200104,202027,13344,13281,63
2020-07-01,1200138,202027,13367,13344,23
2020-07-01,1200179,202027,13367,13367,0
2020-07-01,1200203,202027,13397,13367,30
2020-07-01,1200252,202027,13412,13397,15
2020-07-01,1200302,202027,13452,13412,40
2020-07-01,1200328,202027,13456,13452,4
2020-07-01,1200344,202027,13458,13456,2
2020-07-01,1200351,202027,13471,13458,13
2020-07-01,1200385,202027,13476,13471,5
2020-07-01,1200393,202027,13476,13476,0
2020-07-01,1200807,202027,13480,13476,4
2020-07-01,1200401,202027,13629,13480,149
2020-07-01,1200427,202027,13629,13629,0
2020-07-01,1200435,202027,13631,13629,2
2020-07-01,1200500,202027,13668,13631,37
2020-07-01,1200450,202027,13674,13668,6
2020-07-01,1200609,202027,13704,13674,30
2020-07-01,1200708,202027,13710,13704,6
2020-07-01,1200336,202027,13730,13710,20
2020-07-02,1200013,202027,13735,13730,5
2020-07-02,1200054,202027,13745,13735,10
2020-07-02,1200104,202027,13760,13745,15
2020-07-02,1200138,202027,13768,13760,8
2020-07-02,1200179,202027,13769,13768,1
2020-07-02,1200203,202027,13806,13769,37
2020-07-02,1200708,202027,13820,13806,14
2020-07-02,1200328,202027,13820,13820,0
2020-07-02,1200344,202027,13821,13820,1
2020-07-02,1200351,202027,13826,13821,5
2020-07-02,1200336,202027,13834,13826,8
2020-07-02,1200385,202027,13835,13834,1
2020-07-02,1200807,202027,13836,13835,1
2020-07-02,1200393,202027,13836,13836,0
2020-07-02,1200401,202027,13989,13836,153
2020-07-02,1200427,202027,13991,13989,2
2020-07-02,1200435,202027,13994,13991,3
2020-07-02,1200500,202027,14006,13994,12
2020-07-02,1200450,202027,14008,14006,2
2020-07-02,1200609,202027,14048,14008,40
2020-07-02,1200302,202027,14055,14048,7
2020-07-02,1200252,202027,14063,14055,8
2020-07-03,1200435,202027,14063,14063,0
2020-07-03,1200393,202027,14063,14063,0
2020-07-03,1200708,202027,14063,14063,0
2020-07-03,1200609,202027,14063,14063,0
2020-07-03,1200450,202027,14063,14063,0
2020-07-03,1200500,202027,14073,14063,10
2020-07-03,1200427,202027,14074,14073,1
2020-07-03,1200401,202027,14118,14074,44
2020-07-03,1200807,202027,14119,14118,1
2020-07-03,1200385,202027,14125,14119,6
2020-07-03,1200351,202027,14125,14125,0
2020-07-03,1200336,202027,14125,14125,0
2020-07-03,1200328,202027,14125,14125,0
2020-07-03,1200302,202027,14125,14125,0
2020-07-03,1200252,202027,14125,14125,0
2020-07-03,1200203,202027,14126,14125,1
2020-07-03,1200179,202027,14127,14126,1
2020-07-03,1200138,202027,14127,14127,0
2020-07-03,1200104,202027,14127,14127,0
2020-07-03,1200054,202027,14127,14127,0
2020-07-03,1200013,202027,14127,14127,0
2020-07-03,1200344,202027,14127,14127,0
2020-07-04,1200203,202027,14175,14127,48
2020-07-04,1200302,202027,14190,14175,15
2020-07-04,1200252,202027,14195,14190,5
2020-07-04,1200179,202027,14202,14195,7
2020-07-04,1200351,202027,14213,14202,11
2020-07-04,1200104,202027,14229,14213,16
2020-07-04,1200054,202027,14229,14229,0
2020-07-04,1200013,202027,14229,14229,0
2020-07-04,1200328,202027,14229,14229,0
2020-07-04,1200138,202027,14247,14229,18
2020-07-04,1200336,202027,14253,14247,6
2020-07-04,1200344,202027,14253,14253,0
2020-07-04,1200385,202027,14256,14253,3
2020-07-04,1200807,202027,14266,14256,10
2020-07-04,1200393,202027,14266,14266,0
2020-07-04,1200401,202027,14410,14266,144
2020-07-04,1200427,202027,14410,14410,0
2020-07-04,1200435,202027,14412,14410,2
2020-07-04,1200500,202027,14423,14412,11
2020-07-04,1200450,202027,14424,14423,1
2020-07-04,1200609,202027,14489,14424,65
2020-07-04,1200708,202027,14502,14489,13
2020-07-05,1200013,202028,14504,14502,2
2020-07-05,1200054,202028,14504,14504,0
2020-07-05,1200104,202028,14509,14504,5
2020-07-05,1200138,202028,14511,14509,2
2020-07-05,1200179,202028,14513,14511,2
2020-07-05,1200609,202028,14518,14513,5
2020-07-05,1200252,202028,14521,14518,3
2020-07-05,1200302,202028,14527,14521,6
2020-07-05,1200328,202028,14528,14527,1
2020-07-05,1200344,202028,14529,14528,1
2020-07-05,1200351,202028,14529,14529,0
2020-07-05,1200336,202028,14529,14529,0
2020-07-05,1200385,202028,14526,14529,-3
2020-07-05,1200807,202028,14531,14526,5
2020-07-05,1200393,202028,14531,14531,0
2020-07-05,1200401,202028,14616,14531,85
2020-07-05,1200427,202028,14616,14616,0
2020-07-05,1200435,202028,14616,14616,0
2020-07-05,1200500,202028,14622,14616,6
2020-07-05,1200450,202028,14629,14622,7
2020-07-05,1200708,202028,14634,14629,5
2020-07-05,1200203,202028,14637,14634,3
2020-07-06,1200336,202028,14637,14637,0
2020-07-06,1200427,202028,14637,14637,0
2020-07-06,1200708,202028,14637,14637,0
2020-07-06,1200609,202028,14637,14637,0
2020-07-06,1200450,202028,14638,14637,1
2020-07-06,1200500,202028,14638,14638,0
2020-07-06,1200435,202028,14638,14638,0
2020-07-06,1200401,202028,14686,14638,48
2020-07-06,1200393,202028,14686,14686,0
2020-07-06,1200807,202028,14686,14686,0
2020-07-06,1200351,202028,14686,14686,0
2020-07-06,1200385,202028,14686,14686,0
2020-07-06,1200328,202028,14686,14686,0
2020-07-06,1200302,202028,14699,14686,13
2020-07-06,1200252,202028,14699,14699,0
2020-07-06,1200203,202028,14700,14699,1
2020-07-06,1200179,202028,14702,14700,2
2020-07-06,1200138,202028,14702,14702,0
2020-07-06,1200104,202028,14703,14702,1
2020-07-06,1200054,202028,14703,14703,0
2020-07-06,1200013,202028,14703,14703,0
2020-07-06,1200344,202028,14703,14703,0
2020-07-07,1200203,202028,14714,14703,11
2020-07-07,1200344,202028,14714,14714,0
2020-07-07,1200328,202028,14715,14714,1
2020-07-07,1200302,202028,14721,14715,6
2020-07-07,1200179,202028,14723,14721,2
2020-07-07,1200385,202028,14723,14723,0
2020-07-07,1200104,202028,14744,14723,21
2020-07-07,1200054,202028,14754,14744,10
2020-07-07,1200013,202028,14764,14754,10
2020-07-07,1200351,202028,14768,14764,4
2020-07-07,1200138,202028,14773,14768,5
2020-07-07,1200336,202028,14783,14773,10
2020-07-07,1200252,202028,14792,14783,9
2020-07-07,1200807,202028,14794,14792,2
2020-07-07,1200393,202028,14810,14794,16
2020-07-07,1200401,202028,14884,14810,74
2020-07-07,1200427,202028,14885,14884,1
2020-07-07,1200435,202028,14890,14885,5
2020-07-07,1200500,202028,14895,14890,5
2020-07-07,1200450,202028,14901,14895,6
2020-07-07,1200609,202028,14940,14901,39
2020-07-07,1200708,202028,14956,14940,16
2020-07-08,1200708,202028,14956,14956,0
2020-07-08,1200013,202028,14956,14956,0
2020-07-08,1200054,202028,14957,14956,1
2020-07-08,1200104,202028,14966,14957,9
2020-07-08,1200138,202028,14977,14966,11
2020-07-08,1200179,202028,14977,14977,0
2020-07-08,1200203,202028,14989,14977,12
2020-07-08,1200807,202028,14991,14989,2
2020-07-08,1200450,202028,14992,14991,1
2020-07-08,1200500,202028,15031,14992,39
2020-07-08,1200435,202028,15034,15031,3
2020-07-08,1200427,202028,15034,15034,0
2020-07-08,1200401,202028,15163,15034,129
2020-07-08,1200393,202028,15163,15163,0
2020-07-08,1200252,202028,15165,15163,2
2020-07-08,1200609,202028,15165,15165,0
2020-07-08,1200336,202028,15166,15165,1
2020-07-08,1200351,202028,15168,15166,2
2020-07-08,1200344,202028,15168,15168,0
2020-07-08,1200328,202028,15168,15168,0
2020-07-08,1200302,202028,15173,15168,5
2020-07-08,1200385,202028,15182,15173,9
2020-07-09,1200054,202028,15186,15182,4
2020-07-09,1200013,202028,15187,15186,1
2020-07-09,1200104,202028,15190,15187,3
2020-07-09,1200708,202028,15191,15190,1
2020-07-09,1200450,202028,15194,15191,3
2020-07-09,1200500,202028,15232,15194,38
2020-07-09,1200435,202028,15238,15232,6
2020-07-09,1200427,202028,15240,15238,2
2020-07-09,1200401,202028,15326,15240,86
2020-07-09,1200393,202028,15346,15326,20
2020-07-09,1200807,202028,15354,15346,8
2020-07-09,1200385,202028,15365,15354,11
2020-07-09,1200336,202028,15380,15365,15
2020-07-09,1200351,202028,15387,15380,7
2020-07-09,1200344,202028,15390,15387,3
2020-07-09,1200328,202028,15390,15390,0
2020-07-09,1200302,202028,15418,15390,28
2020-07-09,1200252,202028,15424,15418,6
2020-07-09,1200203,202028,15458,15424,34
2020-07-09,1200179,202028,15465,15458,7
2020-07-09,1200138,202028,15477,15465,12
2020-07-09,1200609,202028,15480,15477,3
2020-07-10,1200807,202028,15482,15480,2
2020-07-10,1200393,202028,15482,15482,0
2020-07-10,1200054,202028,15492,15482,10
2020-07-10,1200401,202028,15621,15492,129
2020-07-10,1200427,202028,15624,15621,3
2020-07-10,1200385,202028,15624,15624,0
2020-07-10,1200500,202028,15634,15624,10
2020-07-10,1200450,202028,15634,15634,0
2020-07-10,1200609,202028,15644,15634,10
2020-07-10,1200708,202028,15661,15644,17
2020-07-10,1200336,202028,15663,15661,2
2020-07-10,1200351,202028,15672,15663,9
2020-07-10,1200344,202028,15676,15672,4
2020-07-10,1200328,202028,15683,15676,7
2020-07-10,1200302,202028,15692,15683,9
2020-07-10,1200252,202028,15710,15692,18
2020-07-10,1200203,202028,15753,15710,43
2020-07-10,1200179,202028,15754,15753,1
2020-07-10,1200138,202028,15756,15754,2
2020-07-10,1200104,202028,15775,15756,19
2020-07-10,1200013,202028,15785,15775,10
2020-07-10,1200435,202028,15783,15785,-2
2020-07-11,1200435,202028,15783,15783,0
2020-07-11,1200708,202028,15791,15783,8
2020-07-11,1200500,202028,15802,15791,11
2020-07-11,1200427,202028,15807,15802,5
2020-07-11,1200401,202028,15872,15807,65
2020-07-11,1200393,202028,15889,15872,17
2020-07-11,1200807,202028,15896,15889,7
2020-07-11,1200385,202028,15904,15896,8
2020-07-11,1200336,202028,15927,15904,23
2020-07-11,1200351,202028,15929,15927,2
2020-07-11,1200344,202028,15929,15929,0
2020-07-11,1200328,202028,15934,15929,5
2020-07-11,1200302,202028,15969,15934,35
2020-07-11,1200252,202028,15972,15969,3
2020-07-11,1200203,202028,16049,15972,77
2020-07-11,1200179,202028,16056,16049,7
2020-07-11,1200138,202028,16061,16056,5
2020-07-11,1200104,202028,16072,16061,11
2020-07-11,1200054,202028,16075,16072,3
2020-07-11,1200450,202028,16078,16075,3
2020-07-11,1200609,202028,16095,16078,17
2020-07-11,1200013,202028,16095,16095,0
2020-07-12,1200336,202029,16095,16095,0
2020-07-12,1200807,202029,16095,16095,0
2020-07-12,1200393,202029,16095,16095,0
2020-07-12,1200401,202029,16145,16095,50
2020-07-12,1200427,202029,16145,16145,0
2020-07-12,1200435,202029,16145,16145,0
2020-07-12,1200500,202029,16149,16145,4
2020-07-12,1200450,202029,16150,16149,1
2020-07-12,1200609,202029,16152,16150,2
2020-07-12,1200708,202029,16152,16152,0
2020-07-12,1200351,202029,16152,16152,0
2020-07-12,1200344,202029,16153,16152,1
2020-07-12,1200328,202029,16155,16153,2
2020-07-12,1200302,202029,16180,16155,25
2020-07-12,1200252,202029,16180,16180,0
2020-07-12,1200203,202029,16195,16180,15
2020-07-12,1200179,202029,16202,16195,7
2020-07-12,1200138,202029,16205,16202,3
2020-07-12,1200104,202029,16205,16205,0
2020-07-12,1200054,202029,16205,16205,0
2020-07-12,1200013,202029,16205,16205,0
2020-07-12,1200385,202029,16205,16205,0
2020-07-13,1200500,202029,16206,16205,1
2020-07-13,1200054,202029,16206,16206,0
2020-07-13,1200708,202029,16206,16206,0
2020-07-13,1200609,202029,16208,16206,2
2020-07-13,1200450,202029,16208,16208,0
2020-07-13,1200435,202029,16208,16208,0
2020-07-13,1200401,202029,16259,16208,51
2020-07-13,1200393,202029,16259,16259,0
2020-07-13,1200807,202029,16262,16259,3
2020-07-13,1200385,202029,16262,16262,0
2020-07-13,1200336,202029,16263,16262,1
2020-07-13,1200427,202029,16263,16263,0
2020-07-13,1200344,202029,16263,16263,0
2020-07-13,1200328,202029,16263,16263,0
2020-07-13,1200302,202029,16263,16263,0
2020-07-13,1200252,202029,16263,16263,0
2020-07-13,1200203,202029,16275,16263,12
2020-07-13,1200179,202029,16275,16275,0
2020-07-13,1200138,202029,16275,16275,0
2020-07-13,1200104,202029,16275,16275,0
2020-07-13,1200013,202029,16275,16275,0
2020-07-13,1200351,202029,16275,16275,0
2020-07-14,1200344,202029,16284,16275,9
2020-07-14,1200328,202029,16286,16284,2
2020-07-14,1200302,202029,16291,16286,5
2020-07-14,1200252,202029,16309,16291,18
2020-07-14,1200203,202029,16314,16309,5
2020-07-14,1200013,202029,16319,16314,5
2020-07-14,1200138,202029,16319,16319,0
2020-07-14,1200104,202029,16346,16319,27
2020-07-14,1200054,202029,16349,16346,3
2020-07-14,1200351,202029,16360,16349,11
2020-07-14,1200179,202029,16360,16360,0
2020-07-14,1200336,202029,16366,16360,6
2020-07-14,1200385,202029,16366,16366,0
2020-07-14,1200393,202029,16366,16366,0
2020-07-14,1200401,202029,16419,16366,53
2020-07-14,1200427,202029,16421,16419,2
2020-07-14,1200435,202029,16422,16421,1
2020-07-14,1200500,202029,16451,16422,29
2020-07-14,1200450,202029,16452,16451,1
2020-07-14,1200609,202029,16483,16452,31
2020-07-14,1200708,202029,16490,16483,7
2020-07-14,1200807,202029,16494,16490,4
2020-07-15,1200708,202029,16500,16494,6
2020-07-15,1200013,202029,16502,16500,2
2020-07-15,1200054,202029,16506,16502,4
2020-07-15,1200104,202029,16528,16506,22
2020-07-15,1200138,202029,16529,16528,1
2020-07-15,1200179,202029,16529,16529,0
2020-07-15,1200203,202029,16549,16529,20
2020-07-15,1200302,202029,16568,16549,19
2020-07-15,1200450,202029,16574,16568,6
2020-07-15,1200500,202029,16584,16574,10
2020-07-15,1200435,202029,16584,16584,0
2020-07-15,1200427,202029,16586,16584,2
2020-07-15,1200401,202029,16646,16586,60
2020-07-15,1200252,202029,16655,16646,9
2020-07-15,1200393,202029,16666,16655,11
2020-07-15,1200385,202029,16666,16666,0
2020-07-15,1200336,202029,16672,16666,6
2020-07-15,1200351,202029,16676,16672,4
2020-07-15,1200344,202029,16683,16676,7
2020-07-15,1200328,202029,16685,16683,2
2020-07-15,1200807,202029,16685,16685,0
2020-07-15,1200609,202029,16687,16685,2
2020-07-16,1200013,202029,16695,16687,8
2020-07-16,1200054,202029,16697,16695,2
2020-07-16,1200104,202029,16737,16697,40
2020-07-16,1200435,202029,16738,16737,1
2020-07-16,1200427,202029,16738,16738,0
2020-07-16,1200138,202029,16747,16738,9
2020-07-16,1200500,202029,16758,16747,11
2020-07-16,1200450,202029,16761,16758,3
2020-07-16,1200609,202029,16768,16761,7
2020-07-16,1200708,202029,16773,16768,5
2020-07-16,1200807,202029,16777,16773,4
2020-07-16,1200385,202029,16781,16777,4
2020-07-16,1200336,202029,16788,16781,7
2020-07-16,1200351,202029,16793,16788,5
2020-07-16,1200344,202029,16794,16793,1
2020-07-16,1200328,202029,16795,16794,1
2020-07-16,1200302,202029,16824,16795,29
2020-07-16,1200252,202029,16825,16824,1
2020-07-16,1200203,202029,16824,16825,-1
2020-07-16,1200179,202029,16824,16824,0
2020-07-16,1200401,202029,16875,16824,51
2020-07-16,1200393,202029,16880,16875,5
2020-07-17,1200385,202029,16881,16880,1
2020-07-17,1200393,202029,16881,16881,0
2020-07-17,1200054,202029,16881,16881,0
2020-07-17,1200104,202029,16881,16881,0
2020-07-17,1200807,202029,16883,16881,2
2020-07-17,1200138,202029,16883,16883,0
2020-07-17,1200179,202029,16884,16883,1
2020-07-17,1200203,202029,16892,16884,8
2020-07-17,1200252,202029,16892,16892,0
2020-07-17,1200302,202029,16919,16892,27
2020-07-17,1200328,202029,16919,16919,0
2020-07-17,1200344,202029,16919,16919,0
2020-07-17,1200013,202029,16919,16919,0
2020-07-17,1200351,202029,16919,16919,0
2020-07-17,1200336,202029,16919,16919,0
2020-07-17,1200427,202029,16919,16919,0
2020-07-17,1200500,202029,16927,16919,8
2020-07-17,1200450,202029,16927,16927,0
2020-07-17,1200609,202029,16930,16927,3
2020-07-17,1200708,202029,16930,16930,0
2020-07-17,1200401,202029,16980,16930,50
2020-07-17,1200435,202029,16980,16980,0
2020-07-18,1200013,202029,16990,16980,10
2020-07-18,1200054,202029,16995,16990,5
2020-07-18,1200104,202029,17001,16995,6
2020-07-18,1200138,202029,17002,17001,1
2020-07-18,1200179,202029,17012,17002,10
2020-07-18,1200203,202029,17023,17012,11
2020-07-18,1200252,202029,17032,17023,9
2020-07-18,1200328,202029,17032,17032,0
2020-07-18,1200302,202029,17043,17032,11
2020-07-18,1200351,202029,17055,17043,12
2020-07-18,1200336,202029,17083,17055,28
2020-07-18,1200385,202029,17086,17083,3
2020-07-18,1200807,202029,17088,17086,2
2020-07-18,1200393,202029,17088,17088,0
2020-07-18,1200401,202029,17166,17088,78
2020-07-18,1200427,202029,17166,17166,0
2020-07-18,1200435,202029,17169,17166,3
2020-07-18,1200500,202029,17178,17169,9
2020-07-18,1200450,202029,17195,17178,17
2020-07-18,1200609,202029,17208,17195,13
2020-07-18,1200708,202029,17216,17208,8
2020-07-18,1200344,202029,17217,17216,1
2020-07-19,1200104,202030,17233,17217,16
2020-07-19,1200179,202030,17233,17233,0
2020-07-19,1200138,202030,17235,17233,2
2020-07-19,1200013,202030,17235,17235,0
2020-07-19,1200054,202030,17242,17235,7
2020-07-19,1200450,202030,17246,17242,4
2020-07-19,1200609,202030,17247,17246,1
2020-07-19,1200708,202030,17247,17247,0
2020-07-19,1200435,202030,17247,17247,0
2020-07-19,1200427,202030,17247,17247,0
2020-07-19,1200401,202030,17268,17247,21
2020-07-19,1200393,202030,17268,17268,0
2020-07-19,1200807,202030,17275,17268,7
2020-07-19,1200385,202030,17276,17275,1
2020-07-19,1200336,202030,17276,17276,0
2020-07-19,1200351,202030,17276,17276,0
2020-07-19,1200344,202030,17276,17276,0
2020-07-19,1200328,202030,17276,17276,0
2020-07-19,1200302,202030,17283,17276,7
2020-07-19,1200252,202030,17291,17283,8
2020-07-19,1200203,202030,17297,17291,6
2020-07-19,1200500,202030,17310,17297,13
2020-07-20,1200393,202030,17310,17310,0
2020-07-20,1200427,202030,17312,17310,2
2020-07-20,1200054,202030,17312,17312,0
2020-07-20,1200104,202030,17312,17312,0
2020-07-20,1200138,202030,17319,17312,7
2020-07-20,1200179,202030,17319,17319,0
2020-07-20,1200203,202030,17362,17319,43
2020-07-20,1200401,202030,17427,17362,65
2020-07-20,1200252,202030,17429,17427,2
2020-07-20,1200302,202030,17471,17429,42
2020-07-20,1200328,202030,17471,17471,0
2020-07-20,1200344,202030,17471,17471,0
2020-07-20,1200351,202030,17471,17471,0
2020-07-20,1200336,202030,17474,17471,3
2020-07-20,1200013,202030,17474,17474,0
2020-07-20,1200385,202030,17475,17474,1
2020-07-20,1200807,202030,17475,17475,0
2020-07-20,1200435,202030,17475,17475,0
2020-07-20,1200500,202030,17473,17475,-2
2020-07-20,1200450,202030,17473,17473,0
2020-07-20,1200609,202030,17477,17473,4
2020-07-20,1200708,202030,17477,17477,0
2020-07-21,1200435,202030,17477,17477,0
2020-07-21,1200393,202030,17503,17477,26
2020-07-21,1200500,202030,17535,17503,32
2020-07-21,1200450,202030,17535,17535,0
2020-07-21,1200609,202030,17573,17535,38
2020-07-21,1200708,202030,17582,17573,9
2020-07-21,1200807,202030,17583,17582,1
2020-07-21,1200385,202030,17587,17583,4
2020-07-21,1200336,202030,17595,17587,8
2020-07-21,1200351,202030,17602,17595,7
2020-07-21,1200302,202030,17613,17602,11
2020-07-21,1200328,202030,17614,17613,1
2020-07-21,1200427,202030,17620,17614,6
2020-07-21,1200252,202030,17627,17620,7
2020-07-21,1200203,202030,17612,17627,-15
2020-07-21,1200179,202030,17615,17612,3
2020-07-21,1200138,202030,17617,17615,2
2020-07-21,1200104,202030,17617,17617,0
2020-07-21,1200054,202030,17617,17617,0
2020-07-21,1200013,202030,17618,17617,1
2020-07-21,1200344,202030,17634,17618,16
2020-07-21,1200401,202030,17715,17634,81
2020-07-22,1200252,202030,17718,17715,3
2020-07-22,1200013,202030,17718,17718,0
2020-07-22,1200302,202030,17724,17718,6
2020-07-22,1200328,202030,17725,17724,1
2020-07-22,1200344,202030,17731,17725,6
2020-07-22,1200351,202030,17733,17731,2
2020-07-22,1200336,202030,17752,17733,19
2020-07-22,1200385,202030,17752,17752,0
2020-07-22,1200179,202030,17754,17752,2
2020-07-22,1200393,202030,17754,17754,0
2020-07-22,1200203,202030,17845,17754,91
2020-07-22,1200401,202030,17904,17845,59
2020-07-22,1200435,202030,17907,17904,3
2020-07-22,1200500,202030,17926,17907,19
2020-07-22,1200450,202030,17928,17926,2
2020-07-22,1200609,202030,17949,17928,21
2020-07-22,1200708,202030,17954,17949,5
2020-07-22,1200138,202030,17957,17954,3
2020-07-22,1200104,202030,17973,17957,16
2020-07-22,1200054,202030,17990,17973,17
2020-07-22,1200427,202030,17993,17990,3
2020-07-22,1200807,202030,17994,17993,1
2020-07-23,1200302,202030,17997,17994,3
2020-07-23,1200401,202030,18016,17997,19
2020-07-23,1200708,202030,18023,18016,7
2020-07-23,1200609,202030,18057,18023,34
2020-07-23,1200450,202030,18065,18057,8
2020-07-23,1200500,202030,18080,18065,15
2020-07-23,1200435,202030,18081,18080,1
2020-07-23,1200427,202030,18081,18081,0
2020-07-23,1200393,202030,18089,18081,8
2020-07-23,1200807,202030,18090,18089,1
2020-07-23,1200336,202030,18095,18090,5
2020-07-23,1200385,202030,18098,18095,3
2020-07-23,1200344,202030,18105,18098,7
2020-07-23,1200328,202030,18105,18105,0
2020-07-23,1200252,202030,18107,18105,2
2020-07-23,1200203,202030,18160,18107,53
2020-07-23,1200179,202030,18162,18160,2
2020-07-23,1200138,202030,18164,18162,2
2020-07-23,1200104,202030,18168,18164,4
2020-07-23,1200054,202030,18171,18168,3
2020-07-23,1200013,202030,18171,18171,0
2020-07-23,1200351,202030,18172,18171,1
2020-07-24,1200252,202030,18190,18172,18
2020-07-24,1200328,202030,18194,18190,4
2020-07-24,1200302,202030,18195,18194,1
2020-07-24,1200203,202030,18202,18195,7
2020-07-24,1200385,202030,18203,18202,1
2020-07-24,1200138,202030,18207,18203,4
2020-07-24,1200054,202030,18218,18207,11
2020-07-24,1200013,202030,18223,18218,5
2020-07-24,1200344,202030,18232,18223,9
2020-07-24,1200179,202030,18232,18232,0
2020-07-24,1200336,202030,18242,18232,10
2020-07-24,1200351,202030,18245,18242,3
2020-07-24,1200104,202030,18290,18245,45
2020-07-24,1200807,202030,18290,18290,0
2020-07-24,1200393,202030,18305,18290,15
2020-07-24,1200401,202030,18328,18305,23
2020-07-24,1200427,202030,18328,18328,0
2020-07-24,1200435,202030,18329,18328,1
2020-07-24,1200500,202030,18344,18329,15
2020-07-24,1200450,202030,18353,18344,9
2020-07-24,1200609,202030,18391,18353,38
2020-07-24,1200708,202030,18408,18391,17
2020-07-25,1200013,202030,18408,18408,0
2020-07-25,1200054,202030,18412,18408,4
2020-07-25,1200104,202030,18441,18412,29
2020-07-25,1200138,202030,18445,18441,4
2020-07-25,1200179,202030,18449,18445,4
2020-07-25,1200609,202030,18475,18449,26
2020-07-25,1200252,202030,18475,18475,0
2020-07-25,1200302,202030,18502,18475,27
2020-07-25,1200328,202030,18508,18502,6
2020-07-25,1200344,202030,18516,18508,8
2020-07-25,1200351,202030,18518,18516,2
2020-07-25,1200336,202030,18519,18518,1
2020-07-25,1200385,202030,18522,18519,3
2020-07-25,1200807,202030,18530,18522,8
2020-07-25,1200393,202030,18544,18530,14
2020-07-25,1200401,202030,18618,18544,74
2020-07-25,1200427,202030,18618,18618,0
2020-07-25,1200435,202030,18621,18618,3
2020-07-25,1200500,202030,18645,18621,24
2020-07-25,1200450,202030,18645,18645,0
2020-07-25,1200708,202030,18650,18645,5
2020-07-25,1200203,202030,18672,18650,22
2020-07-26,1200500,202031,18672,18672,0
2020-07-26,1200054,202031,18672,18672,0
2020-07-26,1200708,202031,18672,18672,0
2020-07-26,1200609,202031,18678,18672,6
2020-07-26,1200450,202031,18678,18678,0
2020-07-26,1200435,202031,18678,18678,0
2020-07-26,1200401,202031,18738,18678,60
2020-07-26,1200393,202031,18738,18738,0
2020-07-26,1200807,202031,18740,18738,2
2020-07-26,1200385,202031,18740,18740,0
2020-07-26,1200336,202031,18740,18740,0
2020-07-26,1200427,202031,18740,18740,0
2020-07-26,1200344,202031,18740,18740,0
2020-07-26,1200328,202031,18740,18740,0
2020-07-26,1200302,202031,18756,18740,16
2020-07-26,1200252,202031,18756,18756,0
2020-07-26,1200203,202031,18760,18756,4
2020-07-26,1200179,202031,18760,18760,0
2020-07-26,1200138,202031,18760,18760,0
2020-07-26,1200104,202031,18760,18760,0
2020-07-26,1200013,202031,18760,18760,0
2020-07-26,1200351,202031,18760,18760,0
2020-07-27,1200344,202031,18760,18760,0
2020-07-27,1200328,202031,18760,18760,0
2020-07-27,1200302,202031,18762,18760,2
2020-07-27,1200252,202031,18762,18762,0
2020-07-27,1200203,202031,18763,18762,1
2020-07-27,1200013,202031,18764,18763,1
2020-07-27,1200138,202031,18770,18764,6
2020-07-27,1200104,202031,18770,18770,0
2020-07-27,1200054,202031,18771,18770,1
2020-07-27,1200351,202031,18771,18771,0
2020-07-27,1200179,202031,18772,18771,1
2020-07-27,1200336,202031,18772,18772,0
2020-07-27,1200385,202031,18773,18772,1
2020-07-27,1200807,202031,18773,18773,0
2020-07-27,1200393,202031,18773,18773,0
2020-07-27,1200401,202031,18795,18773,22
2020-07-27,1200427,202031,18795,18795,0
2020-07-27,1200435,202031,18796,18795,1
2020-07-27,1200500,202031,18796,18796,0
2020-07-27,1200450,202031,18797,18796,1
2020-07-27,1200609,202031,18798,18797,1
2020-07-27,1200708,202031,18798,18798,0
2020-07-28,1200708,202031,18812,18798,14
2020-07-28,1200013,202031,18829,18812,17
2020-07-28,1200054,202031,18853,18829,24
2020-07-28,1200104,202031,18901,18853,48
2020-07-28,1200138,202031,18903,18901,2
2020-07-28,1200179,202031,18903,18903,0
2020-07-28,1200203,202031,18933,18903,30
2020-07-28,1200807,202031,19000,18933,67
2020-07-28,1200450,202031,19011,19000,11
2020-07-28,1200500,202031,19032,19011,21
2020-07-28,1200435,202031,19032,19032,0
2020-07-28,1200427,202031,19033,19032,1
2020-07-28,1200401,202031,19065,19033,32
2020-07-28,1200393,202031,19065,19065,0
2020-07-28,1200252,202031,19090,19065,25
2020-07-28,1200609,202031,19124,19090,34
2020-07-28,1200336,202031,19126,19124,2
2020-07-28,1200351,202031,19131,19126,5
2020-07-28,1200344,202031,19144,19131,13
2020-07-28,1200328,202031,19144,19144,0
2020-07-28,1200302,202031,19144,19144,0
2020-07-28,1200385,202031,19147,19144,3
2020-07-29,1200054,202031,19153,19147,6
2020-07-29,1200013,202031,19152,19153,-1
2020-07-29,1200104,202031,19155,19152,3
2020-07-29,1200708,202031,19169,19155,14
2020-07-29,1200450,202031,19169,19169,0
2020-07-29,1200500,202031,19194,19169,25
2020-07-29,1200435,202031,19194,19194,0
2020-07-29,1200427,202031,19195,19194,1
2020-07-29,1200401,202031,19219,19195,24
2020-07-29,1200393,202031,19235,19219,16
2020-07-29,1200807,202031,19238,19235,3
2020-07-29,1200385,202031,19238,19238,0
2020-07-29,1200336,202031,19272,19238,34
2020-07-29,1200351,202031,19274,19272,2
2020-07-29,1200344,202031,19278,19274,4
2020-07-29,1200328,202031,19278,19278,0
2020-07-29,1200302,202031,19283,19278,5
2020-07-29,1200252,202031,19292,19283,9
2020-07-29,1200203,202031,19343,19292,51
2020-07-29,1200179,202031,19344,19343,1
2020-07-29,1200138,202031,19349,19344,5
2020-07-29,1200609,202031,19381,19349,32
2020-07-30,1200807,202031,19381,19381,0
2020-07-30,1200393,202031,19398,19381,17
2020-07-30,1200054,202031,19403,19398,5
2020-07-30,1200401,202031,19439,19403,36
2020-07-30,1200427,202031,19440,19439,1
2020-07-30,1200385,202031,19440,19440,0
2020-07-30,1200500,202031,19456,19440,16
2020-07-30,1200450,202031,19460,19456,4
2020-07-30,1200609,202031,19475,19460,15
2020-07-30,1200708,202031,19485,19475,10
2020-07-30,1200336,202031,19505,19485,20
2020-07-30,1200351,202031,19507,19505,2
2020-07-30,1200344,202031,19513,19507,6
2020-07-30,1200328,202031,19513,19513,0
2020-07-30,1200302,202031,19520,19513,7
2020-07-30,1200252,202031,19537,19520,17
2020-07-30,1200203,202031,19548,19537,11
2020-07-30,1200179,202031,19548,19548,0
2020-07-30,1200138,202031,19552,19548,4
2020-07-30,1200104,202031,19580,19552,28
2020-07-30,1200013,202031,19587,19580,7
2020-07-30,1200435,202031,19588,19587,1
2020-07-31,1200435,202031,19588,19588,0
2020-07-31,1200708,202031,19588,19588,0
2020-07-31,1200500,202031,19588,19588,0
2020-07-31,1200427,202031,19588,19588,0
2020-07-31,1200401,202031,19624,19588,36
2020-07-31,1200393,202031,19624,19624,0
2020-07-31,1200807,202031,19627,19624,3
2020-07-31,1200385,202031,19629,19627,2
2020-07-31,1200336,202031,19629,19629,0
2020-07-31,1200351,202031,19629,19629,0
2020-07-31,1200344,202031,19629,19629,0
2020-07-31,1200328,202031,19629,19629,0
2020-07-31,1200302,202031,19629,19629,0
2020-07-31,1200252,202031,19629,19629,0
2020-07-31,1200203,202031,19630,19629,1
2020-07-31,1200179,202031,19636,19630,6
2020-07-31,1200138,202031,19636,19636,0
2020-07-31,1200104,202031,19636,19636,0
2020-07-31,1200054,202031,19636,19636,0
2020-07-31,1200450,202031,19639,19636,3
2020-07-31,1200609,202031,19640,19639,1
2020-07-31,1200013,202031,19640,19640,0
2020-08-01,1200336,202031,19640,19640,0
2020-08-01,1200807,202031,19647,19640,7
2020-08-01,1200393,202031,19657,19647,10
2020-08-01,1200401,202031,19774,19657,117
2020-08-01,1200427,202031,19775,19774,1
2020-08-01,1200435,202031,19777,19775,2
2020-08-01,1200500,202031,19814,19777,37
2020-08-01,1200450,202031,19815,19814,1
2020-08-01,1200609,202031,19819,19815,4
2020-08-01,1200708,202031,19831,19819,12
2020-08-01,1200351,202031,19832,19831,1
2020-08-01,1200344,202031,19848,19832,16
2020-08-01,1200328,202031,19850,19848,2
2020-08-01,1200302,202031,19907,19850,57
2020-08-01,1200252,202031,19910,19907,3
2020-08-01,1200203,202031,19924,19910,14
2020-08-01,1200179,202031,19926,19924,2
2020-08-01,1200138,202031,19929,19926,3
2020-08-01,1200104,202031,19930,19929,1
2020-08-01,1200054,202031,19942,19930,12
2020-08-01,1200013,202031,19942,19942,0
2020-08-01,1200385,202031,19945,19942,3
2020-08-02,1200252,202032,19945,19945,0
2020-08-02,1200427,202032,19945,19945,0
2020-08-02,1200708,202032,19945,19945,0
2020-08-02,1200609,202032,19946,19945,1
2020-08-02,1200450,202032,19947,19946,1
2020-08-02,1200500,202032,19949,19947,2
2020-08-02,1200435,202032,19949,19949,0
2020-08-02,1200401,202032,19965,19949,16
2020-08-02,1200393,202032,19965,19965,0
2020-08-02,1200807,202032,19966,19965,1
2020-08-02,1200336,202032,19966,19966,0
2020-08-02,1200385,202032,19966,19966,0
2020-08-02,1200344,202032,19966,19966,0
2020-08-02,1200328,202032,19966,19966,0
2020-08-02,1200302,202032,19980,19966,14
2020-08-02,1200203,202032,19980,19980,0
2020-08-02,1200179,202032,19980,19980,0
2020-08-02,1200138,202032,19980,19980,0
2020-08-02,1200104,202032,19981,19980,1
2020-08-02,1200054,202032,19981,19981,0
2020-08-02,1200013,202032,19981,19981,0
2020-08-02,1200351,202032,19981,19981,0
2020-08-03,1200252,202032,19997,19981,16
2020-08-03,1200344,202032,20027,19997,30
2020-08-03,1200328,202032,20029,20027,2
2020-08-03,1200302,202032,20045,20029,16
2020-08-03,1200203,202032,20089,20045,44
2020-08-03,1200385,202032,20091,20089,2
2020-08-03,1200138,202032,20091,20091,0
2020-08-03,1200104,202032,20130,20091,39
2020-08-03,1200013,202032,20140,20130,10
2020-08-03,1200351,202032,20141,20140,1
2020-08-03,1200179,202032,20143,20141,2
2020-08-03,1200336,202032,20162,20143,19
2020-08-03,1200054,202032,20174,20162,12
2020-08-03,1200393,202032,20179,20174,5
2020-08-03,1200401,202032,20289,20179,110
2020-08-03,1200427,202032,20290,20289,1
2020-08-03,1200435,202032,20292,20290,2
2020-08-03,1200500,202032,20301,20292,9
2020-08-03,1200450,202032,20309,20301,8
2020-08-03,1200609,202032,20322,20309,13
2020-08-03,1200708,202032,20349,20322,27
2020-08-03,1200807,202032,20354,20349,5
2020-08-04,1200708,202032,20366,20354,12
2020-08-04,1200013,202032,20372,20366,6
2020-08-04,1200054,202032,20381,20372,9
2020-08-04,1200104,202032,20383,20381,2
2020-08-04,1200138,202032,20387,20383,4
2020-08-04,1200179,202032,20398,20387,11
2020-08-04,1200203,202032,20444,20398,46
2020-08-04,1200302,202032,20466,20444,22
2020-08-04,1200450,202032,20471,20466,5
2020-08-04,1200500,202032,20496,20471,25
2020-08-04,1200435,202032,20497,20496,1
2020-08-04,1200427,202032,20497,20497,0
2020-08-04,1200401,202032,20596,20497,99
2020-08-04,1200252,202032,20596,20596,0
2020-08-04,1200393,202032,20597,20596,1
2020-08-04,1200385,202032,20604,20597,7
2020-08-04,1200336,202032,20681,20604,77
2020-08-04,1200351,202032,20684,20681,3
2020-08-04,1200344,202032,20695,20684,11
2020-08-04,1200328,202032,20695,20695,0
2020-08-04,1200807,202032,20703,20695,8
2020-08-04,1200609,202032,20725,20703,22
2020-08-05,1200013,202032,20725,20725,0
2020-08-05,1200054,202032,20746,20725,21
2020-08-05,1200104,202032,20764,20746,18
2020-08-05,1200179,202032,20764,20764,0
2020-08-05,1200252,202032,20782,20764,18
2020-08-05,1200302,202032,20809,20782,27
2020-08-05,1200328,202032,20814,20809,5
2020-08-05,1200344,202032,20821,20814,7
2020-08-05,1200351,202032,20827,20821,6
2020-08-05,1200336,202032,20843,20827,16
2020-08-05,1200385,202032,20848,20843,5
2020-08-05,1200807,202032,20851,20848,3
2020-08-05,1200393,202032,20851,20851,0
2020-08-05,1200401,202032,20961,20851,110
2020-08-05,1200427,202032,20964,20961,3
2020-08-05,1200435,202032,20964,20964,0
2020-08-05,1200500,202032,20973,20964,9
2020-08-05,1200203,202032,20992,20973,19
2020-08-05,1200450,202032,20994,20992,2
2020-08-05,1200609,202032,21021,20994,27
2020-08-05,1200708,202032,21045,21021,24
2020-08-05,1200138,202032,21048,21045,3
2020-08-06,1200013,202032,21054,21048,6
2020-08-06,1200054,202032,21067,21054,13
2020-08-06,1200104,202032,21086,21067,19
2020-08-06,1200138,202032,21087,21086,1
2020-08-06,1200179,202032,21090,21087,3
2020-08-06,1200203,202032,21105,21090,15
2020-08-06,1200252,202032,21114,21105,9
2020-08-06,1200302,202032,21153,21114,39
2020-08-06,1200328,202032,21153,21153,0
2020-08-06,1200344,202032,21162,21153,9
2020-08-06,1200351,202032,21162,21162,0
2020-08-06,1200385,202032,21164,21162,2
2020-08-06,1200393,202032,21164,21164,0
2020-08-06,1200807,202032,21171,21164,7
2020-08-06,1200401,202032,21208,21171,37
2020-08-06,1200427,202032,21208,21208,0
2020-08-06,1200435,202032,21208,21208,0
2020-08-06,1200500,202032,21233,21208,25
2020-08-06,1200450,202032,21237,21233,4
2020-08-06,1200609,202032,21240,21237,3
2020-08-06,1200708,202032,21277,21240,37
2020-08-06,1200336,202032,21278,21277,1
2020-08-07,1200013,202032,21278,21278,0
2020-08-07,1200054,202032,21278,21278,0
2020-08-07,1200104,202032,21278,21278,0
2020-08-07,1200138,202032,21279,21278,1
2020-08-07,1200179,202032,21280,21279,1
2020-08-07,1200203,202032,21268,21280,-12
2020-08-07,1200708,202032,21278,21268,10
2020-08-07,1200328,202032,21287,21278,9
2020-08-07,1200344,202032,21287,21287,0
2020-08-07,1200351,202032,21290,21287,3
2020-08-07,1200336,202032,21297,21290,7
2020-08-07,1200385,202032,21298,21297,1
2020-08-07,1200807,202032,21298,21298,0
2020-08-07,1200393,202032,21298,21298,0
2020-08-07,1200401,202032,21358,21298,60
2020-08-07,1200427,202032,21359,21358,1
2020-08-07,1200435,202032,21359,21359,0
2020-08-07,1200500,202032,21362,21359,3
2020-08-07,1200450,202032,21362,21362,0
2020-08-07,1200609,202032,21383,21362,21
2020-08-07,1200302,202032,21391,21383,8
2020-08-07,1200252,202032,21391,21391,0
2020-08-08,1200435,202032,21391,21391,0
2020-08-08,1200393,202032,21391,21391,0
2020-08-08,1200708,202032,21392,21391,1
2020-08-08,1200609,202032,21392,21392,0
2020-08-08,1200450,202032,21395,21392,3
2020-08-08,1200500,202032,21401,21395,6
2020-08-08,1200427,202032,21405,21401,4
2020-08-08,1200401,202032,21453,21405,48
2020-08-08,1200807,202032,21455,21453,2
2020-08-08,1200385,202032,21456,21455,1
2020-08-08,1200351,202032,21457,21456,1
2020-08-08,1200336,202032,21479,21457,22
2020-08-08,1200328,202032,21479,21479,0
2020-08-08,1200302,202032,21507,21479,28
2020-08-08,1200252,202032,21508,21507,1
2020-08-08,1200203,202032,21511,21508,3
2020-08-08,1200179,202032,21511,21511,0
2020-08-08,1200138,202032,21513,21511,2
2020-08-08,1200104,202032,21513,21513,0
2020-08-08,1200054,202032,21513,21513,0
2020-08-08,1200013,202032,21513,21513,0
2020-08-08,1200344,202032,21513,21513,0
2020-08-09,1200203,202033,21514,21513,1
2020-08-09,1200302,202033,21518,21514,4
2020-08-09,1200252,202033,21524,21518,6
2020-08-09,1200179,202033,21526,21524,2
2020-08-09,1200351,202033,21526,21526,0
2020-08-09,1200104,202033,21552,21526,26
2020-08-09,1200054,202033,21555,21552,3
2020-08-09,1200013,202033,21560,21555,5
2020-08-09,1200328,202033,21560,21560,0
2020-08-09,1200138,202033,21565,21560,5
2020-08-09,1200336,202033,21565,21565,0
2020-08-09,1200344,202033,21565,21565,0
2020-08-09,1200385,202033,21566,21565,1
2020-08-09,1200807,202033,21567,21566,1
2020-08-09,1200393,202033,21567,21567,0
2020-08-09,1200401,202033,21583,21567,16
2020-08-09,1200427,202033,21583,21583,0
2020-08-09,1200435,202033,21583,21583,0
2020-08-09,1200500,202033,21584,21583,1
2020-08-09,1200450,202033,21588,21584,4
2020-08-09,1200609,202033,21588,21588,0
2020-08-09,1200708,202033,21602,21588,14
2020-08-10,1200013,202033,21602,21602,0
2020-08-10,1200054,202033,21602,21602,0
2020-08-10,1200104,202033,21605,21602,3
2020-08-10,1200138,202033,21606,21605,1
2020-08-10,1200179,202033,21606,21606,0
2020-08-10,1200609,202033,21606,21606,0
2020-08-10,1200252,202033,21606,21606,0
2020-08-10,1200302,202033,21608,21606,2
2020-08-10,1200328,202033,21615,21608,7
2020-08-10,1200344,202033,21615,21615,0
2020-08-10,1200351,202033,21615,21615,0
2020-08-10,1200336,202033,21616,21615,1
2020-08-10,1200385,202033,21616,21616,0
2020-08-10,1200807,202033,21616,21616,0
2020-08-10,1200393,202033,21616,21616,0
2020-08-10,1200401,202033,21625,21616,9
2020-08-10,1200427,202033,21625,21625,0
2020-08-10,1200435,202033,21625,21625,0
2020-08-10,1200500,202033,21628,21625,3
2020-08-10,1200450,202033,21628,21628,0
2020-08-10,1200708,202033,21628,21628,0
2020-08-10,1200203,202033,21634,21628,6
2020-08-11,1200336,202033,21635,21634,1
2020-08-11,1200427,202033,21636,21635,1
2020-08-11,1200708,202033,21656,21636,20
2020-08-11,1200609,202033,21657,21656,1
2020-08-11,1200450,202033,21661,21657,4
2020-08-11,1200500,202033,21691,21661,30
2020-08-11,1200435,202033,21694,21691,3
2020-08-11,1200401,202033,21715,21694,21
2020-08-11,1200393,202033,21715,21715,0
2020-08-11,1200807,202033,21715,21715,0
2020-08-11,1200351,202033,21719,21715,4
2020-08-11,1200385,202033,21722,21719,3
2020-08-11,1200328,202033,21722,21722,0
2020-08-11,1200302,202033,21736,21722,14
2020-08-11,1200252,202033,21738,21736,2
2020-08-11,1200203,202033,21739,21738,1
2020-08-11,1200179,202033,21739,21739,0
2020-08-11,1200138,202033,21743,21739,4
2020-08-11,1200104,202033,21752,21743,9
2020-08-11,1200054,202033,21758,21752,6
2020-08-11,1200013,202033,21762,21758,4
2020-08-11,1200344,202033,21772,21762,10
2020-08-12,1200203,202033,21822,21772,50
2020-08-12,1200344,202033,21829,21822,7
2020-08-12,1200328,202033,21836,21829,7
2020-08-12,1200302,202033,21848,21836,12
2020-08-12,1200179,202033,21849,21848,1
2020-08-12,1200385,202033,21848,21849,-1
2020-08-12,1200104,202033,21852,21848,4
2020-08-12,1200054,202033,21871,21852,19
2020-08-12,1200013,202033,21895,21871,24
2020-08-12,1200351,202033,21898,21895,3
2020-08-12,1200138,202033,21899,21898,1
2020-08-12,1200336,202033,21902,21899,3
2020-08-12,1200252,202033,21913,21902,11
2020-08-12,1200807,202033,21915,21913,2
2020-08-12,1200393,202033,21919,21915,4
2020-08-12,1200401,202033,21945,21919,26
2020-08-12,1200427,202033,21945,21945,0
2020-08-12,1200435,202033,21949,21945,4
2020-08-12,1200500,202033,21971,21949,22
2020-08-12,1200450,202033,21979,21971,8
2020-08-12,1200609,202033,21992,21979,13
2020-08-12,1200708,202033,22008,21992,16
2020-08-13,1200708,202033,22030,22008,22
2020-08-13,1200013,202033,22061,22030,31
2020-08-13,1200054,202033,22070,22061,9
2020-08-13,1200104,202033,22073,22070,3
2020-08-13,1200138,202033,22075,22073,2
2020-08-13,1200179,202033,22075,22075,0
2020-08-13,1200203,202033,22088,22075,13
2020-08-13,1200807,202033,22088,22088,0
2020-08-13,1200450,202033,22092,22088,4
2020-08-13,1200500,202033,22122,22092,30
2020-08-13,1200435,202033,22123,22122,1
2020-08-13,1200427,202033,22123,22123,0
2020-08-13,1200401,202033,22139,22123,16
2020-08-13,1200393,202033,22142,22139,3
2020-08-13,1200252,202033,22145,22142,3
2020-08-13,1200609,202033,22173,22145,28
2020-08-13,1200336,202033,22196,22173,23
2020-08-13,1200351,202033,22196,22196,0
2020-08-13,1200344,202033,22206,22196,10
2020-08-13,1200328,202033,22214,22206,8
2020-08-13,1200302,202033,22256,22214,42
2020-08-13,1200385,202033,22257,22256,1
2020-08-14,1200054,202033,22271,22257,14
2020-08-14,1200013,202033,22279,22271,8
2020-08-14,1200104,202033,22298,22279,19
2020-08-14,1200708,202033,22328,22298,30
2020-08-14,1200450,202033,22332,22328,4
2020-08-14,1200500,202033,22353,22332,21
2020-08-14,1200435,202033,22353,22353,0
2020-08-14,1200427,202033,22353,22353,0
2020-08-14,1200401,202033,22384,22353,31
2020-08-14,1200393,202033,22385,22384,1
2020-08-14,1200807,202033,22390,22385,5
2020-08-14,1200385,202033,22391,22390,1
2020-08-14,1200336,202033,22399,22391,8
2020-08-14,1200351,202033,22402,22399,3
2020-08-14,1200344,202033,22405,22402,3
2020-08-14,1200328,202033,22408,22405,3
2020-08-14,1200302,202033,22417,22408,9
2020-08-14,1200252,202033,22423,22417,6
2020-08-14,1200203,202033,22440,22423,17
2020-08-14,1200179,202033,22443,22440,3
2020-08-14,1200138,202033,22445,22443,2
2020-08-14,1200609,202033,22450,22445,5
2020-08-15,1200807,202033,22451,22450,1
2020-08-15,1200393,202033,22451,22451,0
2020-08-15,1200054,202033,22456,22451,5
2020-08-15,1200401,202033,22481,22456,25
2020-08-15,1200427,202033,22481,22481,0
2020-08-15,1200385,202033,22484,22481,3
2020-08-15,1200500,202033,22496,22484,12
2020-08-15,1200450,202033,22498,22496,2
2020-08-15,1200609,202033,22502,22498,4
2020-08-15,1200708,202033,22511,22502,9
2020-08-15,1200336,202033,22515,22511,4
2020-08-15,1200351,202033,22515,22515,0
2020-08-15,1200344,202033,22515,22515,0
2020-08-15,1200328,202033,22515,22515,0
2020-08-15,1200302,202033,22519,22515,4
2020-08-15,1200252,202033,22519,22519,0
2020-08-15,1200203,202033,22522,22519,3
2020-08-15,1200179,202033,22525,22522,3
2020-08-15,1200138,202033,22525,22525,0
2020-08-15,1200104,202033,22526,22525,1
2020-08-15,1200013,202033,22528,22526,2
2020-08-15,1200435,202033,22531,22528,3
2020-08-16,1200435,202034,22531,22531,0
2020-08-16,1200708,202034,22531,22531,0
2020-08-16,1200500,202034,22531,22531,0
2020-08-16,1200427,202034,22531,22531,0
2020-08-16,1200401,202034,22537,22531,6
2020-08-16,1200393,202034,22537,22537,0
2020-08-16,1200807,202034,22537,22537,0
2020-08-16,1200385,202034,22537,22537,0
2020-08-16,1200336,202034,22537,22537,0
2020-08-16,1200351,202034,22537,22537,0
2020-08-16,1200344,202034,22537,22537,0
2020-08-16,1200328,202034,22537,22537,0
2020-08-16,1200302,202034,22563,22537,26
2020-08-16,1200252,202034,22563,22563,0
2020-08-16,1200203,202034,22564,22563,1
2020-08-16,1200179,202034,22564,22564,0
2020-08-16,1200138,202034,22565,22564,1
2020-08-16,1200104,202034,22565,22565,0
2020-08-16,1200054,202034,22564,22565,-1
2020-08-16,1200450,202034,22563,22564,-1
2020-08-16,1200609,202034,22563,22563,0
2020-08-16,1200013,202034,22563,22563,0
2020-08-17,1200336,202034,22563,22563,0
2020-08-17,1200807,202034,22563,22563,0
2020-08-17,1200393,202034,22563,22563,0
2020-08-17,1200401,202034,22574,22563,11
2020-08-17,1200427,202034,22574,22574,0
2020-08-17,1200435,202034,22574,22574,0
2020-08-17,1200500,202034,22579,22574,5
2020-08-17,1200450,202034,22579,22579,0
2020-08-17,1200609,202034,22579,22579,0
2020-08-17,1200708,202034,22586,22579,7
2020-08-17,1200351,202034,22587,22586,1
2020-08-17,1200344,202034,22587,22587,0
2020-08-17,1200328,202034,22587,22587,0
2020-08-17,1200302,202034,22596,22587,9
2020-08-17,1200252,202034,22608,22596,12
2020-08-17,1200203,202034,22608,22608,0
2020-08-17,1200179,202034,22608,22608,0
2020-08-17,1200138,202034,22608,22608,0
2020-08-17,1200104,202034,22614,22608,6
2020-08-17,1200054,202034,22615,22614,1
2020-08-17,1200013,202034,22620,22615,5
2020-08-17,1200385,202034,22620,22620,0
2020-08-18,1200336,202034,22620,22620,0
2020-08-18,1200427,202034,22620,22620,0
2020-08-18,1200708,202034,22647,22620,27
2020-08-18,1200609,202034,22732,22647,85
2020-08-18,1200450,202034,22734,22732,2
2020-08-18,1200500,202034,22751,22734,17
2020-08-18,1200435,202034,22753,22751,2
2020-08-18,1200401,202034,22783,22753,30
2020-08-18,1200393,202034,22783,22783,0
2020-08-18,1200807,202034,22783,22783,0
2020-08-18,1200351,202034,22786,22783,3
2020-08-18,1200385,202034,22786,22786,0
2020-08-18,1200328,202034,22790,22786,4
2020-08-18,1200302,202034,22796,22790,6
2020-08-18,1200252,202034,22811,22796,15
2020-08-18,1200203,202034,22830,22811,19
2020-08-18,1200179,202034,22831,22830,1
2020-08-18,1200138,202034,22832,22831,1
2020-08-18,1200104,202034,22925,22832,93
2020-08-18,1200054,202034,22926,22925,1
2020-08-18,1200013,202034,22946,22926,20
2020-08-18,1200344,202034,22948,22946,2
2020-08-19,1200203,202034,23010,22948,62
2020-08-19,1200344,202034,23012,23010,2
2020-08-19,1200328,202034,23012,23012,0
2020-08-19,1200302,202034,23020,23012,8
2020-08-19,1200179,202034,23020,23020,0
2020-08-19,1200385,202034,23021,23020,1
2020-08-19,1200104,202034,23043,23021,22
2020-08-19,1200054,202034,23048,23043,5
2020-08-19,1200013,202034,23048,23048,0
2020-08-19,1200351,202034,23051,23048,3
2020-08-19,1200138,202034,23053,23051,2
2020-08-19,1200336,202034,23053,23053,0
2020-08-19,1200252,202034,23053,23053,0
2020-08-19,1200393,202034,23053,23053,0
2020-08-19,1200401,202034,23062,23053,9
2020-08-19,1200427,202034,23064,23062,2
2020-08-19,1200435,202034,23065,23064,1
2020-08-19,1200500,202034,23078,23065,13
2020-08-19,1200450,202034,23081,23078,3
2020-08-19,1200609,202034,23129,23081,48
2020-08-19,1200708,202034,23151,23129,22
2020-08-19,1200807,202034,23161,23151,10
2020-08-20,1200708,202034,23187,23161,26
2020-08-20,1200013,202034,23192,23187,5
2020-08-20,1200054,202034,23201,23192,9
2020-08-20,1200104,202034,23208,23201,7
2020-08-20,1200138,202034,23208,23208,0
2020-08-20,1200179,202034,23211,23208,3
2020-08-20,1200203,202034,23219,23211,8
2020-08-20,1200302,202034,23251,23219,32
2020-08-20,1200450,202034,23261,23251,10
2020-08-20,1200500,202034,23281,23261,20
2020-08-20,1200435,202034,23283,23281,2
2020-08-20,1200427,202034,23284,23283,1
2020-08-20,1200401,202034,23306,23284,22
2020-08-20,1200252,202034,23313,23306,7
2020-08-20,1200393,202034,23314,23313,1
2020-08-20,1200385,202034,23316,23314,2
2020-08-20,1200336,202034,23317,23316,1
2020-08-20,1200351,202034,23323,23317,6
2020-08-20,1200344,202034,23324,23323,1
2020-08-20,1200328,202034,23333,23324,9
2020-08-20,1200807,202034,23335,23333,2
2020-08-20,1200609,202034,23337,23335,2
2020-08-21,1200013,202034,23337,23337,0
2020-08-21,1200054,202034,23337,23337,0
2020-08-21,1200104,202034,23337,23337,0
2020-08-21,1200435,202034,23337,23337,0
2020-08-21,1200427,202034,23337,23337,0
2020-08-21,1200138,202034,23337,23337,0
2020-08-21,1200500,202034,23339,23337,2
2020-08-21,1200450,202034,23339,23339,0
2020-08-21,1200609,202034,23339,23339,0
2020-08-21,1200708,202034,23339,23339,0
2020-08-21,1200807,202034,23339,23339,0
2020-08-21,1200385,202034,23339,23339,0
2020-08-21,1200336,202034,23339,23339,0
2020-08-21,1200351,202034,23339,23339,0
2020-08-21,1200344,202034,23339,23339,0
2020-08-21,1200328,202034,23339,23339,0
2020-08-21,1200302,202034,23339,23339,0
2020-08-21,1200252,202034,23340,23339,1
2020-08-21,1200203,202034,23344,23340,4
2020-08-21,1200179,202034,23344,23344,0
2020-08-21,1200401,202034,23352,23344,8
2020-08-21,1200393,202034,23352,23352,0
2020-08-22,1200385,202034,23354,23352,2
2020-08-22,1200393,202034,23357,23354,3
2020-08-22,1200054,202034,23374,23357,17
2020-08-22,1200104,202034,23389,23374,15
2020-08-22,1200807,202034,23408,23389,19
2020-08-22,1200138,202034,23415,23408,7
2020-08-22,1200179,202034,23415,23415,0
2020-08-22,1200203,202034,23426,23415,11
2020-08-22,1200252,202034,23426,23426,0
2020-08-22,1200302,202034,23428,23426,2
2020-08-22,1200328,202034,23428,23428,0
2020-08-22,1200344,202034,23431,23428,3
2020-08-22,1200013,202034,23431,23431,0
2020-08-22,1200351,202034,23443,23431,12
2020-08-22,1200336,202034,23464,23443,21
2020-08-22,1200500,202034,23485,23464,21
2020-08-22,1200609,202034,23489,23485,4
2020-08-22,1200427,202034,23489,23489,0
2020-08-22,1200708,202034,23548,23489,59
2020-08-22,1200435,202034,23599,23548,51
2020-08-22,1200401,202034,23676,23599,77
2020-08-22,1200450,202034,23680,23676,4
2020-08-23,1200013,202035,23685,23680,5
2020-08-23,1200054,202035,23686,23685,1
2020-08-23,1200104,202035,23700,23686,14
2020-08-23,1200138,202035,23700,23700,0
2020-08-23,1200179,202035,23700,23700,0
2020-08-23,1200203,202035,23700,23700,0
2020-08-23,1200252,202035,23706,23700,6
2020-08-23,1200328,202035,23706,23706,0
2020-08-23,1200302,202035,23720,23706,14
2020-08-23,1200336,202035,23720,23720,0
2020-08-23,1200385,202035,23720,23720,0
2020-08-23,1200807,202035,23720,23720,0
2020-08-23,1200393,202035,23720,23720,0
2020-08-23,1200401,202035,23727,23720,7
2020-08-23,1200427,202035,23727,23727,0
2020-08-23,1200435,202035,23727,23727,0
2020-08-23,1200500,202035,23729,23727,2
2020-08-23,1200450,202035,23732,23729,3
2020-08-23,1200609,202035,23732,23732,0
2020-08-23,1200708,202035,23734,23732,2
2020-08-23,1200351,202035,23734,23734,0
2020-08-23,1200344,202035,23734,23734,0
2020-08-24,1200179,202035,23734,23734,0
2020-08-24,1200138,202035,23734,23734,0
2020-08-24,1200104,202035,23733,23734,-1
2020-08-24,1200013,202035,23733,23733,0
2020-08-24,1200054,202035,23733,23733,0
2020-08-24,1200807,202035,23733,23733,0
2020-08-24,1200500,202035,23738,23733,5
2020-08-24,1200435,202035,23737,23738,-1
2020-08-24,1200427,202035,23737,23737,0
2020-08-24,1200401,202035,23741,23737,4
2020-08-24,1200393,202035,23741,23741,0
2020-08-24,1200708,202035,23741,23741,0
2020-08-24,1200450,202035,23741,23741,0
2020-08-24,1200385,202035,23741,23741,0
2020-08-24,1200351,202035,23742,23741,1
2020-08-24,1200344,202035,23742,23742,0
2020-08-24,1200328,202035,23742,23742,0
2020-08-24,1200302,202035,23742,23742,0
2020-08-24,1200252,202035,23742,23742,0
2020-08-24,1200203,202035,23742,23742,0
2020-08-24,1200336,202035,23744,23742,2
2020-08-24,1200609,202035,23744,23744,0
2020-08-25,1200427,202035,23745,23744,1
2020-08-25,1200401,202035,23768,23745,23
2020-08-25,1200013,202035,23780,23768,12
2020-08-25,1200104,202035,23782,23780,2
2020-08-25,1200435,202035,23783,23782,1
2020-08-25,1200393,202035,23783,23783,0
2020-08-25,1200450,202035,23790,23783,7
2020-08-25,1200609,202035,23791,23790,1
2020-08-25,1200708,202035,23828,23791,37
2020-08-25,1200807,202035,23828,23828,0
2020-08-25,1200385,202035,23831,23828,3
2020-08-25,1200054,202035,23839,23831,8
2020-08-25,1200336,202035,23896,23839,57
2020-08-25,1200344,202035,23901,23896,5
2020-08-25,1200328,202035,23901,23901,0
2020-08-25,1200302,202035,23909,23901,8
2020-08-25,1200252,202035,23919,23909,10
2020-08-25,1200203,202035,23924,23919,5
2020-08-25,1200179,202035,23926,23924,2
2020-08-25,1200138,202035,23926,23926,0
2020-08-25,1200351,202035,23933,23926,7
2020-08-25,1200500,202035,23951,23933,18
2020-08-26,1200385,202035,23952,23951,1
2020-08-26,1200401,202035,23988,23952,36
2020-08-26,1200708,202035,24014,23988,26
2020-08-26,1200609,202035,24025,24014,11
2020-08-26,1200450,202035,24039,24025,14
2020-08-26,1200500,202035,24057,24039,18
2020-08-26,1200435,202035,24069,24057,12
2020-08-26,1200427,202035,24069,24069,0
2020-08-26,1200393,202035,24069,24069,0
2020-08-26,1200807,202035,24070,24069,1
2020-08-26,1200351,202035,24077,24070,7
2020-08-26,1200336,202035,24077,24077,0
2020-08-26,1200328,202035,24091,24077,14
2020-08-26,1200302,202035,24104,24091,13
2020-08-26,1200252,202035,24107,24104,3
2020-08-26,1200203,202035,24119,24107,12
2020-08-26,1200179,202035,24119,24119,0
2020-08-26,1200138,202035,24119,24119,0
2020-08-26,1200104,202035,24123,24119,4
2020-08-26,1200054,202035,24130,24123,7
2020-08-26,1200013,202035,24132,24130,2
2020-08-26,1200344,202035,24134,24132,2
2020-08-27,1200203,202035,24152,24134,18
2020-08-27,1200328,202035,24154,24152,2
2020-08-27,1200252,202035,24154,24154,0
2020-08-27,1200179,202035,24155,24154,1
2020-08-27,1200385,202035,24156,24155,1
2020-08-27,1200104,202035,24159,24156,3
2020-08-27,1200054,202035,24162,24159,3
2020-08-27,1200013,202035,24165,24162,3
2020-08-27,1200344,202035,24165,24165,0
2020-08-27,1200138,202035,24165,24165,0
2020-08-27,1200336,202035,24172,24165,7
2020-08-27,1200351,202035,24175,24172,3
2020-08-27,1200302,202035,24199,24175,24
2020-08-27,1200807,202035,24200,24199,1
2020-08-27,1200393,202035,24200,24200,0
2020-08-27,1200401,202035,24221,24200,21
2020-08-27,1200427,202035,24221,24221,0
2020-08-27,1200435,202035,24227,24221,6
2020-08-27,1200500,202035,24236,24227,9
2020-08-27,1200450,202035,24251,24236,15
2020-08-27,1200609,202035,24262,24251,11
2020-08-27,1200708,202035,24284,24262,22
2020-08-28,1200013,202035,24286,24284,2
2020-08-28,1200054,202035,24290,24286,4
2020-08-28,1200104,202035,24298,24290,8
2020-08-28,1200138,202035,24300,24298,2
2020-08-28,1200179,202035,24300,24300,0
2020-08-28,1200609,202035,24301,24300,1
2020-08-28,1200252,202035,24303,24301,2
2020-08-28,1200302,202035,24313,24303,10
2020-08-28,1200328,202035,24325,24313,12
2020-08-28,1200344,202035,24327,24325,2
2020-08-28,1200351,202035,24334,24327,7
2020-08-28,1200336,202035,24358,24334,24
2020-08-28,1200385,202035,24358,24358,0
2020-08-28,1200807,202035,24358,24358,0
2020-08-28,1200393,202035,24362,24358,4
2020-08-28,1200401,202035,24403,24362,41
2020-08-28,1200427,202035,24403,24403,0
2020-08-28,1200435,202035,24404,24403,1
2020-08-28,1200500,202035,24412,24404,8
2020-08-28,1200450,202035,24419,24412,7
2020-08-28,1200708,202035,24441,24419,22
2020-08-28,1200203,202035,24477,24441,36
2020-08-29,1200252,202035,24479,24477,2
2020-08-29,1200427,202035,24480,24479,1
2020-08-29,1200708,202035,24496,24480,16
2020-08-29,1200609,202035,24512,24496,16
2020-08-29,1200450,202035,24512,24512,0
2020-08-29,1200500,202035,24530,24512,18
2020-08-29,1200435,202035,24530,24530,0
2020-08-29,1200401,202035,24564,24530,34
2020-08-29,1200393,202035,24574,24564,10
2020-08-29,1200807,202035,24574,24574,0
2020-08-29,1200336,202035,24574,24574,0
2020-08-29,1200385,202035,24575,24574,1
2020-08-29,1200344,202035,24576,24575,1
2020-08-29,1200328,202035,24575,24576,-1
2020-08-29,1200302,202035,24587,24575,12
2020-08-29,1200203,202035,24602,24587,15
2020-08-29,1200179,202035,24602,24602,0
2020-08-29,1200138,202035,24604,24602,2
2020-08-29,1200104,202035,24604,24604,0
2020-08-29,1200054,202035,24613,24604,9
2020-08-29,1200013,202035,24614,24613,1
2020-08-29,1200351,202035,24616,24614,2
2020-08-30,1200252,202036,24616,24616,0
2020-08-30,1200344,202036,24616,24616,0
2020-08-30,1200328,202036,24616,24616,0
2020-08-30,1200302,202036,24639,24616,23
2020-08-30,1200203,202036,24639,24639,0
2020-08-30,1200385,202036,24639,24639,0
2020-08-30,1200138,202036,24639,24639,0
2020-08-30,1200104,202036,24643,24639,4
2020-08-30,1200013,202036,24643,24643,0
2020-08-30,1200351,202036,24643,24643,0
2020-08-30,1200179,202036,24643,24643,0
2020-08-30,1200336,202036,24643,24643,0
2020-08-30,1200054,202036,24643,24643,0
2020-08-30,1200807,202036,24644,24643,1
2020-08-30,1200393,202036,24644,24644,0
2020-08-30,1200401,202036,24653,24644,9
2020-08-30,1200427,202036,24653,24653,0
2020-08-30,1200435,202036,24653,24653,0
2020-08-30,1200500,202036,24653,24653,0
2020-08-30,1200450,202036,24653,24653,0
2020-08-30,1200609,202036,24653,24653,0
2020-08-30,1200708,202036,24653,24653,0
2020-08-31,1200708,202036,24656,24653,3
2020-08-31,1200013,202036,24656,24656,0
2020-08-31,1200054,202036,24656,24656,0
2020-08-31,1200104,202036,24656,24656,0
2020-08-31,1200138,202036,24656,24656,0
2020-08-31,1200179,202036,24656,24656,0
2020-08-31,1200203,202036,24656,24656,0
2020-08-31,1200807,202036,24656,24656,0
2020-08-31,1200450,202036,24656,24656,0
2020-08-31,1200500,202036,24658,24656,2
2020-08-31,1200435,202036,24658,24658,0
2020-08-31,1200427,202036,24658,24658,0
2020-08-31,1200401,202036,24662,24658,4
2020-08-31,1200393,202036,24662,24662,0
2020-08-31,1200252,202036,24662,24662,0
2020-08-31,1200609,202036,24662,24662,0
2020-08-31,1200336,202036,24662,24662,0
2020-08-31,1200351,202036,24662,24662,0
2020-08-31,1200344,202036,24662,24662,0
2020-08-31,1200328,202036,24662,24662,0
2020-08-31,1200302,202036,24660,24662,-2
2020-08-31,1200385,202036,24662,24660,2
2020-09-01,1200054,202036,24663,24662,1
2020-09-01,1200013,202036,24663,24663,0
2020-09-01,1200104,202036,24665,24663,2
2020-09-01,1200708,202036,24691,24665,26
2020-09-01,1200450,202036,24705,24691,14
2020-09-01,1200500,202036,24721,24705,16
2020-09-01,1200435,202036,24721,24721,0
2020-09-01,1200427,202036,24723,24721,2
2020-09-01,1200401,202036,24755,24723,32
2020-09-01,1200393,202036,24760,24755,5
2020-09-01,1200807,202036,24760,24760,0
2020-09-01,1200385,202036,24760,24760,0
2020-09-01,1200336,202036,24778,24760,18
2020-09-01,1200351,202036,24782,24778,4
2020-09-01,1200344,202036,24785,24782,3
2020-09-01,1200328,202036,24788,24785,3
2020-09-01,1200302,202036,24800,24788,12
2020-09-01,1200252,202036,24800,24800,0
2020-09-01,1200203,202036,24816,24800,16
2020-09-01,1200179,202036,24817,24816,1
2020-09-01,1200138,202036,24818,24817,1
2020-09-01,1200609,202036,24855,24818,37
2020-09-02,1200807,202036,24855,24855,0
2020-09-02,1200393,202036,24855,24855,0
2020-09-02,1200054,202036,24855,24855,0
2020-09-02,1200401,202036,24855,24855,0
2020-09-02,1200427,202036,24855,24855,0
2020-09-02,1200385,202036,24855,24855,0
2020-09-02,1200500,202036,24855,24855,0
2020-09-02,1200450,202036,24855,24855,0
2020-09-02,1200609,202036,24855,24855,0
2020-09-02,1200708,202036,24855,24855,0
2020-09-02,1200336,202036,24855,24855,0
2020-09-02,1200351,202036,24855,24855,0
2020-09-02,1200344,202036,24855,24855,0
2020-09-02,1200328,202036,24855,24855,0
2020-09-02,1200302,202036,24855,24855,0
2020-09-02,1200252,202036,24855,24855,0
2020-09-02,1200203,202036,24855,24855,0
2020-09-02,1200179,202036,24855,24855,0
2020-09-02,1200138,202036,24855,24855,0
2020-09-02,1200104,202036,24855,24855,0
2020-09-02,1200013,202036,24855,24855,0
2020-09-02,1200435,202036,24855,24855,0
2020-09-03,1200435,202036,24871,24855,16
2020-09-03,1200708,202036,24904,24871,33
2020-09-03,1200500,202036,24920,24904,16
2020-09-03,1200427,202036,24920,24920,0
2020-09-03,1200401,202036,24972,24920,52
2020-09-03,1200393,202036,24978,24972,6
2020-09-03,1200807,202036,24979,24978,1
2020-09-03,1200385,202036,24982,24979,3
2020-09-03,1200336,202036,25042,24982,60
2020-09-03,1200351,202036,25047,25042,5
2020-09-03,1200344,202036,25049,25047,2
2020-09-03,1200328,202036,25051,25049,2
2020-09-03,1200302,202036,25066,25051,15
2020-09-03,1200252,202036,25064,25066,-2
2020-09-03,1200203,202036,25079,25064,15
2020-09-03,1200179,202036,25079,25079,0
2020-09-03,1200138,202036,25079,25079,0
2020-09-03,1200104,202036,25093,25079,14
2020-09-03,1200054,202036,25095,25093,2
2020-09-03,1200450,202036,25097,25095,2
2020-09-03,1200609,202036,25146,25097,49
2020-09-03,1200013,202036,25150,25146,4
2020-09-04,1200336,202036,25146,25150,-4
2020-09-04,1200807,202036,25146,25146,0
2020-09-04,1200393,202036,25148,25146,2
2020-09-04,1200401,202036,25161,25148,13
2020-09-04,1200427,202036,25163,25161,2
2020-09-04,1200435,202036,25176,25163,13
2020-09-04,1200500,202036,25185,25176,9
2020-09-04,1200450,202036,25187,25185,2
2020-09-04,1200609,202036,25212,25187,25
2020-09-04,1200708,202036,25225,25212,13
2020-09-04,1200351,202036,25231,25225,6
2020-09-04,1200344,202036,25234,25231,3
2020-09-04,1200328,202036,25234,25234,0
2020-09-04,1200302,202036,25234,25234,0
2020-09-04,1200252,202036,25236,25234,2
2020-09-04,1200203,202036,25252,25236,16
2020-09-04,1200179,202036,25252,25252,0
2020-09-04,1200138,202036,25252,25252,0
2020-09-04,1200104,202036,25259,25252,7
2020-09-04,1200054,202036,25264,25259,5
2020-09-04,1200013,202036,25264,25264,0
2020-09-04,1200385,202036,25264,25264,0
2020-09-05,1200336,202036,25287,25264,23
2020-09-05,1200427,202036,25287,25287,0
2020-09-05,1200708,202036,25301,25287,14
2020-09-05,1200609,202036,25303,25301,2
2020-09-05,1200450,202036,25306,25303,3
2020-09-05,1200500,202036,25315,25306,9
2020-09-05,1200435,202036,25320,25315,5
2020-09-05,1200401,202036,25345,25320,25
2020-09-05,1200393,202036,25350,25345,5
2020-09-05,1200807,202036,25351,25350,1
2020-09-05,1200351,202036,25355,25351,4
2020-09-05,1200385,202036,25356,25355,1
2020-09-05,1200328,202036,25365,25356,9
2020-09-05,1200302,202036,25380,25365,15
2020-09-05,1200252,202036,25379,25380,-1
2020-09-05,1200203,202036,25408,25379,29
2020-09-05,1200179,202036,25408,25408,0
2020-09-05,1200138,202036,25409,25408,1
2020-09-05,1200104,202036,25412,25409,3
2020-09-05,1200054,202036,25419,25412,7
2020-09-05,1200013,202036,25422,25419,3
2020-09-05,1200344,202036,25423,25422,1
2020-09-06,1200203,202037,25423,25423,0
2020-09-06,1200344,202037,25423,25423,0
2020-09-06,1200328,202037,25423,25423,0
2020-09-06,1200302,202037,25423,25423,0
2020-09-06,1200179,202037,25424,25423,1
2020-09-06,1200385,202037,25424,25424,0
2020-09-06,1200104,202037,25424,25424,0
2020-09-06,1200054,202037,25424,25424,0
2020-09-06,1200013,202037,25424,25424,0
2020-09-06,1200351,202037,25424,25424,0
2020-09-06,1200138,202037,25424,25424,0
2020-09-06,1200336,202037,25424,25424,0
2020-09-06,1200252,202037,25424,25424,0
2020-09-06,1200393,202037,25424,25424,0
2020-09-06,1200401,202037,25458,25424,34
2020-09-06,1200427,202037,25458,25458,0
2020-09-06,1200435,202037,25458,25458,0
2020-09-06,1200500,202037,25458,25458,0
2020-09-06,1200450,202037,25458,25458,0
2020-09-06,1200609,202037,25458,25458,0
2020-09-06,1200708,202037,25458,25458,0
2020-09-06,1200807,202037,25458,25458,0
2020-09-07,1200708,202037,25459,25458,1
2020-09-07,1200013,202037,25459,25459,0
2020-09-07,1200054,202037,25460,25459,1
2020-09-07,1200104,202037,25462,25460,2
2020-09-07,1200138,202037,25463,25462,1
2020-09-07,1200179,202037,25463,25463,0
2020-09-07,1200203,202037,25463,25463,0
2020-09-07,1200302,202037,25464,25463,1
2020-09-07,1200450,202037,25465,25464,1
2020-09-07,1200500,202037,25467,25465,2
2020-09-07,1200435,202037,25467,25467,0
2020-09-07,1200427,202037,25467,25467,0
2020-09-07,1200401,202037,25477,25467,10
2020-09-07,1200252,202037,25482,25477,5
2020-09-07,1200393,202037,25482,25482,0
2020-09-07,1200385,202037,25482,25482,0
2020-09-07,1200336,202037,25482,25482,0
2020-09-07,1200351,202037,25483,25482,1
2020-09-07,1200344,202037,25483,25483,0
2020-09-07,1200328,202037,25483,25483,0
2020-09-07,1200807,202037,25484,25483,1
2020-09-07,1200609,202037,25484,25484,0
2020-09-08,1200013,202037,25486,25484,2
2020-09-08,1200054,202037,25488,25486,2
2020-09-08,1200104,202037,25490,25488,2
2020-09-08,1200179,202037,25490,25490,0
2020-09-08,1200252,202037,25490,25490,0
2020-09-08,1200302,202037,25490,25490,0
2020-09-08,1200328,202037,25490,25490,0
2020-09-08,1200344,202037,25490,25490,0
2020-09-08,1200351,202037,25490,25490,0
2020-09-08,1200336,202037,25496,25490,6
2020-09-08,1200385,202037,25496,25496,0
2020-09-08,1200807,202037,25497,25496,1
2020-09-08,1200393,202037,25497,25497,0
2020-09-08,1200401,202037,25506,25497,9
2020-09-08,1200427,202037,25506,25506,0
2020-09-08,1200435,202037,25506,25506,0
2020-09-08,1200500,202037,25506,25506,0
2020-09-08,1200203,202037,25507,25506,1
2020-09-08,1200450,202037,25508,25507,1
2020-09-08,1200609,202037,25508,25508,0
2020-09-08,1200708,202037,25509,25508,1
2020-09-08,1200138,202037,25509,25509,0
2020-09-09,1200013,202037,25509,25509,0
2020-09-09,1200054,202037,25526,25509,17
2020-09-09,1200104,202037,25526,25526,0
2020-09-09,1200138,202037,25527,25526,1
2020-09-09,1200179,202037,25527,25527,0
2020-09-09,1200203,202037,25542,25527,15
2020-09-09,1200252,202037,25543,25542,1
2020-09-09,1200302,202037,25547,25543,4
2020-09-09,1200328,202037,25547,25547,0
2020-09-09,1200344,202037,25547,25547,0
2020-09-09,1200351,202037,25559,25547,12
2020-09-09,1200385,202037,25560,25559,1
2020-09-09,1200393,202037,25560,25560,0
2020-09-09,1200807,202037,25561,25560,1
2020-09-09,1200401,202037,25578,25561,17
2020-09-09,1200427,202037,25579,25578,1
2020-09-09,1200435,202037,25594,25579,15
2020-09-09,1200500,202037,25603,25594,9
2020-09-09,1200450,202037,25616,25603,13
2020-09-09,1200609,202037,25667,25616,51
2020-09-09,1200708,202037,25683,25667,16
2020-09-09,1200336,202037,25683,25683,0
2020-09-10,1200013,202037,25686,25683,3
2020-09-10,1200054,202037,25692,25686,6
2020-09-10,1200104,202037,25694,25692,2
2020-09-10,1200138,202037,25694,25694,0
2020-09-10,1200179,202037,25694,25694,0
2020-09-10,1200203,202037,25723,25694,29
2020-09-10,1200708,202037,25749,25723,26
2020-09-10,1200328,202037,25760,25749,11
2020-09-10,1200344,202037,25763,25760,3
2020-09-10,1200351,202037,25769,25763,6
2020-09-10,1200336,202037,25782,25769,13
2020-09-10,1200385,202037,25785,25782,3
2020-09-10,1200807,202037,25785,25785,0
2020-09-10,1200393,202037,25788,25785,3
2020-09-10,1200401,202037,25817,25788,29
2020-09-10,1200427,202037,25817,25817,0
2020-09-10,1200435,202037,25821,25817,4
2020-09-10,1200500,202037,25829,25821,8
2020-09-10,1200450,202037,25831,25829,2
2020-09-10,1200609,202037,25878,25831,47
2020-09-10,1200302,202037,25892,25878,14
2020-09-10,1200252,202037,25892,25892,0
2020-09-11,1200435,202037,25898,25892,6
2020-09-11,1200393,202037,25898,25898,0
2020-09-11,1200708,202037,25913,25898,15
2020-09-11,1200609,202037,25936,25913,23
2020-09-11,1200450,202037,25939,25936,3
2020-09-11,1200500,202037,25944,25939,5
2020-09-11,1200427,202037,25944,25944,0
2020-09-11,1200401,202037,25969,25944,25
2020-09-11,1200807,202037,25970,25969,1
2020-09-11,1200385,202037,25971,25970,1
2020-09-11,1200351,202037,25981,25971,10
2020-09-11,1200336,202037,25999,25981,18
2020-09-11,1200328,202037,25999,25999,0
2020-09-11,1200302,202037,26002,25999,3
2020-09-11,1200252,202037,26001,26002,-1
2020-09-11,1200203,202037,26011,26001,10
2020-09-11,1200179,202037,26011,26011,0
2020-09-11,1200138,202037,26011,26011,0
2020-09-11,1200104,202037,26013,26011,2
2020-09-11,1200054,202037,26019,26013,6
2020-09-11,1200013,202037,26019,26019,0
2020-09-11,1200344,202037,26019,26019,0
2020-09-12,1200203,202037,26030,26019,11
2020-09-12,1200302,202037,26040,26030,10
2020-09-12,1200252,202037,26040,26040,0
2020-09-12,1200179,202037,26040,26040,0
2020-09-12,1200351,202037,26060,26040,20
2020-09-12,1200104,202037,26061,26060,1
2020-09-12,1200054,202037,26070,26061,9
2020-09-12,1200013,202037,26076,26070,6
2020-09-12,1200328,202037,26076,26076,0
2020-09-12,1200138,202037,26077,26076,1
2020-09-12,1200336,202037,26098,26077,21
2020-09-12,1200344,202037,26098,26098,0
2020-09-12,1200385,202037,26098,26098,0
2020-09-12,1200807,202037,26101,26098,3
2020-09-12,1200393,202037,26117,26101,16
2020-09-12,1200401,202037,26142,26117,25
2020-09-12,1200427,202037,26142,26142,0
2020-09-12,1200435,202037,26144,26142,2
2020-09-12,1200500,202037,26146,26144,2
2020-09-12,1200450,202037,26149,26146,3
2020-09-12,1200609,202037,26149,26149,0
2020-09-12,1200708,202037,26163,26149,14
2020-09-13,1200013,202038,26163,26163,0
2020-09-13,1200054,202038,26164,26163,1
2020-09-13,1200104,202038,26168,26164,4
2020-09-13,1200138,202038,26168,26168,0
2020-09-13,1200179,202038,26168,26168,0
2020-09-13,1200609,202038,26169,26168,1
2020-09-13,1200252,202038,26170,26169,1
2020-09-13,1200302,202038,26172,26170,2
2020-09-13,1200328,202038,26172,26172,0
2020-09-13,1200344,202038,26172,26172,0
2020-09-13,1200351,202038,26172,26172,0
2020-09-13,1200336,202038,26172,26172,0
2020-09-13,1200385,202038,26172,26172,0
2020-09-13,1200807,202038,26173,26172,1
2020-09-13,1200393,202038,26173,26173,0
2020-09-13,1200401,202038,26181,26173,8
2020-09-13,1200427,202038,26181,26181,0
2020-09-13,1200435,202038,26181,26181,0
2020-09-13,1200500,202038,26181,26181,0
2020-09-13,1200450,202038,26181,26181,0
2020-09-13,1200708,202038,26181,26181,0
2020-09-13,1200203,202038,26181,26181,0
2020-09-14,1200336,202038,26181,26181,0
2020-09-14,1200427,202038,26181,26181,0
2020-09-14,1200708,202038,26184,26181,3
2020-09-14,1200609,202038,26184,26184,0
2020-09-14,1200450,202038,26184,26184,0
2020-09-14,1200500,202038,26184,26184,0
2020-09-14,1200435,202038,26184,26184,0
2020-09-14,1200401,202038,26190,26184,6
2020-09-14,1200393,202038,26190,26190,0
2020-09-14,1200807,202038,26191,26190,1
2020-09-14,1200351,202038,26191,26191,0
2020-09-14,1200385,202038,26191,26191,0
2020-09-14,1200328,202038,26191,26191,0
2020-09-14,1200302,202038,26191,26191,0
2020-09-14,1200252,202038,26191,26191,0
2020-09-14,1200203,202038,26191,26191,0
2020-09-14,1200179,202038,26191,26191,0
2020-09-14,1200138,202038,26191,26191,0
2020-09-14,1200104,202038,26191,26191,0
2020-09-14,1200054,202038,26191,26191,0
2020-09-14,1200013,202038,26191,26191,0
2020-09-14,1200344,202038,26191,26191,0
2020-09-15,1200203,202038,26199,26191,8
2020-09-15,1200344,202038,26201,26199,2
2020-09-15,1200328,202038,26201,26201,0
2020-09-15,1200302,202038,26203,26201,2
2020-09-15,1200179,202038,26204,26203,1
2020-09-15,1200385,202038,26204,26204,0
2020-09-15,1200104,202038,26205,26204,1
2020-09-15,1200054,202038,26207,26205,2
2020-09-15,1200013,202038,26209,26207,2
2020-09-15,1200351,202038,26215,26209,6
2020-09-15,1200138,202038,26215,26215,0
2020-09-15,1200336,202038,26223,26215,8
2020-09-15,1200252,202038,26223,26223,0
2020-09-15,1200807,202038,26223,26223,0
2020-09-15,1200393,202038,26226,26223,3
2020-09-15,1200401,202038,26259,26226,33
2020-09-15,1200427,202038,26259,26259,0
2020-09-15,1200435,202038,26264,26259,5
2020-09-15,1200500,202038,26281,26264,17
2020-09-15,1200450,202038,26286,26281,5
2020-09-15,1200609,202038,26294,26286,8
2020-09-15,1200708,202038,26302,26294,8
2020-09-16,1200708,202038,26312,26302,10
2020-09-16,1200013,202038,26316,26312,4
2020-09-16,1200054,202038,26331,26316,15
2020-09-16,1200104,202038,26331,26331,0
2020-09-16,1200138,202038,26331,26331,0
2020-09-16,1200179,202038,26331,26331,0
2020-09-16,1200203,202038,26350,26331,19
2020-09-16,1200807,202038,26350,26350,0
2020-09-16,1200450,202038,26350,26350,0
2020-09-16,1200500,202038,26355,26350,5
2020-09-16,1200435,202038,26354,26355,-1
2020-09-16,1200427,202038,26354,26354,0
2020-09-16,1200401,202038,26371,26354,17
2020-09-16,1200393,202038,26380,26371,9
2020-09-16,1200252,202038,26378,26380,-2
2020-09-16,1200609,202038,26443,26378,65
2020-09-16,1200336,202038,26445,26443,2
2020-09-16,1200351,202038,26457,26445,12
2020-09-16,1200344,202038,26457,26457,0
2020-09-16,1200328,202038,26458,26457,1
2020-09-16,1200302,202038,26475,26458,17
2020-09-16,1200385,202038,26478,26475,3
2020-09-17,1200054,202038,26483,26478,5
2020-09-17,1200013,202038,26484,26483,1
2020-09-17,1200104,202038,26484,26484,0
2020-09-17,1200708,202038,26490,26484,6
2020-09-17,1200450,202038,26495,26490,5
2020-09-17,1200500,202038,26505,26495,10
2020-09-17,1200435,202038,26506,26505,1
2020-09-17,1200427,202038,26507,26506,1
2020-09-17,1200401,202038,26539,26507,32
2020-09-17,1200393,202038,26542,26539,3
2020-09-17,1200807,202038,26546,26542,4
2020-09-17,1200385,202038,26546,26546,0
2020-09-17,1200336,202038,26571,26546,25
2020-09-17,1200351,202038,26583,26571,12
2020-09-17,1200344,202038,26584,26583,1
2020-09-17,1200328,202038,26585,26584,1
2020-09-17,1200302,202038,26591,26585,6
2020-09-17,1200252,202038,26591,26591,0
2020-09-17,1200203,202038,26617,26591,26
2020-09-17,1200179,202038,26617,26617,0
2020-09-17,1200138,202038,26619,26617,2
2020-09-17,1200609,202038,26731,26619,112
2020-09-18,1200807,202038,26731,26731,0
2020-09-18,1200393,202038,26733,26731,2
2020-09-18,1200054,202038,26734,26733,1
2020-09-18,1200401,202038,26757,26734,23
2020-09-18,1200427,202038,26757,26757,0
2020-09-18,1200385,202038,26757,26757,0
2020-09-18,1200500,202038,26764,26757,7
2020-09-18,1200450,202038,26763,26764,-1
2020-09-18,1200609,202038,26848,26763,85
2020-09-18,1200708,202038,26860,26848,12
2020-09-18,1200336,202038,26902,26860,42
2020-09-18,1200351,202038,26918,26902,16
2020-09-18,1200344,202038,26921,26918,3
2020-09-18,1200328,202038,26921,26921,0
2020-09-18,1200302,202038,26928,26921,7
2020-09-18,1200252,202038,26934,26928,6
2020-09-18,1200203,202038,26958,26934,24
2020-09-18,1200179,202038,26958,26958,0
2020-09-18,1200138,202038,26958,26958,0
2020-09-18,1200104,202038,26957,26958,-1
2020-09-18,1200013,202038,26958,26957,1
2020-09-18,1200435,202038,26957,26958,-1
2020-09-19,1200435,202038,26957,26957,0
2020-09-19,1200708,202038,26966,26957,9
2020-09-19,1200500,202038,26972,26966,6
2020-09-19,1200427,202038,26973,26972,1
2020-09-19,1200401,202038,26986,26973,13
2020-09-19,1200393,202038,26987,26986,1
2020-09-19,1200807,202038,26987,26987,0
2020-09-19,1200385,202038,26990,26987,3
2020-09-19,1200336,202038,26997,26990,7
2020-09-19,1200351,202038,27003,26997,6
2020-09-19,1200344,202038,27003,27003,0
2020-09-19,1200328,202038,27011,27003,8
2020-09-19,1200302,202038,27013,27011,2
2020-09-19,1200252,202038,27015,27013,2
2020-09-19,1200203,202038,27043,27015,28
2020-09-19,1200179,202038,27043,27043,0
2020-09-19,1200138,202038,27043,27043,0
2020-09-19,1200104,202038,27044,27043,1
2020-09-19,1200054,202038,27045,27044,1
2020-09-19,1200450,202038,27050,27045,5
2020-09-19,1200609,202038,27075,27050,25
2020-09-19,1200013,202038,27076,27075,1
2020-09-20,1200336,202039,27076,27076,0
2020-09-20,1200807,202039,27076,27076,0
2020-09-20,1200393,202039,27076,27076,0
2020-09-20,1200401,202039,27090,27076,14
2020-09-20,1200427,202039,27090,27090,0
2020-09-20,1200435,202039,27090,27090,0
2020-09-20,1200500,202039,27090,27090,0
2020-09-20,1200450,202039,27090,27090,0
2020-09-20,1200609,202039,27090,27090,0
2020-09-20,1200708,202039,27090,27090,0
2020-09-20,1200351,202039,27090,27090,0
2020-09-20,1200344,202039,27090,27090,0
2020-09-20,1200328,202039,27090,27090,0
2020-09-20,1200302,202039,27092,27090,2
2020-09-20,1200252,202039,27092,27092,0
2020-09-20,1200203,202039,27094,27092,2
2020-09-20,1200179,202039,27094,27094,0
2020-09-20,1200138,202039,27094,27094,0
2020-09-20,1200104,202039,27094,27094,0
2020-09-20,1200054,202039,27094,27094,0
2020-09-20,1200013,202039,27094,27094,0
2020-09-20,1200385,202039,27094,27094,0
2020-09-21,1200252,202039,27095,27094,1
2020-09-21,1200427,202039,27095,27095,0
2020-09-21,1200708,202039,27098,27095,3
2020-09-21,1200609,202039,27098,27098,0
2020-09-21,1200450,202039,27098,27098,0
2020-09-21,1200500,202039,27098,27098,0
2020-09-21,1200435,202039,27098,27098,0
2020-09-21,1200401,202039,27111,27098,13
2020-09-21,1200393,202039,27111,27111,0
2020-09-21,1200807,202039,27112,27111,1
2020-09-21,1200336,202039,27112,27112,0
2020-09-21,1200385,202039,27112,27112,0
2020-09-21,1200344,202039,27112,27112,0
2020-09-21,1200328,202039,27112,27112,0
2020-09-21,1200302,202039,27113,27112,1
2020-09-21,1200203,202039,27114,27113,1
2020-09-21,1200179,202039,27114,27114,0
2020-09-21,1200138,202039,27114,27114,0
2020-09-21,1200104,202039,27116,27114,2
2020-09-21,1200054,202039,27116,27116,0
2020-09-21,1200013,202039,27118,27116,2
2020-09-21,1200351,202039,27121,27118,3
2020-09-22,1200252,202039,27121,27121,0
2020-09-22,1200344,202039,27127,27121,6
2020-09-22,1200328,202039,27130,27127,3
2020-09-22,1200302,202039,27134,27130,4
2020-09-22,1200203,202039,27159,27134,25
2020-09-22,1200385,202039,27159,27159,0
2020-09-22,1200138,202039,27159,27159,0
2020-09-22,1200104,202039,27161,27159,2
2020-09-22,1200013,202039,27161,27161,0
2020-09-22,1200351,202039,27165,27161,4
2020-09-22,1200179,202039,27165,27165,0
2020-09-22,1200336,202039,27180,27165,15
2020-09-22,1200054,202039,27188,27180,8
2020-09-22,1200393,202039,27190,27188,2
2020-09-22,1200401,202039,27210,27190,20
2020-09-22,1200427,202039,27210,27210,0
2020-09-22,1200435,202039,27210,27210,0
2020-09-22,1200500,202039,27223,27210,13
2020-09-22,1200450,202039,27224,27223,1
2020-09-22,1200609,202039,27255,27224,31
2020-09-22,1200708,202039,27261,27255,6
2020-09-22,1200807,202039,27261,27261,0
2020-09-23,1200708,202039,27270,27261,9
2020-09-23,1200013,202039,27274,27270,4
2020-09-23,1200054,202039,27274,27274,0
2020-09-23,1200104,202039,27276,27274,2
2020-09-23,1200138,202039,27276,27276,0
2020-09-23,1200179,202039,27276,27276,0
2020-09-23,1200203,202039,27308,27276,32
2020-09-23,1200302,202039,27317,27308,9
2020-09-23,1200450,202039,27319,27317,2
2020-09-23,1200500,202039,27324,27319,5
2020-09-23,1200435,202039,27324,27324,0
2020-09-23,1200427,202039,27324,27324,0
2020-09-23,1200401,202039,27343,27324,19
2020-09-23,1200252,202039,27347,27343,4
2020-09-23,1200393,202039,27347,27347,0
2020-09-23,1200385,202039,27343,27347,-4
2020-09-23,1200336,202039,27359,27343,16
2020-09-23,1200351,202039,27382,27359,23
2020-09-23,1200344,202039,27382,27382,0
2020-09-23,1200328,202039,27385,27382,3
2020-09-23,1200807,202039,27385,27385,0
2020-09-23,1200609,202039,27412,27385,27
2020-09-24,1200013,202039,27415,27412,3
2020-09-24,1200054,202039,27416,27415,1
2020-09-24,1200104,202039,27420,27416,4
2020-09-24,1200435,202039,27420,27420,0
2020-09-24,1200427,202039,27424,27420,4
2020-09-24,1200138,202039,27424,27424,0
2020-09-24,1200500,202039,27432,27424,8
2020-09-24,1200450,202039,27431,27432,-1
2020-09-24,1200609,202039,27483,27431,52
2020-09-24,1200708,202039,27492,27483,9
2020-09-24,1200807,202039,27492,27492,0
2020-09-24,1200385,202039,27494,27492,2
2020-09-24,1200336,202039,27507,27494,13
2020-09-24,1200351,202039,27519,27507,12
2020-09-24,1200344,202039,27520,27519,1
2020-09-24,1200328,202039,27526,27520,6
2020-09-24,1200302,202039,27533,27526,7
2020-09-24,1200252,202039,27533,27533,0
2020-09-24,1200203,202039,27547,27533,14
2020-09-24,1200179,202039,27548,27547,1
2020-09-24,1200401,202039,27571,27548,23
2020-09-24,1200393,202039,27571,27571,0
2020-09-25,1200385,202039,27571,27571,0
2020-09-25,1200393,202039,27571,27571,0
2020-09-25,1200054,202039,27584,27571,13
2020-09-25,1200104,202039,27585,27584,1
2020-09-25,1200807,202039,27587,27585,2
2020-09-25,1200138,202039,27588,27587,1
2020-09-25,1200179,202039,27588,27588,0
2020-09-25,1200203,202039,27600,27588,12
2020-09-25,1200252,202039,27600,27600,0
2020-09-25,1200302,202039,27600,27600,0
2020-09-25,1200328,202039,27600,27600,0
2020-09-25,1200344,202039,27602,27600,2
2020-09-25,1200013,202039,27604,27602,2
2020-09-25,1200351,202039,27613,27604,9
2020-09-25,1200336,202039,27617,27613,4
2020-09-25,1200427,202039,27617,27617,0
2020-09-25,1200500,202039,27627,27617,10
2020-09-25,1200450,202039,27627,27627,0
2020-09-25,1200609,202039,27693,27627,66
2020-09-25,1200708,202039,27703,27693,10
2020-09-25,1200401,202039,27724,27703,21
2020-09-25,1200435,202039,27725,27724,1
2020-09-26,1200013,202039,27727,27725,2
2020-09-26,1200054,202039,27738,27727,11
2020-09-26,1200104,202039,27739,27738,1
2020-09-26,1200138,202039,27739,27739,0
2020-09-26,1200179,202039,27739,27739,0
2020-09-26,1200203,202039,27748,27739,9
2020-09-26,1200252,202039,27749,27748,1
2020-09-26,1200328,202039,27754,27749,5
2020-09-26,1200302,202039,27757,27754,3
2020-09-26,1200351,202039,27779,27757,22
2020-09-26,1200336,202039,27804,27779,25
2020-09-26,1200385,202039,27804,27804,0
2020-09-26,1200807,202039,27804,27804,0
2020-09-26,1200393,202039,27804,27804,0
2020-09-26,1200401,202039,27833,27804,29
2020-09-26,1200427,202039,27836,27833,3
2020-09-26,1200435,202039,27839,27836,3
2020-09-26,1200500,202039,27842,27839,3
2020-09-26,1200450,202039,27842,27842,0
2020-09-26,1200609,202039,27863,27842,21
2020-09-26,1200708,202039,27868,27863,5
2020-09-26,1200344,202039,27874,27868,6
2020-09-27,1200104,202040,27874,27874,0
2020-09-27,1200179,202040,27874,27874,0
2020-09-27,1200138,202040,27874,27874,0
2020-09-27,1200013,202040,27874,27874,0
2020-09-27,1200054,202040,27874,27874,0
2020-09-27,1200609,202040,27874,27874,0
2020-09-27,1200450,202040,27874,27874,0
2020-09-27,1200500,202040,27874,27874,0
2020-09-27,1200435,202040,27874,27874,0
2020-09-27,1200427,202040,27874,27874,0
2020-09-27,1200401,202040,27874,27874,0
2020-09-27,1200393,202040,27874,27874,0
2020-09-27,1200708,202040,27874,27874,0
2020-09-27,1200807,202040,27874,27874,0
2020-09-27,1200336,202040,27874,27874,0
2020-09-27,1200351,202040,27874,27874,0
2020-09-27,1200344,202040,27874,27874,0
2020-09-27,1200328,202040,27874,27874,0
2020-09-27,1200302,202040,27874,27874,0
2020-09-27,1200252,202040,27874,27874,0
2020-09-27,1200385,202040,27874,27874,0
2020-09-27,1200203,202040,27874,27874,0
2020-09-28,1200427,202040,27875,27874,1
2020-09-28,1200393,202040,27875,27875,0
2020-09-28,1200054,202040,27875,27875,0
2020-09-28,1200104,202040,27875,27875,0
2020-09-28,1200138,202040,27875,27875,0
2020-09-28,1200179,202040,27875,27875,0
2020-09-28,1200203,202040,27875,27875,0
2020-09-28,1200252,202040,27875,27875,0
2020-09-28,1200302,202040,27876,27875,1
2020-09-28,1200328,202040,27876,27876,0
2020-09-28,1200344,202040,27876,27876,0
2020-09-28,1200351,202040,27876,27876,0
2020-09-28,1200336,202040,27876,27876,0
2020-09-28,1200385,202040,27876,27876,0
2020-09-28,1200013,202040,27876,27876,0
2020-09-28,1200807,202040,27876,27876,0
2020-09-28,1200401,202040,27899,27876,23
2020-09-28,1200500,202040,27899,27899,0
2020-09-28,1200450,202040,27899,27899,0
2020-09-28,1200609,202040,27899,27899,0
2020-09-28,1200708,202040,27900,27899,1
2020-09-28,1200435,202040,27900,27900,0
2020-09-29,1200344,202040,27900,27900,0
2020-09-29,1200104,202040,27901,27900,1
2020-09-29,1200138,202040,27903,27901,2
2020-09-29,1200179,202040,27906,27903,3
2020-09-29,1200203,202040,27906,27906,0
2020-09-29,1200252,202040,27906,27906,0
2020-09-29,1200302,202040,27912,27906,6
2020-09-29,1200328,202040,27913,27912,1
2020-09-29,1200351,202040,27922,27913,9
2020-09-29,1200385,202040,27923,27922,1
2020-09-29,1200054,202040,27925,27923,2
2020-09-29,1200807,202040,27925,27925,0
2020-09-29,1200393,202040,27925,27925,0
2020-09-29,1200401,202040,27941,27925,16
2020-09-29,1200427,202040,27941,27941,0
2020-09-29,1200435,202040,27942,27941,1
2020-09-29,1200500,202040,27955,27942,13
2020-09-29,1200450,202040,27956,27955,1
2020-09-29,1200609,202040,28023,27956,67
2020-09-29,1200708,202040,28045,28023,22
2020-09-29,1200336,202040,28045,28045,0
2020-09-29,1200013,202040,28045,28045,0
2020-09-30,1200252,202040,28052,28045,7
2020-09-30,1200013,202040,28055,28052,3
2020-09-30,1200054,202040,28064,28055,9
2020-09-30,1200203,202040,28084,28064,20
2020-09-30,1200179,202040,28086,28084,2
2020-09-30,1200104,202040,28074,28086,-12
2020-09-30,1200138,202040,28075,28074,1
2020-09-30,1200393,202040,28075,28075,0
2020-09-30,1200302,202040,28083,28075,8
2020-09-30,1200328,202040,28083,28083,0
2020-09-30,1200344,202040,28084,28083,1
2020-09-30,1200351,202040,28104,28084,20
2020-09-30,1200336,202040,28104,28104,0
2020-09-30,1200385,202040,28104,28104,0
2020-09-30,1200807,202040,28104,28104,0
2020-09-30,1200708,202040,28118,28104,14
2020-09-30,1200401,202040,28156,28118,38
2020-09-30,1200427,202040,28156,28156,0
2020-09-30,1200435,202040,28156,28156,0
2020-09-30,1200500,202040,28164,28156,8
2020-09-30,1200450,202040,28165,28164,1
2020-09-30,1200609,202040,28237,28165,72
2020-10-01,1200500,202040,28249,28237,12
2020-10-01,1200013,202040,28249,28249,0
2020-10-01,1200435,202040,28249,28249,0
2020-10-01,1200054,202040,28250,28249,1
2020-10-01,1200138,202040,28251,28250,1
2020-10-01,1200427,202040,28251,28251,0
2020-10-01,1200609,202040,28314,28251,63
2020-10-01,1200708,202040,28326,28314,12
2020-10-01,1200401,202040,28349,28326,23
2020-10-01,1200393,202040,28351,28349,2
2020-10-01,1200807,202040,28351,28351,0
2020-10-01,1200385,202040,28352,28351,1
2020-10-01,1200336,202040,28404,28352,52
2020-10-01,1200351,202040,28411,28404,7
2020-10-01,1200344,202040,28411,28411,0
2020-10-01,1200328,202040,28411,28411,0
2020-10-01,1200302,202040,28412,28411,1
2020-10-01,1200252,202040,28412,28412,0
2020-10-01,1200203,202040,28424,28412,12
2020-10-01,1200179,202040,28424,28424,0
2020-10-01,1200104,202040,28424,28424,0
2020-10-01,1200450,202040,28424,28424,0
2020-10-02,1200807,202040,28424,28424,0
2020-10-02,1200401,202040,28424,28424,0
2020-10-02,1200708,202040,28424,28424,0
2020-10-02,1200609,202040,28424,28424,0
2020-10-02,1200450,202040,28424,28424,0
2020-10-02,1200500,202040,28424,28424,0
2020-10-02,1200435,202040,28424,28424,0
2020-10-02,1200427,202040,28424,28424,0
2020-10-02,1200393,202040,28424,28424,0
2020-10-02,1200385,202040,28424,28424,0
2020-10-02,1200351,202040,28424,28424,0
2020-10-02,1200336,202040,28424,28424,0
2020-10-02,1200328,202040,28424,28424,0
2020-10-02,1200302,202040,28424,28424,0
2020-10-02,1200252,202040,28424,28424,0
2020-10-02,1200203,202040,28424,28424,0
2020-10-02,1200179,202040,28424,28424,0
2020-10-02,1200138,202040,28424,28424,0
2020-10-02,1200104,202040,28424,28424,0
2020-10-02,1200054,202040,28424,28424,0
2020-10-02,1200013,202040,28424,28424,0
2020-10-02,1200344,202040,28424,28424,0
2020-10-03,1200203,202040,28431,28424,7
2020-10-03,1200302,202040,28440,28431,9
2020-10-03,1200252,202040,28443,28440,3
2020-10-03,1200179,202040,28443,28443,0
2020-10-03,1200385,202040,28443,28443,0
2020-10-03,1200104,202040,28443,28443,0
2020-10-03,1200054,202040,28453,28443,10
2020-10-03,1200013,202040,28454,28453,1
2020-10-03,1200344,202040,28457,28454,3
2020-10-03,1200138,202040,28457,28457,0
2020-10-03,1200336,202040,28475,28457,18
2020-10-03,1200351,202040,28478,28475,3
2020-10-03,1200328,202040,28478,28478,0
2020-10-03,1200807,202040,28482,28478,4
2020-10-03,1200393,202040,28482,28482,0
2020-10-03,1200401,202040,28519,28482,37
2020-10-03,1200427,202040,28521,28519,2
2020-10-03,1200435,202040,28543,28521,22
2020-10-03,1200500,202040,28553,28543,10
2020-10-03,1200450,202040,28553,28553,0
2020-10-03,1200609,202040,28655,28553,102
2020-10-03,1200708,202040,28677,28655,22
2020-10-04,1200013,202041,28677,28677,0
2020-10-04,1200054,202041,28677,28677,0
2020-10-04,1200104,202041,28677,28677,0
2020-10-04,1200138,202041,28677,28677,0
2020-10-04,1200179,202041,28677,28677,0
2020-10-04,1200609,202041,28677,28677,0
2020-10-04,1200252,202041,28677,28677,0
2020-10-04,1200302,202041,28677,28677,0
2020-10-04,1200328,202041,28677,28677,0
2020-10-04,1200344,202041,28677,28677,0
2020-10-04,1200351,202041,28677,28677,0
2020-10-04,1200336,202041,28678,28677,1
2020-10-04,1200385,202041,28678,28678,0
2020-10-04,1200807,202041,28679,28678,1
2020-10-04,1200393,202041,28679,28679,0
2020-10-04,1200401,202041,28686,28679,7
2020-10-04,1200427,202041,28686,28686,0
2020-10-04,1200435,202041,28686,28686,0
2020-10-04,1200500,202041,28686,28686,0
2020-10-04,1200450,202041,28686,28686,0
2020-10-04,1200708,202041,28687,28686,1
2020-10-04,1200203,202041,28687,28687,0
2020-10-05,1200500,202041,28687,28687,0
2020-10-05,1200401,202041,28695,28687,8
2020-10-05,1200708,202041,28695,28695,0
2020-10-05,1200609,202041,28695,28695,0
2020-10-05,1200450,202041,28695,28695,0
2020-10-05,1200435,202041,28695,28695,0
2020-10-05,1200427,202041,28695,28695,0
2020-10-05,1200393,202041,28695,28695,0
2020-10-05,1200807,202041,28695,28695,0
2020-10-05,1200385,202041,28695,28695,0
2020-10-05,1200351,202041,28696,28695,1
2020-10-05,1200336,202041,28697,28696,1
2020-10-05,1200328,202041,28697,28697,0
2020-10-05,1200302,202041,28698,28697,1
2020-10-05,1200252,202041,28699,28698,1
2020-10-05,1200203,202041,28700,28699,1
2020-10-05,1200179,202041,28700,28700,0
2020-10-05,1200138,202041,28700,28700,0
2020-10-05,1200104,202041,28702,28700,2
2020-10-05,1200054,202041,28702,28702,0
2020-10-05,1200013,202041,28702,28702,0
2020-10-05,1200344,202041,28702,28702,0
2020-10-06,1200203,202041,28721,28702,19
2020-10-06,1200328,202041,28722,28721,1
2020-10-06,1200302,202041,28722,28722,0
2020-10-06,1200252,202041,28722,28722,0
2020-10-06,1200179,202041,28722,28722,0
2020-10-06,1200385,202041,28722,28722,0
2020-10-06,1200104,202041,28725,28722,3
2020-10-06,1200054,202041,28725,28725,0
2020-10-06,1200013,202041,28725,28725,0
2020-10-06,1200344,202041,28726,28725,1
2020-10-06,1200138,202041,28732,28726,6
2020-10-06,1200336,202041,28732,28732,0
2020-10-06,1200807,202041,28734,28732,2
2020-10-06,1200393,202041,28734,28734,0
2020-10-06,1200401,202041,28752,28734,18
2020-10-06,1200427,202041,28752,28752,0
2020-10-06,1200435,202041,28753,28752,1
2020-10-06,1200500,202041,28762,28753,9
2020-10-06,1200450,202041,28762,28762,0
2020-10-06,1200609,202041,28793,28762,31
2020-10-06,1200708,202041,28817,28793,24
2020-10-06,1200351,202041,28820,28817,3
2020-10-07,1200708,202041,28820,28820,0
2020-10-07,1200013,202041,28820,28820,0
2020-10-07,1200054,202041,28820,28820,0
2020-10-07,1200104,202041,28820,28820,0
2020-10-07,1200138,202041,28820,28820,0
2020-10-07,1200179,202041,28820,28820,0
2020-10-07,1200203,202041,28819,28820,-1
2020-10-07,1200302,202041,28819,28819,0
2020-10-07,1200450,202041,28819,28819,0
2020-10-07,1200500,202041,28819,28819,0
2020-10-07,1200435,202041,28819,28819,0
2020-10-07,1200427,202041,28819,28819,0
2020-10-07,1200401,202041,28833,28819,14
2020-10-07,1200252,202041,28833,28833,0
2020-10-07,1200393,202041,28833,28833,0
2020-10-07,1200385,202041,28833,28833,0
2020-10-07,1200336,202041,28833,28833,0
2020-10-07,1200351,202041,28833,28833,0
2020-10-07,1200344,202041,28833,28833,0
2020-10-07,1200328,202041,28833,28833,0
2020-10-07,1200807,202041,28833,28833,0
2020-10-07,1200609,202041,28833,28833,0
2020-10-08,1200013,202041,28833,28833,0
2020-10-08,1200054,202041,28833,28833,0
2020-10-08,1200104,202041,28833,28833,0
2020-10-08,1200708,202041,28833,28833,0
2020-10-08,1200450,202041,28833,28833,0
2020-10-08,1200500,202041,28833,28833,0
2020-10-08,1200435,202041,28833,28833,0
2020-10-08,1200427,202041,28833,28833,0
2020-10-08,1200401,202041,28846,28833,13
2020-10-08,1200393,202041,28846,28846,0
2020-10-08,1200807,202041,28846,28846,0
2020-10-08,1200385,202041,28846,28846,0
2020-10-08,1200336,202041,28846,28846,0
2020-10-08,1200351,202041,28846,28846,0
2020-10-08,1200344,202041,28846,28846,0
2020-10-08,1200328,202041,28846,28846,0
2020-10-08,1200302,202041,28846,28846,0
2020-10-08,1200252,202041,28846,28846,0
2020-10-08,1200203,202041,28847,28846,1
2020-10-08,1200179,202041,28847,28847,0
2020-10-08,1200138,202041,28849,28847,2
2020-10-08,1200609,202041,28849,28849,0
2020-10-09,1200807,202041,28850,28849,1
2020-10-09,1200393,202041,28850,28850,0
2020-10-09,1200054,202041,28860,28850,10
2020-10-09,1200401,202041,28900,28860,40
2020-10-09,1200427,202041,28908,28900,8
2020-10-09,1200385,202041,28909,28908,1
2020-10-09,1200500,202041,28923,28909,14
2020-10-09,1200450,202041,28923,28923,0
2020-10-09,1200609,202041,28956,28923,33
2020-10-09,1200708,202041,28990,28956,34
2020-10-09,1200336,202041,29002,28990,12
2020-10-09,1200351,202041,29012,29002,10
2020-10-09,1200344,202041,29018,29012,6
2020-10-09,1200328,202041,29019,29018,1
2020-10-09,1200302,202041,29023,29019,4
2020-10-09,1200252,202041,29024,29023,1
2020-10-09,1200203,202041,29027,29024,3
2020-10-09,1200179,202041,29027,29027,0
2020-10-09,1200138,202041,29027,29027,0
2020-10-09,1200104,202041,29027,29027,0
2020-10-09,1200013,202041,29032,29027,5
2020-10-09,1200435,202041,29032,29032,0
2020-10-10,1200336,202041,29032,29032,0
2020-10-10,1200401,202041,29044,29032,12
2020-10-10,1200708,202041,29044,29044,0
2020-10-10,1200609,202041,29044,29044,0
2020-10-10,1200450,202041,29044,29044,0
2020-10-10,1200500,202041,29044,29044,0
2020-10-10,1200435,202041,29044,29044,0
2020-10-10,1200427,202041,29044,29044,0
2020-10-10,1200393,202041,29044,29044,0
2020-10-10,1200807,202041,29044,29044,0
2020-10-10,1200351,202041,29045,29044,1
2020-10-10,1200385,202041,29045,29045,0
2020-10-10,1200328,202041,29045,29045,0
2020-10-10,1200302,202041,29045,29045,0
2020-10-10,1200252,202041,29045,29045,0
2020-10-10,1200203,202041,29045,29045,0
2020-10-10,1200179,202041,29045,29045,0
2020-10-10,1200138,202041,29045,29045,0
2020-10-10,1200104,202041,29045,29045,0
2020-10-10,1200054,202041,29045,29045,0
2020-10-10,1200013,202041,29046,29045,1
2020-10-10,1200344,202041,29046,29046,0
2020-10-11,1200203,202042,29047,29046,1
2020-10-11,1200328,202042,29047,29047,0
2020-10-11,1200302,202042,29048,29047,1
2020-10-11,1200179,202042,29048,29048,0
2020-10-11,1200385,202042,29048,29048,0
2020-10-11,1200104,202042,29048,29048,0
2020-10-11,1200054,202042,29048,29048,0
2020-10-11,1200013,202042,29048,29048,0
2020-10-11,1200344,202042,29048,29048,0
2020-10-11,1200138,202042,29048,29048,0
2020-10-11,1200336,202042,29048,29048,0
2020-10-11,1200351,202042,29049,29048,1
2020-10-11,1200252,202042,29049,29049,0
2020-10-11,1200807,202042,29049,29049,0
2020-10-11,1200393,202042,29049,29049,0
2020-10-11,1200401,202042,29065,29049,16
2020-10-11,1200427,202042,29065,29065,0
2020-10-11,1200435,202042,29065,29065,0
2020-10-11,1200500,202042,29065,29065,0
2020-10-11,1200450,202042,29065,29065,0
2020-10-11,1200609,202042,29065,29065,0
2020-10-11,1200708,202042,29065,29065,0
2020-10-12,1200013,202042,29065,29065,0
2020-10-12,1200054,202042,29065,29065,0
2020-10-12,1200104,202042,29065,29065,0
2020-10-12,1200138,202042,29065,29065,0
2020-10-12,1200179,202042,29065,29065,0
2020-10-12,1200609,202042,29065,29065,0
2020-10-12,1200252,202042,29065,29065,0
2020-10-12,1200302,202042,29065,29065,0
2020-10-12,1200328,202042,29065,29065,0
2020-10-12,1200344,202042,29065,29065,0
2020-10-12,1200351,202042,29065,29065,0
2020-10-12,1200336,202042,29065,29065,0
2020-10-12,1200385,202042,29065,29065,0
2020-10-12,1200807,202042,29065,29065,0
2020-10-12,1200393,202042,29065,29065,0
2020-10-12,1200401,202042,29078,29065,13
2020-10-12,1200427,202042,29078,29078,0
2020-10-12,1200435,202042,29078,29078,0
2020-10-12,1200500,202042,29078,29078,0
2020-10-12,1200450,202042,29078,29078,0
2020-10-12,1200708,202042,29078,29078,0
2020-10-12,1200203,202042,29078,29078,0
2020-10-13,1200500,202042,29105,29078,27
2020-10-13,1200054,202042,29106,29105,1
2020-10-13,1200708,202042,29146,29106,40
2020-10-13,1200609,202042,29160,29146,14
2020-10-13,1200450,202042,29162,29160,2
2020-10-13,1200435,202042,29162,29162,0
2020-10-13,1200401,202042,29201,29162,39
2020-10-13,1200393,202042,29201,29201,0
2020-10-13,1200807,202042,29201,29201,0
2020-10-13,1200385,202042,29203,29201,2
2020-10-13,1200336,202042,29253,29203,50
2020-10-13,1200427,202042,29252,29253,-1
2020-10-13,1200344,202042,29256,29252,4
2020-10-13,1200328,202042,29256,29256,0
2020-10-13,1200302,202042,29258,29256,2
2020-10-13,1200252,202042,29259,29258,1
2020-10-13,1200203,202042,29274,29259,15
2020-10-13,1200179,202042,29274,29274,0
2020-10-13,1200138,202042,29276,29274,2
2020-10-13,1200104,202042,29278,29276,2
2020-10-13,1200013,202042,29278,29278,0
2020-10-13,1200351,202042,29287,29278,9
2020-10-14,1200344,202042,29287,29287,0
2020-10-14,1200328,202042,29287,29287,0
2020-10-14,1200302,202042,29287,29287,0
2020-10-14,1200252,202042,29287,29287,0
2020-10-14,1200203,202042,29288,29287,1
2020-10-14,1200013,202042,29288,29288,0
2020-10-14,1200138,202042,29288,29288,0
2020-10-14,1200104,202042,29288,29288,0
2020-10-14,1200054,202042,29288,29288,0
2020-10-14,1200351,202042,29288,29288,0
2020-10-14,1200179,202042,29288,29288,0
2020-10-14,1200336,202042,29288,29288,0
2020-10-14,1200385,202042,29288,29288,0
2020-10-14,1200393,202042,29288,29288,0
2020-10-14,1200401,202042,29316,29288,28
2020-10-14,1200427,202042,29316,29316,0
2020-10-14,1200435,202042,29316,29316,0
2020-10-14,1200500,202042,29316,29316,0
2020-10-14,1200450,202042,29316,29316,0
2020-10-14,1200609,202042,29316,29316,0
2020-10-14,1200708,202042,29316,29316,0
2020-10-14,1200807,202042,29316,29316,0
2020-10-15,1200708,202042,29329,29316,13
2020-10-15,1200013,202042,29329,29329,0
2020-10-15,1200054,202042,29328,29329,-1
2020-10-15,1200104,202042,29328,29328,0
2020-10-15,1200138,202042,29329,29328,1
2020-10-15,1200179,202042,29329,29329,0
2020-10-15,1200203,202042,29344,29329,15
2020-10-15,1200302,202042,29344,29344,0
2020-10-15,1200450,202042,29345,29344,1
2020-10-15,1200500,202042,29352,29345,7
2020-10-15,1200435,202042,29352,29352,0
2020-10-15,1200427,202042,29359,29352,7
2020-10-15,1200401,202042,29391,29359,32
2020-10-15,1200252,202042,29393,29391,2
2020-10-15,1200393,202042,29393,29393,0
2020-10-15,1200385,202042,29394,29393,1
2020-10-15,1200336,202042,29395,29394,1
2020-10-15,1200351,202042,29409,29395,14
2020-10-15,1200344,202042,29409,29409,0
2020-10-15,1200328,202042,29409,29409,0
2020-10-15,1200807,202042,29409,29409,0
2020-10-15,1200609,202042,29421,29409,12
2020-10-16,1200013,202042,29422,29421,1
2020-10-16,1200054,202042,29471,29422,49
2020-10-16,1200104,202042,29472,29471,1
2020-10-16,1200179,202042,29472,29472,0
2020-10-16,1200252,202042,29472,29472,0
2020-10-16,1200302,202042,29474,29472,2
2020-10-16,1200328,202042,29474,29474,0
2020-10-16,1200344,202042,29474,29474,0
2020-10-16,1200351,202042,29479,29474,5
2020-10-16,1200336,202042,29482,29479,3
2020-10-16,1200385,202042,29482,29482,0
2020-10-16,1200807,202042,29482,29482,0
2020-10-16,1200393,202042,29483,29482,1
2020-10-16,1200401,202042,29522,29483,39
2020-10-16,1200427,202042,29531,29522,9
2020-10-16,1200435,202042,29531,29531,0
2020-10-16,1200500,202042,29552,29531,21
2020-10-16,1200203,202042,29566,29552,14
2020-10-16,1200450,202042,29567,29566,1
2020-10-16,1200609,202042,29567,29567,0
2020-10-16,1200708,202042,29612,29567,45
2020-10-16,1200138,202042,29613,29612,1
2020-10-17,1200013,202042,29614,29613,1
2020-10-17,1200054,202042,29616,29614,2
2020-10-17,1200104,202042,29616,29616,0
2020-10-17,1200138,202042,29618,29616,2
2020-10-17,1200179,202042,29618,29618,0
2020-10-17,1200203,202042,29627,29618,9
2020-10-17,1200252,202042,29629,29627,2
2020-10-17,1200302,202042,29636,29629,7
2020-10-17,1200328,202042,29636,29636,0
2020-10-17,1200344,202042,29637,29636,1
2020-10-17,1200351,202042,29643,29637,6
2020-10-17,1200385,202042,29643,29643,0
2020-10-17,1200393,202042,29643,29643,0
2020-10-17,1200807,202042,29643,29643,0
2020-10-17,1200401,202042,29678,29643,35
2020-10-17,1200427,202042,29683,29678,5
2020-10-17,1200435,202042,29683,29683,0
2020-10-17,1200500,202042,29695,29683,12
2020-10-17,1200450,202042,29695,29695,0
2020-10-17,1200609,202042,29695,29695,0
2020-10-17,1200708,202042,29699,29695,4
2020-10-17,1200336,202042,29708,29699,9
2020-10-18,1200013,202043,29708,29708,0
2020-10-18,1200054,202043,29708,29708,0
2020-10-18,1200104,202043,29710,29708,2
2020-10-18,1200138,202043,29710,29710,0
2020-10-18,1200179,202043,29710,29710,0
2020-10-18,1200203,202043,29711,29710,1
2020-10-18,1200708,202043,29711,29711,0
2020-10-18,1200328,202043,29711,29711,0
2020-10-18,1200344,202043,29711,29711,0
2020-10-18,1200351,202043,29711,29711,0
2020-10-18,1200336,202043,29711,29711,0
2020-10-18,1200385,202043,29711,29711,0
2020-10-18,1200807,202043,29711,29711,0
2020-10-18,1200393,202043,29711,29711,0
2020-10-18,1200401,202043,29733,29711,22
2020-10-18,1200427,202043,29733,29733,0
2020-10-18,1200435,202043,29733,29733,0
2020-10-18,1200500,202043,29733,29733,0
2020-10-18,1200450,202043,29733,29733,0
2020-10-18,1200609,202043,29733,29733,0
2020-10-18,1200302,202043,29733,29733,0
2020-10-18,1200252,202043,29733,29733,0
2020-10-19,1200435,202043,29733,29733,0
2020-10-19,1200393,202043,29733,29733,0
2020-10-19,1200708,202043,29733,29733,0
2020-10-19,1200609,202043,29733,29733,0
2020-10-19,1200450,202043,29735,29733,2
2020-10-19,1200500,202043,29735,29735,0
2020-10-19,1200427,202043,29736,29735,1
2020-10-19,1200401,202043,29771,29736,35
2020-10-19,1200807,202043,29771,29771,0
2020-10-19,1200385,202043,29771,29771,0
2020-10-19,1200351,202043,29771,29771,0
2020-10-19,1200336,202043,29771,29771,0
2020-10-19,1200328,202043,29771,29771,0
2020-10-19,1200302,202043,29771,29771,0
2020-10-19,1200252,202043,29772,29771,1
2020-10-19,1200203,202043,29775,29772,3
2020-10-19,1200179,202043,29775,29775,0
2020-10-19,1200138,202043,29775,29775,0
2020-10-19,1200104,202043,29775,29775,0
2020-10-19,1200054,202043,29775,29775,0
2020-10-19,1200013,202043,29780,29775,5
2020-10-19,1200344,202043,29780,29780,0
2020-10-20,1200203,202043,29787,29780,7
2020-10-20,1200302,202043,29787,29787,0
2020-10-20,1200252,202043,29787,29787,0
2020-10-20,1200179,202043,29788,29787,1
2020-10-20,1200351,202043,29789,29788,1
2020-10-20,1200104,202043,29790,29789,1
2020-10-20,1200054,202043,29796,29790,6
2020-10-20,1200013,202043,29796,29796,0
2020-10-20,1200328,202043,29796,29796,0
2020-10-20,1200138,202043,29798,29796,2
2020-10-20,1200336,202043,29803,29798,5
2020-10-20,1200344,202043,29806,29803,3
2020-10-20,1200385,202043,29806,29806,0
2020-10-20,1200807,202043,29806,29806,0
2020-10-20,1200393,202043,29806,29806,0
2020-10-20,1200401,202043,29832,29806,26
2020-10-20,1200427,202043,29832,29832,0
2020-10-20,1200435,202043,29832,29832,0
2020-10-20,1200500,202043,29866,29832,34
2020-10-20,1200450,202043,29867,29866,1
2020-10-20,1200609,202043,29867,29867,0
2020-10-20,1200708,202043,29880,29867,13
2020-10-21,1200013,202043,29880,29880,0
2020-10-21,1200054,202043,29880,29880,0
2020-10-21,1200104,202043,29880,29880,0
2020-10-21,1200138,202043,29881,29880,1
2020-10-21,1200179,202043,29881,29881,0
2020-10-21,1200609,202043,29881,29881,0
2020-10-21,1200252,202043,29881,29881,0
2020-10-21,1200302,202043,29881,29881,0
2020-10-21,1200328,202043,29881,29881,0
2020-10-21,1200344,202043,29885,29881,4
2020-10-21,1200351,202043,29885,29885,0
2020-10-21,1200336,202043,29887,29885,2
2020-10-21,1200385,202043,29888,29887,1
2020-10-21,1200807,202043,29888,29888,0
2020-10-21,1200393,202043,29889,29888,1
2020-10-21,1200401,202043,29916,29889,27
2020-10-21,1200427,202043,29916,29916,0
2020-10-21,1200435,202043,29916,29916,0
2020-10-21,1200500,202043,29920,29916,4
2020-10-21,1200450,202043,29920,29920,0
2020-10-21,1200708,202043,29925,29920,5
2020-10-21,1200203,202043,29940,29925,15
2020-10-22,1200336,202043,29954,29940,14
2020-10-22,1200427,202043,29954,29954,0
2020-10-22,1200708,202043,29961,29954,7
2020-10-22,1200609,202043,29961,29961,0
2020-10-22,1200450,202043,29962,29961,1
2020-10-22,1200500,202043,29968,29962,6
2020-10-22,1200435,202043,29968,29968,0
2020-10-22,1200401,202043,30026,29968,58
2020-10-22,1200393,202043,30026,30026,0
2020-10-22,1200807,202043,30026,30026,0
2020-10-22,1200351,202043,30027,30026,1
2020-10-22,1200385,202043,30027,30027,0
2020-10-22,1200328,202043,30027,30027,0
2020-10-22,1200302,202043,30029,30027,2
2020-10-22,1200252,202043,30029,30029,0
2020-10-22,1200203,202043,30032,30029,3
2020-10-22,1200179,202043,30032,30032,0
2020-10-22,1200138,202043,30034,30032,2
2020-10-22,1200104,202043,30040,30034,6
2020-10-22,1200054,202043,30041,30040,1
2020-10-22,1200013,202043,30041,30041,0
2020-10-22,1200344,202043,30043,30041,2
2020-10-23,1200203,202043,30048,30043,5
2020-10-23,1200344,202043,30048,30048,0
2020-10-23,1200328,202043,30048,30048,0
2020-10-23,1200302,202043,30053,30048,5
2020-10-23,1200179,202043,30053,30053,0
2020-10-23,1200385,202043,30053,30053,0
2020-10-23,1200104,202043,30054,30053,1
2020-10-23,1200054,202043,30055,30054,1
2020-10-23,1200013,202043,30059,30055,4
2020-10-23,1200351,202043,30059,30059,0
2020-10-23,1200138,202043,30061,30059,2
2020-10-23,1200336,202043,30071,30061,10
2020-10-23,1200252,202043,30071,30071,0
2020-10-23,1200807,202043,30071,30071,0
2020-10-23,1200393,202043,30071,30071,0
2020-10-23,1200401,202043,30115,30071,44
2020-10-23,1200427,202043,30116,30115,1
2020-10-23,1200435,202043,30116,30116,0
2020-10-23,1200500,202043,30122,30116,6
2020-10-23,1200450,202043,30122,30122,0
2020-10-23,1200609,202043,30121,30122,-1
2020-10-23,1200708,202043,30136,30121,15
2020-10-24,1200708,202043,30145,30136,9
2020-10-24,1200013,202043,30147,30145,2
2020-10-24,1200054,202043,30148,30147,1
2020-10-24,1200104,202043,30157,30148,9
2020-10-24,1200138,202043,30158,30157,1
2020-10-24,1200179,202043,30158,30158,0
2020-10-24,1200203,202043,30165,30158,7
2020-10-24,1200807,202043,30165,30165,0
2020-10-24,1200450,202043,30165,30165,0
2020-10-24,1200500,202043,30168,30165,3
2020-10-24,1200435,202043,30168,30168,0
2020-10-24,1200427,202043,30168,30168,0
2020-10-24,1200401,202043,30205,30168,37
2020-10-24,1200393,202043,30205,30205,0
2020-10-24,1200252,202043,30206,30205,1
2020-10-24,1200609,202043,30216,30206,10
2020-10-24,1200336,202043,30225,30216,9
2020-10-24,1200351,202043,30229,30225,4
2020-10-24,1200344,202043,30230,30229,1
2020-10-24,1200328,202043,30230,30230,0
2020-10-24,1200302,202043,30232,30230,2
2020-10-24,1200385,202043,30232,30232,0
2020-10-25,1200054,202044,30232,30232,0
2020-10-25,1200013,202044,30232,30232,0
2020-10-25,1200104,202044,30232,30232,0
2020-10-25,1200708,202044,30232,30232,0
2020-10-25,1200450,202044,30232,30232,0
2020-10-25,1200500,202044,30232,30232,0
2020-10-25,1200435,202044,30232,30232,0
2020-10-25,1200427,202044,30232,30232,0
2020-10-25,1200401,202044,30313,30232,81
2020-10-25,1200393,202044,30313,30313,0
2020-10-25,1200807,202044,30314,30313,1
2020-10-25,1200385,202044,30316,30314,2
2020-10-25,1200336,202044,30316,30316,0
2020-10-25,1200351,202044,30316,30316,0
2020-10-25,1200344,202044,30316,30316,0
2020-10-25,1200328,202044,30316,30316,0
2020-10-25,1200302,202044,30318,30316,2
2020-10-25,1200252,202044,30318,30318,0
2020-10-25,1200203,202044,30318,30318,0
2020-10-25,1200179,202044,30318,30318,0
2020-10-25,1200138,202044,30319,30318,1
2020-10-25,1200609,202044,30319,30319,0
2020-10-26,1200807,202044,30319,30319,0
2020-10-26,1200393,202044,30319,30319,0
2020-10-26,1200054,202044,30319,30319,0
2020-10-26,1200401,202044,30328,30319,9
2020-10-26,1200427,202044,30328,30328,0
2020-10-26,1200385,202044,30328,30328,0
2020-10-26,1200500,202044,30329,30328,1
2020-10-26,1200450,202044,30329,30329,0
2020-10-26,1200609,202044,30329,30329,0
2020-10-26,1200708,202044,30329,30329,0
2020-10-26,1200336,202044,30329,30329,0
2020-10-26,1200351,202044,30329,30329,0
2020-10-26,1200344,202044,30329,30329,0
2020-10-26,1200328,202044,30329,30329,0
2020-10-26,1200302,202044,30329,30329,0
2020-10-26,1200252,202044,30329,30329,0
2020-10-26,1200203,202044,30331,30329,2
2020-10-26,1200179,202044,30331,30331,0
2020-10-26,1200138,202044,30331,30331,0
2020-10-26,1200104,202044,30333,30331,2
2020-10-26,1200013,202044,30332,30333,-1
2020-10-26,1200435,202044,30332,30332,0
2020-10-27,1200435,202044,30332,30332,0
2020-10-27,1200708,202044,30338,30332,6
2020-10-27,1200500,202044,30340,30338,2
2020-10-27,1200427,202044,30340,30340,0
2020-10-27,1200401,202044,30357,30340,17
2020-10-27,1200393,202044,30358,30357,1
2020-10-27,1200807,202044,30359,30358,1
2020-10-27,1200385,202044,30359,30359,0
2020-10-27,1200336,202044,30358,30359,-1
2020-10-27,1200351,202044,30370,30358,12
2020-10-27,1200344,202044,30376,30370,6
2020-10-27,1200328,202044,30376,30376,0
2020-10-27,1200302,202044,30376,30376,0
2020-10-27,1200252,202044,30378,30376,2
2020-10-27,1200203,202044,30382,30378,4
2020-10-27,1200179,202044,30382,30382,0
2020-10-27,1200138,202044,30385,30382,3
2020-10-27,1200104,202044,30384,30385,-1
2020-10-27,1200054,202044,30384,30384,0
2020-10-27,1200450,202044,30385,30384,1
2020-10-27,1200609,202044,30395,30385,10
2020-10-27,1200013,202044,30395,30395,0
2020-10-28,1200336,202044,30398,30395,3
2020-10-28,1200807,202044,30398,30398,0
2020-10-28,1200393,202044,30398,30398,0
2020-10-28,1200401,202044,30531,30398,133
2020-10-28,1200427,202044,30531,30531,0
2020-10-28,1200435,202044,30531,30531,0
2020-10-28,1200500,202044,30536,30531,5
2020-10-28,1200450,202044,30537,30536,1
2020-10-28,1200609,202044,30545,30537,8
2020-10-28,1200708,202044,30549,30545,4
2020-10-28,1200351,202044,30550,30549,1
2020-10-28,1200344,202044,30551,30550,1
2020-10-28,1200328,202044,30551,30551,0
2020-10-28,1200302,202044,30551,30551,0
2020-10-28,1200252,202044,30552,30551,1
2020-10-28,1200203,202044,30558,30552,6
2020-10-28,1200179,202044,30558,30558,0
2020-10-28,1200138,202044,30558,30558,0
2020-10-28,1200104,202044,30558,30558,0
2020-10-28,1200054,202044,30559,30558,1
2020-10-28,1200013,202044,30560,30559,1
2020-10-28,1200385,202044,30560,30560,0
2020-10-29,1200252,202044,30560,30560,0
2020-10-29,1200427,202044,30560,30560,0
2020-10-29,1200708,202044,30561,30560,1
2020-10-29,1200609,202044,30562,30561,1
2020-10-29,1200450,202044,30562,30562,0
2020-10-29,1200500,202044,30567,30562,5
2020-10-29,1200435,202044,30567,30567,0
2020-10-29,1200401,202044,30621,30567,54
2020-10-29,1200393,202044,30621,30621,0
2020-10-29,1200807,202044,30621,30621,0
2020-10-29,1200336,202044,30628,30621,7
2020-10-29,1200385,202044,30628,30628,0
2020-10-29,1200344,202044,30630,30628,2
2020-10-29,1200328,202044,30630,30630,0
2020-10-29,1200302,202044,30630,30630,0
2020-10-29,1200203,202044,30636,30630,6
2020-10-29,1200179,202044,30636,30636,0
2020-10-29,1200138,202044,30637,30636,1
2020-10-29,1200104,202044,30639,30637,2
2020-10-29,1200054,202044,30639,30639,0
2020-10-29,1200013,202044,30640,30639,1
2020-10-29,1200351,202044,30653,30640,13
2020-10-30,1200252,202044,30654,30653,1
2020-10-30,1200344,202044,30656,30654,2
2020-10-30,1200328,202044,30656,30656,0
2020-10-30,1200302,202044,30656,30656,0
2020-10-30,1200203,202044,30659,30656,3
2020-10-30,1200385,202044,30662,30659,3
2020-10-30,1200138,202044,30663,30662,1
2020-10-30,1200104,202044,30664,30663,1
2020-10-30,1200013,202044,30664,30664,0
2020-10-30,1200351,202044,30663,30664,-1
2020-10-30,1200179,202044,30663,30663,0
2020-10-30,1200336,202044,30664,30663,1
2020-10-30,1200054,202044,30664,30664,0
2020-10-30,1200393,202044,30664,30664,0
2020-10-30,1200401,202044,30751,30664,87
2020-10-30,1200427,202044,30751,30751,0
2020-10-30,1200435,202044,30751,30751,0
2020-10-30,1200500,202044,30753,30751,2
2020-10-30,1200450,202044,30758,30753,5
2020-10-30,1200609,202044,30767,30758,9
2020-10-30,1200708,202044,30771,30767,4
2020-10-30,1200807,202044,30773,30771,2
2020-10-31,1200708,202044,30773,30773,0
2020-10-31,1200013,202044,30773,30773,0
2020-10-31,1200054,202044,30773,30773,0
2020-10-31,1200104,202044,30773,30773,0
2020-10-31,1200138,202044,30773,30773,0
2020-10-31,1200179,202044,30773,30773,0
2020-10-31,1200203,202044,30774,30773,1
2020-10-31,1200302,202044,30774,30774,0
2020-10-31,1200450,202044,30774,30774,0
2020-10-31,1200500,202044,30774,30774,0
2020-10-31,1200435,202044,30774,30774,0
2020-10-31,1200427,202044,30776,30774,2
2020-10-31,1200401,202044,30786,30776,10
2020-10-31,1200252,202044,30786,30786,0
2020-10-31,1200393,202044,30786,30786,0
2020-10-31,1200385,202044,30786,30786,0
2020-10-31,1200336,202044,30811,30786,25
2020-10-31,1200351,202044,30811,30811,0
2020-10-31,1200344,202044,30811,30811,0
2020-10-31,1200328,202044,30811,30811,0
2020-10-31,1200807,202044,30811,30811,0
2020-10-31,1200609,202044,30811,30811,0
2020-11-01,1200013,202045,30811,30811,0
2020-11-01,1200054,202045,30811,30811,0
2020-11-01,1200104,202045,30811,30811,0
2020-11-01,1200435,202045,30811,30811,0
2020-11-01,1200427,202045,30811,30811,0
2020-11-01,1200138,202045,30811,30811,0
2020-11-01,1200500,202045,30811,30811,0
2020-11-01,1200450,202045,30812,30811,1
2020-11-01,1200609,202045,30812,30812,0
2020-11-01,1200708,202045,30812,30812,0
2020-11-01,1200807,202045,30812,30812,0
2020-11-01,1200385,202045,30812,30812,0
2020-11-01,1200336,202045,30812,30812,0
2020-11-01,1200351,202045,30812,30812,0
2020-11-01,1200344,202045,30812,30812,0
2020-11-01,1200328,202045,30812,30812,0
2020-11-01,1200302,202045,30817,30812,5
2020-11-01,1200252,202045,30818,30817,1
2020-11-01,1200203,202045,30822,30818,4
2020-11-01,1200179,202045,30822,30822,0
2020-11-01,1200401,202045,30965,30822,143
2020-11-01,1200393,202045,30966,30965,1
2020-11-02,1200385,202045,30966,30966,0
2020-11-02,1200393,202045,30966,30966,0
2020-11-02,1200054,202045,30966,30966,0
2020-11-02,1200104,202045,30966,30966,0
2020-11-02,1200807,202045,30966,30966,0
2020-11-02,1200138,202045,30966,30966,0
2020-11-02,1200179,202045,30966,30966,0
2020-11-02,1200203,202045,30968,30966,2
2020-11-02,1200252,202045,30968,30968,0
2020-11-02,1200302,202045,30968,30968,0
2020-11-02,1200328,202045,30968,30968,0
2020-11-02,1200344,202045,30968,30968,0
2020-11-02,1200013,202045,30968,30968,0
2020-11-02,1200351,202045,30968,30968,0
2020-11-02,1200336,202045,30968,30968,0
2020-11-02,1200500,202045,30968,30968,0
2020-11-02,1200609,202045,30968,30968,0
2020-11-02,1200427,202045,30968,30968,0
2020-11-02,1200708,202045,30968,30968,0
2020-11-02,1200435,202045,30968,30968,0
2020-11-02,1200401,202045,30969,30968,1
2020-11-02,1200450,202045,30969,30969,0
2020-11-03,1200013,202045,30969,30969,0
2020-11-03,1200054,202045,30969,30969,0
2020-11-03,1200104,202045,30970,30969,1
2020-11-03,1200138,202045,30970,30970,0
2020-11-03,1200179,202045,30970,30970,0
2020-11-03,1200203,202045,30972,30970,2
2020-11-03,1200252,202045,30972,30972,0
2020-11-03,1200328,202045,30972,30972,0
2020-11-03,1200302,202045,30972,30972,0
2020-11-03,1200336,202045,30974,30972,2
2020-11-03,1200385,202045,30974,30974,0
2020-11-03,1200807,202045,30973,30974,-1
2020-11-03,1200393,202045,30973,30973,0
2020-11-03,1200401,202045,30975,30973,2
2020-11-03,1200427,202045,30977,30975,2
2020-11-03,1200435,202045,30977,30977,0
2020-11-03,1200500,202045,30977,30977,0
2020-11-03,1200450,202045,30977,30977,0
2020-11-03,1200609,202045,30977,30977,0
2020-11-03,1200708,202045,30977,30977,0
2020-11-03,1200351,202045,30977,30977,0
2020-11-03,1200344,202045,30977,30977,0
2020-11-04,1200179,202045,30978,30977,1
2020-11-04,1200138,202045,30978,30978,0
2020-11-04,1200104,202045,30978,30978,0
2020-11-04,1200013,202045,30978,30978,0
2020-11-04,1200054,202045,30979,30978,1
2020-11-04,1200807,202045,30979,30979,0
2020-11-04,1200500,202045,30986,30979,7
2020-11-04,1200435,202045,30986,30986,0
2020-11-04,1200427,202045,30988,30986,2
2020-11-04,1200401,202045,31220,30988,232
2020-11-04,1200393,202045,31219,31220,-1
2020-11-04,1200708,202045,31223,31219,4
2020-11-04,1200450,202045,31223,31223,0
2020-11-04,1200385,202045,31224,31223,1
2020-11-04,1200351,202045,31227,31224,3
2020-11-04,1200344,202045,31227,31227,0
2020-11-04,1200328,202045,31227,31227,0
2020-11-04,1200302,202045,31227,31227,0
2020-11-04,1200252,202045,31227,31227,0
2020-11-04,1200203,202045,31232,31227,5
2020-11-04,1200336,202045,31232,31232,0
2020-11-04,1200609,202045,31233,31232,1
2020-11-05,1200427,202045,31237,31233,4
2020-11-05,1200401,202045,31254,31237,17
2020-11-05,1200013,202045,31254,31254,0
2020-11-05,1200104,202045,31256,31254,2
2020-11-05,1200435,202045,31256,31256,0
2020-11-05,1200393,202045,31256,31256,0
2020-11-05,1200450,202045,31256,31256,0
2020-11-05,1200609,202045,31257,31256,1
2020-11-05,1200708,202045,31262,31257,5
2020-11-05,1200807,202045,31262,31262,0
2020-11-05,1200385,202045,31263,31262,1
2020-11-05,1200054,202045,31263,31263,0
2020-11-05,1200336,202045,31263,31263,0
2020-11-05,1200344,202045,31263,31263,0
2020-11-05,1200328,202045,31263,31263,0
2020-11-05,1200302,202045,31263,31263,0
2020-11-05,1200252,202045,31263,31263,0
2020-11-05,1200203,202045,31263,31263,0
2020-11-05,1200179,202045,31263,31263,0
2020-11-05,1200138,202045,31263,31263,0
2020-11-05,1200351,202045,31263,31263,0
2020-11-05,1200500,202045,31263,31263,0
2020-11-06,1200385,202045,31263,31263,0
2020-11-06,1200401,202045,31283,31263,20
2020-11-06,1200708,202045,31298,31283,15
2020-11-06,1200609,202045,31298,31298,0
2020-11-06,1200450,202045,31302,31298,4
2020-11-06,1200500,202045,31305,31302,3
2020-11-06,1200435,202045,31305,31305,0
2020-11-06,1200427,202045,31306,31305,1
2020-11-06,1200393,202045,31306,31306,0
2020-11-06,1200807,202045,31307,31306,1
2020-11-06,1200351,202045,31308,31307,1
2020-11-06,1200336,202045,31308,31308,0
2020-11-06,1200328,202045,31313,31308,5
2020-11-06,1200302,202045,31321,31313,8
2020-11-06,1200252,202045,31322,31321,1
2020-11-06,1200203,202045,31333,31322,11
2020-11-06,1200179,202045,31333,31333,0
2020-11-06,1200138,202045,31333,31333,0
2020-11-06,1200104,202045,31333,31333,0
2020-11-06,1200054,202045,31341,31333,8
2020-11-06,1200013,202045,31341,31341,0
2020-11-06,1200344,202045,31341,31341,0
2020-11-07,1200203,202045,31344,31341,3
2020-11-07,1200328,202045,31344,31344,0
2020-11-07,1200252,202045,31346,31344,2
2020-11-07,1200179,202045,31346,31346,0
2020-11-07,1200385,202045,31346,31346,0
2020-11-07,1200104,202045,31348,31346,2
2020-11-07,1200054,202045,31350,31348,2
2020-11-07,1200013,202045,31356,31350,6
2020-11-07,1200344,202045,31362,31356,6
2020-11-07,1200138,202045,31368,31362,6
2020-11-07,1200336,202045,31368,31368,0
2020-11-07,1200351,202045,31370,31368,2
2020-11-07,1200302,202045,31370,31370,0
2020-11-07,1200807,202045,31371,31370,1
2020-11-07,1200393,202045,31371,31371,0
2020-11-07,1200401,202045,31569,31371,198
2020-11-07,1200427,202045,31569,31569,0
2020-11-07,1200435,202045,31569,31569,0
2020-11-07,1200500,202045,31578,31569,9
2020-11-07,1200450,202045,31578,31578,0
2020-11-07,1200609,202045,31584,31578,6
2020-11-07,1200708,202045,31590,31584,6
2020-11-08,1200013,202046,31590,31590,0
2020-11-08,1200054,202046,31590,31590,0
2020-11-08,1200104,202046,31590,31590,0
2020-11-08,1200138,202046,31592,31590,2
2020-11-08,1200179,202046,31592,31592,0
2020-11-08,1200609,202046,31592,31592,0
2020-11-08,1200252,202046,31594,31592,2
2020-11-08,1200302,202046,31595,31594,1
2020-11-08,1200328,202046,31595,31595,0
2020-11-08,1200344,202046,31595,31595,0
2020-11-08,1200351,202046,31595,31595,0
2020-11-08,1200336,202046,31595,31595,0
2020-11-08,1200385,202046,31597,31595,2
2020-11-08,1200807,202046,31598,31597,1
2020-11-08,1200393,202046,31598,31598,0
2020-11-08,1200401,202046,31716,31598,118
2020-11-08,1200427,202046,31716,31716,0
2020-11-08,1200435,202046,31716,31716,0
2020-11-08,1200500,202046,31716,31716,0
2020-11-08,1200450,202046,31721,31716,5
2020-11-08,1200708,202046,31721,31721,0
2020-11-08,1200203,202046,31722,31721,1
2020-11-09,1200252,202046,31722,31722,0
2020-11-09,1200427,202046,31722,31722,0
2020-11-09,1200708,202046,31727,31722,5
2020-11-09,1200609,202046,31728,31727,1
2020-11-09,1200450,202046,31728,31728,0
2020-11-09,1200500,202046,31731,31728,3
2020-11-09,1200435,202046,31731,31731,0
2020-11-09,1200401,202046,31797,31731,66
2020-11-09,1200393,202046,31797,31797,0
2020-11-09,1200807,202046,31797,31797,0
2020-11-09,1200336,202046,31798,31797,1
2020-11-09,1200385,202046,31798,31798,0
2020-11-09,1200344,202046,31798,31798,0
2020-11-09,1200328,202046,31798,31798,0
2020-11-09,1200302,202046,31798,31798,0
2020-11-09,1200203,202046,31799,31798,1
2020-11-09,1200179,202046,31799,31799,0
2020-11-09,1200138,202046,31799,31799,0
2020-11-09,1200104,202046,31801,31799,2
2020-11-09,1200054,202046,31803,31801,2
2020-11-09,1200013,202046,31802,31803,-1
2020-11-09,1200351,202046,31803,31802,1
2020-11-10,1200252,202046,31802,31803,-1
2020-11-10,1200344,202046,31804,31802,2
2020-11-10,1200328,202046,31804,31804,0
2020-11-10,1200302,202046,31805,31804,1
2020-11-10,1200203,202046,31820,31805,15
2020-11-10,1200385,202046,31821,31820,1
2020-11-10,1200138,202046,31822,31821,1
2020-11-10,1200104,202046,31827,31822,5
2020-11-10,1200013,202046,31827,31827,0
2020-11-10,1200351,202046,31830,31827,3
2020-11-10,1200179,202046,31830,31830,0
2020-11-10,1200336,202046,31830,31830,0
2020-11-10,1200054,202046,31830,31830,0
2020-11-10,1200807,202046,31831,31830,1
2020-11-10,1200393,202046,31831,31831,0
2020-11-10,1200401,202046,31940,31831,109
2020-11-10,1200427,202046,31940,31940,0
2020-11-10,1200435,202046,31940,31940,0
2020-11-10,1200500,202046,31940,31940,0
2020-11-10,1200450,202046,31940,31940,0
2020-11-10,1200609,202046,31940,31940,0
2020-11-10,1200708,202046,31941,31940,1
2020-11-11,1200708,202046,31947,31941,6
2020-11-11,1200013,202046,31947,31947,0
2020-11-11,1200054,202046,31947,31947,0
2020-11-11,1200104,202046,31947,31947,0
2020-11-11,1200138,202046,31948,31947,1
2020-11-11,1200179,202046,31949,31948,1
2020-11-11,1200203,202046,31967,31949,18
2020-11-11,1200807,202046,31972,31967,5
2020-11-11,1200450,202046,31973,31972,1
2020-11-11,1200500,202046,31982,31973,9
2020-11-11,1200435,202046,31982,31982,0
2020-11-11,1200427,202046,31990,31982,8
2020-11-11,1200401,202046,32110,31990,120
2020-11-11,1200393,202046,32110,32110,0
2020-11-11,1200252,202046,32110,32110,0
2020-11-11,1200609,202046,32110,32110,0
2020-11-11,1200336,202046,32111,32110,1
2020-11-11,1200351,202046,32122,32111,11
2020-11-11,1200344,202046,32123,32122,1
2020-11-11,1200328,202046,32123,32123,0
2020-11-11,1200302,202046,32128,32123,5
2020-11-11,1200385,202046,32128,32128,0
2020-11-12,1200054,202046,32128,32128,0
2020-11-12,1200013,202046,32128,32128,0
2020-11-12,1200104,202046,32131,32128,3
2020-11-12,1200708,202046,32155,32131,24
2020-11-12,1200450,202046,32158,32155,3
2020-11-12,1200500,202046,32169,32158,11
2020-11-12,1200435,202046,32170,32169,1
2020-11-12,1200427,202046,32174,32170,4
2020-11-12,1200401,202046,32468,32174,294
2020-11-12,1200393,202046,32469,32468,1
2020-11-12,1200807,202046,32469,32469,0
2020-11-12,1200385,202046,32469,32469,0
2020-11-12,1200336,202046,32501,32469,32
2020-11-12,1200351,202046,32504,32501,3
2020-11-12,1200344,202046,32505,32504,1
2020-11-12,1200328,202046,32508,32505,3
2020-11-12,1200302,202046,32511,32508,3
2020-11-12,1200252,202046,32513,32511,2
2020-11-12,1200203,202046,32520,32513,7
2020-11-12,1200179,202046,32520,32520,0
2020-11-12,1200138,202046,32530,32520,10
2020-11-12,1200609,202046,32530,32530,0
2020-11-13,1200807,202046,32530,32530,0
2020-11-13,1200393,202046,32530,32530,0
2020-11-13,1200054,202046,32531,32530,1
2020-11-13,1200401,202046,32657,32531,126
2020-11-13,1200427,202046,32657,32657,0
2020-11-13,1200385,202046,32657,32657,0
2020-11-13,1200500,202046,32658,32657,1
2020-11-13,1200450,202046,32660,32658,2
2020-11-13,1200609,202046,32660,32660,0
2020-11-13,1200708,202046,32671,32660,11
2020-11-13,1200336,202046,32671,32671,0
2020-11-13,1200351,202046,32671,32671,0
2020-11-13,1200344,202046,32671,32671,0
2020-11-13,1200328,202046,32671,32671,0
2020-11-13,1200302,202046,32673,32671,2
2020-11-13,1200252,202046,32673,32673,0
2020-11-13,1200203,202046,32673,32673,0
2020-11-13,1200179,202046,32673,32673,0
2020-11-13,1200138,202046,32674,32673,1
2020-11-13,1200104,202046,32676,32674,2
2020-11-13,1200013,202046,32676,32676,0
2020-11-13,1200435,202046,32676,32676,0
2020-11-14,1200435,202046,32676,32676,0
2020-11-14,1200708,202046,32689,32676,13
2020-11-14,1200500,202046,32704,32689,15
2020-11-14,1200427,202046,32704,32704,0
2020-11-14,1200401,202046,32980,32704,276
2020-11-14,1200393,202046,32980,32980,0
2020-11-14,1200807,202046,32984,32980,4
2020-11-14,1200385,202046,32984,32984,0
2020-11-14,1200336,202046,32984,32984,0
2020-11-14,1200351,202046,32988,32984,4
2020-11-14,1200344,202046,32989,32988,1
2020-11-14,1200328,202046,32989,32989,0
2020-11-14,1200302,202046,32994,32989,5
2020-11-14,1200252,202046,32994,32994,0
2020-11-14,1200203,202046,33003,32994,9
2020-11-14,1200179,202046,33004,33003,1
2020-11-14,1200138,202046,33004,33004,0
2020-11-14,1200104,202046,33005,33004,1
2020-11-14,1200054,202046,33005,33005,0
2020-11-14,1200450,202046,33005,33005,0
2020-11-14,1200609,202046,33005,33005,0
2020-11-14,1200013,202046,33006,33005,1
2020-11-15,1200336,202047,33006,33006,0
2020-11-15,1200807,202047,33007,33006,1
2020-11-15,1200393,202047,33007,33007,0
2020-11-15,1200401,202047,33161,33007,154
2020-11-15,1200427,202047,33161,33161,0
2020-11-15,1200435,202047,33161,33161,0
2020-11-15,1200500,202047,33161,33161,0
2020-11-15,1200450,202047,33164,33161,3
2020-11-15,1200609,202047,33164,33164,0
2020-11-15,1200708,202047,33164,33164,0
2020-11-15,1200351,202047,33164,33164,0
2020-11-15,1200344,202047,33164,33164,0
2020-11-15,1200328,202047,33164,33164,0
2020-11-15,1200302,202047,33164,33164,0
2020-11-15,1200252,202047,33164,33164,0
2020-11-15,1200203,202047,33166,33164,2
2020-11-15,1200179,202047,33167,33166,1
2020-11-15,1200138,202047,33169,33167,2
2020-11-15,1200104,202047,33169,33169,0
2020-11-15,1200054,202047,33169,33169,0
2020-11-15,1200013,202047,33169,33169,0
2020-11-15,1200385,202047,33171,33169,2
2020-11-16,1200336,202047,33171,33171,0
2020-11-16,1200427,202047,33171,33171,0
2020-11-16,1200708,202047,33171,33171,0
2020-11-16,1200609,202047,33171,33171,0
2020-11-16,1200450,202047,33172,33171,1
2020-11-16,1200500,202047,33172,33172,0
2020-11-16,1200435,202047,33172,33172,0
2020-11-16,1200401,202047,33299,33172,127
2020-11-16,1200393,202047,33299,33299,0
2020-11-16,1200807,202047,33301,33299,2
2020-11-16,1200351,202047,33301,33301,0
2020-11-16,1200385,202047,33301,33301,0
2020-11-16,1200328,202047,33301,33301,0
2020-11-16,1200302,202047,33301,33301,0
2020-11-16,1200252,202047,33304,33301,3
2020-11-16,1200203,202047,33307,33304,3
2020-11-16,1200179,202047,33307,33307,0
2020-11-16,1200138,202047,33307,33307,0
2020-11-16,1200104,202047,33310,33307,3
2020-11-16,1200054,202047,33310,33310,0
2020-11-16,1200013,202047,33310,33310,0
2020-11-16,1200344,202047,33310,33310,0
2020-11-17,1200203,202047,33315,33310,5
2020-11-17,1200344,202047,33315,33315,0
2020-11-17,1200328,202047,33324,33315,9
2020-11-17,1200302,202047,33324,33324,0
2020-11-17,1200179,202047,33324,33324,0
2020-11-17,1200385,202047,33325,33324,1
2020-11-17,1200104,202047,33326,33325,1
2020-11-17,1200054,202047,33326,33326,0
2020-11-17,1200013,202047,33326,33326,0
2020-11-17,1200351,202047,33327,33326,1
2020-11-17,1200138,202047,33327,33327,0
2020-11-17,1200336,202047,33327,33327,0
2020-11-17,1200252,202047,33327,33327,0
2020-11-17,1200393,202047,33327,33327,0
2020-11-17,1200401,202047,33475,33327,148
2020-11-17,1200427,202047,33476,33475,1
2020-11-17,1200435,202047,33476,33476,0
2020-11-17,1200500,202047,33487,33476,11
2020-11-17,1200450,202047,33487,33487,0
2020-11-17,1200609,202047,33488,33487,1
2020-11-17,1200708,202047,33491,33488,3
2020-11-17,1200807,202047,33490,33491,-1
2020-11-18,1200708,202047,33489,33490,-1
2020-11-18,1200013,202047,33489,33489,0
2020-11-18,1200054,202047,33492,33489,3
2020-11-18,1200104,202047,33492,33492,0
2020-11-18,1200138,202047,33492,33492,0
2020-11-18,1200179,202047,33492,33492,0
2020-11-18,1200203,202047,33496,33492,4
2020-11-18,1200302,202047,33501,33496,5
2020-11-18,1200450,202047,33501,33501,0
2020-11-18,1200500,202047,33511,33501,10
2020-11-18,1200435,202047,33511,33511,0
2020-11-18,1200427,202047,33511,33511,0
2020-11-18,1200401,202047,33734,33511,223
2020-11-18,1200252,202047,33734,33734,0
2020-11-18,1200393,202047,33734,33734,0
2020-11-18,1200385,202047,33736,33734,2
2020-11-18,1200336,202047,33736,33736,0
2020-11-18,1200351,202047,33739,33736,3
2020-11-18,1200344,202047,33740,33739,1
2020-11-18,1200328,202047,33740,33740,0
2020-11-18,1200807,202047,33740,33740,0
2020-11-18,1200609,202047,33740,33740,0
2020-11-19,1200013,202047,33740,33740,0
2020-11-19,1200054,202047,33740,33740,0
2020-11-19,1200104,202047,33743,33740,3
2020-11-19,1200179,202047,33743,33743,0
2020-11-19,1200252,202047,33743,33743,0
2020-11-19,1200302,202047,33743,33743,0
2020-11-19,1200328,202047,33743,33743,0
2020-11-19,1200344,202047,33748,33743,5
2020-11-19,1200351,202047,33748,33748,0
2020-11-19,1200336,202047,33764,33748,16
2020-11-19,1200385,202047,33765,33764,1
2020-11-19,1200807,202047,33765,33765,0
2020-11-19,1200393,202047,33765,33765,0
2020-11-19,1200401,202047,33949,33765,184
2020-11-19,1200427,202047,33949,33949,0
2020-11-19,1200435,202047,33949,33949,0
2020-11-19,1200500,202047,33968,33949,19
2020-11-19,1200203,202047,33985,33968,17
2020-11-19,1200450,202047,33986,33985,1
2020-11-19,1200609,202047,33987,33986,1
2020-11-19,1200708,202047,33991,33987,4
2020-11-19,1200138,202047,33991,33991,0
2020-11-20,1200013,202047,33996,33991,5
2020-11-20,1200054,202047,34000,33996,4
2020-11-20,1200104,202047,34004,34000,4
2020-11-20,1200138,202047,34004,34004,0
2020-11-20,1200179,202047,34007,34004,3
2020-11-20,1200203,202047,34014,34007,7
2020-11-20,1200252,202047,34019,34014,5
2020-11-20,1200302,202047,34035,34019,16
2020-11-20,1200328,202047,34035,34035,0
2020-11-20,1200344,202047,34042,34035,7
2020-11-20,1200351,202047,34042,34042,0
2020-11-20,1200385,202047,34053,34042,11
2020-11-20,1200393,202047,34053,34053,0
2020-11-20,1200807,202047,34063,34053,10
2020-11-20,1200401,202047,34214,34063,151
2020-11-20,1200427,202047,34214,34214,0
2020-11-20,1200435,202047,34214,34214,0
2020-11-20,1200500,202047,34226,34214,12
2020-11-20,1200450,202047,34228,34226,2
2020-11-20,1200609,202047,34238,34228,10
2020-11-20,1200708,202047,34249,34238,11
2020-11-20,1200336,202047,34261,34249,12
2020-11-21,1200013,202047,34261,34261,0
2020-11-21,1200054,202047,34261,34261,0
2020-11-21,1200104,202047,34262,34261,1
2020-11-21,1200138,202047,34261,34262,-1
2020-11-21,1200179,202047,34261,34261,0
2020-11-21,1200203,202047,34261,34261,0
2020-11-21,1200708,202047,34264,34261,3
2020-11-21,1200328,202047,34264,34264,0
2020-11-21,1200344,202047,34266,34264,2
2020-11-21,1200351,202047,34267,34266,1
2020-11-21,1200336,202047,34284,34267,17
2020-11-21,1200385,202047,34284,34284,0
2020-11-21,1200807,202047,34284,34284,0
2020-11-21,1200393,202047,34284,34284,0
2020-11-21,1200401,202047,34444,34284,160
2020-11-21,1200427,202047,34445,34444,1
2020-11-21,1200435,202047,34445,34445,0
2020-11-21,1200500,202047,34451,34445,6
2020-11-21,1200450,202047,34451,34451,0
2020-11-21,1200609,202047,34451,34451,0
2020-11-21,1200302,202047,34450,34451,-1
2020-11-21,1200252,202047,34450,34450,0
2020-11-22,1200435,202048,34450,34450,0
2020-11-22,1200393,202048,34450,34450,0
2020-11-22,1200708,202048,34450,34450,0
2020-11-22,1200609,202048,34450,34450,0
2020-11-22,1200450,202048,34458,34450,8
2020-11-22,1200500,202048,34458,34458,0
2020-11-22,1200427,202048,34458,34458,0
2020-11-22,1200401,202048,34619,34458,161
2020-11-22,1200807,202048,34620,34619,1
2020-11-22,1200385,202048,34625,34620,5
2020-11-22,1200351,202048,34625,34625,0
2020-11-22,1200336,202048,34625,34625,0
2020-11-22,1200328,202048,34625,34625,0
2020-11-22,1200302,202048,34636,34625,11
2020-11-22,1200252,202048,34637,34636,1
2020-11-22,1200203,202048,34638,34637,1
2020-11-22,1200179,202048,34638,34638,0
2020-11-22,1200138,202048,34638,34638,0
2020-11-22,1200104,202048,34641,34638,3
2020-11-22,1200054,202048,34641,34641,0
2020-11-22,1200013,202048,34641,34641,0
2020-11-22,1200344,202048,34641,34641,0
2020-11-23,1200203,202048,34645,34641,4
2020-11-23,1200302,202048,34645,34645,0
2020-11-23,1200252,202048,34646,34645,1
2020-11-23,1200179,202048,34646,34646,0
2020-11-23,1200351,202048,34647,34646,1
2020-11-23,1200104,202048,34647,34647,0
2020-11-23,1200054,202048,34647,34647,0
2020-11-23,1200013,202048,34647,34647,0
2020-11-23,1200328,202048,34647,34647,0
2020-11-23,1200138,202048,34648,34647,1
2020-11-23,1200336,202048,34649,34648,1
2020-11-23,1200344,202048,34649,34649,0
2020-11-23,1200385,202048,34655,34649,6
2020-11-23,1200807,202048,34655,34655,0
2020-11-23,1200393,202048,34655,34655,0
2020-11-23,1200401,202048,34843,34655,188
2020-11-23,1200427,202048,34843,34843,0
2020-11-23,1200435,202048,34843,34843,0
2020-11-23,1200500,202048,34843,34843,0
2020-11-23,1200450,202048,34850,34843,7
2020-11-23,1200609,202048,34860,34850,10
2020-11-23,1200708,202048,34864,34860,4
2020-11-24,1200013,202048,34864,34864,0
2020-11-24,1200054,202048,34864,34864,0
2020-11-24,1200104,202048,34865,34864,1
2020-11-24,1200138,202048,34864,34865,-1
2020-11-24,1200179,202048,34866,34864,2
2020-11-24,1200609,202048,34880,34866,14
2020-11-24,1200252,202048,34879,34880,-1
2020-11-24,1200302,202048,34878,34879,-1
2020-11-24,1200328,202048,34878,34878,0
2020-11-24,1200344,202048,34889,34878,11
2020-11-24,1200351,202048,34889,34889,0
2020-11-24,1200336,202048,34889,34889,0
2020-11-24,1200385,202048,34889,34889,0
2020-11-24,1200807,202048,34890,34889,1
2020-11-24,1200393,202048,34890,34890,0
2020-11-24,1200401,202048,35015,34890,125
2020-11-24,1200427,202048,35015,35015,0
2020-11-24,1200435,202048,35015,35015,0
2020-11-24,1200500,202048,35057,35015,42
2020-11-24,1200450,202048,35057,35057,0
2020-11-24,1200708,202048,35062,35057,5
2020-11-24,1200203,202048,35068,35062,6
2020-11-25,1200336,202048,35068,35068,0
2020-11-25,1200427,202048,35068,35068,0
2020-11-25,1200708,202048,35068,35068,0
2020-11-25,1200609,202048,35068,35068,0
2020-11-25,1200450,202048,35069,35068,1
2020-11-25,1200500,202048,35069,35069,0
2020-11-25,1200435,202048,35069,35069,0
2020-11-25,1200401,202048,35195,35069,126
2020-11-25,1200393,202048,35195,35195,0
2020-11-25,1200807,202048,35199,35195,4
2020-11-25,1200351,202048,35199,35199,0
2020-11-25,1200385,202048,35200,35199,1
2020-11-25,1200328,202048,35200,35200,0
2020-11-25,1200302,202048,35200,35200,0
2020-11-25,1200252,202048,35200,35200,0
2020-11-25,1200203,202048,35203,35200,3
2020-11-25,1200179,202048,35203,35203,0
2020-11-25,1200138,202048,35203,35203,0
2020-11-25,1200104,202048,35203,35203,0
2020-11-25,1200054,202048,35203,35203,0
2020-11-25,1200013,202048,35203,35203,0
2020-11-25,1200344,202048,35203,35203,0
2020-11-26,1200203,202048,35204,35203,1
2020-11-26,1200344,202048,35204,35204,0
2020-11-26,1200328,202048,35204,35204,0
2020-11-26,1200302,202048,35204,35204,0
2020-11-26,1200179,202048,35215,35204,11
2020-11-26,1200385,202048,35215,35215,0
2020-11-26,1200104,202048,35218,35215,3
2020-11-26,1200054,202048,35218,35218,0
2020-11-26,1200013,202048,35218,35218,0
2020-11-26,1200351,202048,35218,35218,0
2020-11-26,1200138,202048,35220,35218,2
2020-11-26,1200336,202048,35221,35220,1
2020-11-26,1200252,202048,35225,35221,4
2020-11-26,1200807,202048,35225,35225,0
2020-11-26,1200393,202048,35225,35225,0
2020-11-26,1200401,202048,35317,35225,92
2020-11-26,1200427,202048,35317,35317,0
2020-11-26,1200435,202048,35317,35317,0
2020-11-26,1200500,202048,35317,35317,0
2020-11-26,1200450,202048,35319,35317,2
2020-11-26,1200609,202048,35319,35319,0
2020-11-26,1200708,202048,35319,35319,0
2020-11-27,1200708,202048,35351,35319,32
2020-11-27,1200013,202048,35355,35351,4
2020-11-27,1200054,202048,35355,35355,0
2020-11-27,1200104,202048,35356,35355,1
2020-11-27,1200138,202048,35356,35356,0
2020-11-27,1200179,202048,35356,35356,0
2020-11-27,1200203,202048,35395,35356,39
2020-11-27,1200807,202048,35408,35395,13
2020-11-27,1200450,202048,35412,35408,4
2020-11-27,1200500,202048,35461,35412,49
2020-11-27,1200435,202048,35463,35461,2
2020-11-27,1200427,202048,35470,35463,7
2020-11-27,1200401,202048,35641,35470,171
2020-11-27,1200393,202048,35641,35641,0
2020-11-27,1200252,202048,35641,35641,0
2020-11-27,1200609,202048,35665,35641,24
2020-11-27,1200336,202048,35689,35665,24
2020-11-27,1200351,202048,35692,35689,3
2020-11-27,1200344,202048,35736,35692,44
2020-11-27,1200328,202048,35736,35736,0
2020-11-27,1200302,202048,35768,35736,32
2020-11-27,1200385,202048,35771,35768,3
2020-11-28,1200054,202048,35771,35771,0
2020-11-28,1200013,202048,35773,35771,2
2020-11-28,1200104,202048,35773,35773,0
2020-11-28,1200708,202048,35773,35773,0
2020-11-28,1200450,202048,35773,35773,0
2020-11-28,1200500,202048,35776,35773,3
2020-11-28,1200435,202048,35776,35776,0
2020-11-28,1200427,202048,35776,35776,0
2020-11-28,1200401,202048,35924,35776,148
2020-11-28,1200393,202048,35924,35924,0
2020-11-28,1200807,202048,35928,35924,4
2020-11-28,1200385,202048,35933,35928,5
2020-11-28,1200336,202048,35933,35933,0
2020-11-28,1200351,202048,35933,35933,0
2020-11-28,1200344,202048,35933,35933,0
2020-11-28,1200328,202048,35933,35933,0
2020-11-28,1200302,202048,35934,35933,1
2020-11-28,1200252,202048,35934,35934,0
2020-11-28,1200203,202048,35935,35934,1
2020-11-28,1200179,202048,35935,35935,0
2020-11-28,1200138,202048,35935,35935,0
2020-11-28,1200609,202048,35935,35935,0
2020-11-29,1200807,202049,35939,35935,4
2020-11-29,1200393,202049,35939,35939,0
2020-11-29,1200054,202049,35939,35939,0
2020-11-29,1200401,202049,36077,35939,138
2020-11-29,1200427,202049,36077,36077,0
2020-11-29,1200385,202049,36078,36077,1
2020-11-29,1200500,202049,36078,36078,0
2020-11-29,1200450,202049,36081,36078,3
2020-11-29,1200609,202049,36081,36081,0
2020-11-29,1200708,202049,36083,36081,2
2020-11-29,1200336,202049,36083,36083,0
2020-11-29,1200351,202049,36083,36083,0
2020-11-29,1200344,202049,36083,36083,0
2020-11-29,1200328,202049,36083,36083,0
2020-11-29,1200302,202049,36083,36083,0
2020-11-29,1200252,202049,36087,36083,4
2020-11-29,1200203,202049,36088,36087,1
2020-11-29,1200179,202049,36088,36088,0
2020-11-29,1200138,202049,36088,36088,0
2020-11-29,1200104,202049,36088,36088,0
2020-11-29,1200013,202049,36095,36088,7
2020-11-29,1200435,202049,36095,36095,0
2020-11-30,1200435,202049,36096,36095,1
2020-11-30,1200708,202049,36105,36096,9
2020-11-30,1200500,202049,36134,36105,29
2020-11-30,1200427,202049,36136,36134,2
2020-11-30,1200401,202049,36204,36136,68
2020-11-30,1200393,202049,36205,36204,1
2020-11-30,1200807,202049,36205,36205,0
2020-11-30,1200385,202049,36210,36205,5
2020-11-30,1200336,202049,36218,36210,8
2020-11-30,1200351,202049,36218,36218,0
2020-11-30,1200344,202049,36225,36218,7
2020-11-30,1200328,202049,36225,36225,0
2020-11-30,1200302,202049,36233,36225,8
2020-11-30,1200252,202049,36235,36233,2
2020-11-30,1200203,202049,36247,36235,12
2020-11-30,1200179,202049,36247,36247,0
2020-11-30,1200138,202049,36247,36247,0
2020-11-30,1200104,202049,36251,36247,4
2020-11-30,1200054,202049,36252,36251,1
2020-11-30,1200450,202049,36253,36252,1
2020-11-30,1200609,202049,36274,36253,21
2020-11-30,1200013,202049,36274,36274,0
2020-12-01,1200336,202049,36274,36274,0
2020-12-01,1200807,202049,36274,36274,0
2020-12-01,1200393,202049,36274,36274,0
2020-12-01,1200401,202049,36425,36274,151
2020-12-01,1200427,202049,36426,36425,1
2020-12-01,1200435,202049,36426,36426,0
2020-12-01,1200500,202049,36460,36426,34
2020-12-01,1200450,202049,36463,36460,3
2020-12-01,1200609,202049,36488,36463,25
2020-12-01,1200708,202049,36498,36488,10
2020-12-01,1200351,202049,36500,36498,2
2020-12-01,1200344,202049,36501,36500,1
2020-12-01,1200328,202049,36501,36501,0
2020-12-01,1200302,202049,36529,36501,28
2020-12-01,1200252,202049,36532,36529,3
2020-12-01,1200203,202049,36573,36532,41
2020-12-01,1200179,202049,36576,36573,3
2020-12-01,1200138,202049,36576,36576,0
2020-12-01,1200104,202049,36576,36576,0
2020-12-01,1200054,202049,36577,36576,1
2020-12-01,1200013,202049,36577,36577,0
2020-12-01,1200385,202049,36578,36577,1
2020-12-02,1200336,202049,36578,36578,0
2020-12-02,1200427,202049,36578,36578,0
2020-12-02,1200708,202049,36588,36578,10
2020-12-02,1200609,202049,36619,36588,31
2020-12-02,1200450,202049,36620,36619,1
2020-12-02,1200500,202049,36642,36620,22
2020-12-02,1200435,202049,36643,36642,1
2020-12-02,1200401,202049,36726,36643,83
2020-12-02,1200393,202049,36726,36726,0
2020-12-02,1200807,202049,36728,36726,2
2020-12-02,1200351,202049,36728,36728,0
2020-12-02,1200385,202049,36729,36728,1
2020-12-02,1200328,202049,36729,36729,0
2020-12-02,1200302,202049,36731,36729,2
2020-12-02,1200252,202049,36734,36731,3
2020-12-02,1200203,202049,36739,36734,5
2020-12-02,1200179,202049,36739,36739,0
2020-12-02,1200138,202049,36756,36739,17
2020-12-02,1200104,202049,36756,36756,0
2020-12-02,1200054,202049,36756,36756,0
2020-12-02,1200013,202049,36756,36756,0
2020-12-02,1200344,202049,36761,36756,5
2020-12-03,1200203,202049,36772,36761,11
2020-12-03,1200344,202049,36776,36772,4
2020-12-03,1200328,202049,36784,36776,8
2020-12-03,1200302,202049,36787,36784,3
2020-12-03,1200179,202049,36795,36787,8
2020-12-03,1200385,202049,36797,36795,2
2020-12-03,1200104,202049,36797,36797,0
2020-12-03,1200054,202049,36797,36797,0
2020-12-03,1200013,202049,36797,36797,0
2020-12-03,1200351,202049,36798,36797,1
2020-12-03,1200138,202049,36802,36798,4
2020-12-03,1200336,202049,36803,36802,1
2020-12-03,1200252,202049,36804,36803,1
2020-12-03,1200393,202049,36807,36804,3
2020-12-03,1200401,202049,36889,36807,82
2020-12-03,1200427,202049,36889,36889,0
2020-12-03,1200435,202049,36889,36889,0
2020-12-03,1200500,202049,36899,36889,10
2020-12-03,1200450,202049,36899,36899,0
2020-12-03,1200609,202049,36899,36899,0
2020-12-03,1200708,202049,36911,36899,12
2020-12-03,1200807,202049,36914,36911,3
2020-12-04,1200708,202049,36924,36914,10
2020-12-04,1200013,202049,36924,36924,0
2020-12-04,1200054,202049,36924,36924,0
2020-12-04,1200104,202049,36924,36924,0
2020-12-04,1200138,202049,36928,36924,4
2020-12-04,1200179,202049,36930,36928,2
2020-12-04,1200203,202049,36935,36930,5
2020-12-04,1200302,202049,36941,36935,6
2020-12-04,1200450,202049,36941,36941,0
2020-12-04,1200500,202049,36974,36941,33
2020-12-04,1200435,202049,36974,36974,0
2020-12-04,1200427,202049,36974,36974,0
2020-12-04,1200401,202049,37143,36974,169
2020-12-04,1200252,202049,37143,37143,0
2020-12-04,1200393,202049,37143,37143,0
2020-12-04,1200385,202049,37147,37143,4
2020-12-04,1200336,202049,37147,37147,0
2020-12-04,1200351,202049,37147,37147,0
2020-12-04,1200344,202049,37148,37147,1
2020-12-04,1200328,202049,37151,37148,3
2020-12-04,1200807,202049,37152,37151,1
2020-12-04,1200609,202049,37167,37152,15
2020-12-05,1200013,202049,37168,37167,1
2020-12-05,1200054,202049,37168,37168,0
2020-12-05,1200104,202049,37168,37168,0
2020-12-05,1200435,202049,37168,37168,0
2020-12-05,1200427,202049,37168,37168,0
2020-12-05,1200138,202049,37169,37168,1
2020-12-05,1200500,202049,37187,37169,18
2020-12-05,1200450,202049,37189,37187,2
2020-12-05,1200609,202049,37194,37189,5
2020-12-05,1200708,202049,37198,37194,4
2020-12-05,1200807,202049,37198,37198,0
2020-12-05,1200385,202049,37204,37198,6
2020-12-05,1200336,202049,37204,37204,0
2020-12-05,1200351,202049,37205,37204,1
2020-12-05,1200344,202049,37205,37205,0
2020-12-05,1200328,202049,37205,37205,0
2020-12-05,1200302,202049,37224,37205,19
2020-12-05,1200252,202049,37224,37224,0
2020-12-05,1200203,202049,37226,37224,2
2020-12-05,1200179,202049,37226,37226,0
2020-12-05,1200401,202049,37291,37226,65
2020-12-05,1200393,202049,37292,37291,1
2020-12-06,1200385,202050,37292,37292,0
2020-12-06,1200393,202050,37292,37292,0
2020-12-06,1200054,202050,37292,37292,0
2020-12-06,1200104,202050,37292,37292,0
2020-12-06,1200807,202050,37293,37292,1
2020-12-06,1200138,202050,37293,37293,0
2020-12-06,1200179,202050,37295,37293,2
2020-12-06,1200203,202050,37296,37295,1
2020-12-06,1200252,202050,37296,37296,0
2020-12-06,1200302,202050,37296,37296,0
2020-12-06,1200328,202050,37296,37296,0
2020-12-06,1200344,202050,37296,37296,0
2020-12-06,1200013,202050,37296,37296,0
2020-12-06,1200351,202050,37296,37296,0
2020-12-06,1200336,202050,37296,37296,0
2020-12-06,1200427,202050,37296,37296,0
2020-12-06,1200500,202050,37296,37296,0
2020-12-06,1200450,202050,37299,37296,3
2020-12-06,1200609,202050,37299,37299,0
2020-12-06,1200708,202050,37299,37299,0
2020-12-06,1200401,202050,37336,37299,37
2020-12-06,1200435,202050,37336,37336,0
2020-12-07,1200013,202050,37337,37336,1
2020-12-07,1200054,202050,37337,37337,0
2020-12-07,1200104,202050,37338,37337,1
2020-12-07,1200138,202050,37339,37338,1
2020-12-07,1200179,202050,37339,37339,0
2020-12-07,1200203,202050,37344,37339,5
2020-12-07,1200252,202050,37344,37344,0
2020-12-07,1200328,202050,37344,37344,0
2020-12-07,1200302,202050,37344,37344,0
2020-12-07,1200351,202050,37344,37344,0
2020-12-07,1200336,202050,37344,37344,0
2020-12-07,1200385,202050,37345,37344,1
2020-12-07,1200807,202050,37345,37345,0
2020-12-07,1200393,202050,37345,37345,0
2020-12-07,1200401,202050,37389,37345,44
2020-12-07,1200427,202050,37392,37389,3
2020-12-07,1200435,202050,37392,37392,0
2020-12-07,1200500,202050,37423,37392,31
2020-12-07,1200450,202050,37424,37423,1
2020-12-07,1200609,202050,37437,37424,13
2020-12-07,1200708,202050,37443,37437,6
2020-12-07,1200344,202050,37443,37443,0
2020-12-08,1200104,202050,37443,37443,0
2020-12-08,1200179,202050,37443,37443,0
2020-12-08,1200138,202050,37443,37443,0
2020-12-08,1200013,202050,37443,37443,0
2020-12-08,1200054,202050,37443,37443,0
2020-12-08,1200450,202050,37443,37443,0
2020-12-08,1200609,202050,37443,37443,0
2020-12-08,1200708,202050,37443,37443,0
2020-12-08,1200435,202050,37443,37443,0
2020-12-08,1200427,202050,37443,37443,0
2020-12-08,1200401,202050,37552,37443,109
2020-12-08,1200393,202050,37552,37552,0
2020-12-08,1200807,202050,37552,37552,0
2020-12-08,1200385,202050,37556,37552,4
2020-12-08,1200336,202050,37556,37556,0
2020-12-08,1200351,202050,37556,37556,0
2020-12-08,1200344,202050,37556,37556,0
2020-12-08,1200328,202050,37556,37556,0
2020-12-08,1200302,202050,37570,37556,14
2020-12-08,1200252,202050,37570,37570,0
2020-12-08,1200203,202050,37570,37570,0
2020-12-08,1200500,202050,37571,37570,1
2020-12-09,1200393,202050,37571,37571,0
2020-12-09,1200427,202050,37571,37571,0
2020-12-09,1200054,202050,37576,37571,5
2020-12-09,1200104,202050,37575,37576,-1
2020-12-09,1200138,202050,37583,37575,8
2020-12-09,1200179,202050,37583,37583,0
2020-12-09,1200203,202050,37592,37583,9
2020-12-09,1200401,202050,37645,37592,53
2020-12-09,1200252,202050,37645,37645,0
2020-12-09,1200302,202050,37655,37645,10
2020-12-09,1200328,202050,37655,37655,0
2020-12-09,1200344,202050,37659,37655,4
2020-12-09,1200351,202050,37659,37659,0
2020-12-09,1200336,202050,37660,37659,1
2020-12-09,1200013,202050,37661,37660,1
2020-12-09,1200385,202050,37660,37661,-1
2020-12-09,1200807,202050,37661,37660,1
2020-12-09,1200435,202050,37661,37661,0
2020-12-09,1200500,202050,37683,37661,22
2020-12-09,1200450,202050,37684,37683,1
2020-12-09,1200609,202050,37684,37684,0
2020-12-09,1200708,202050,37687,37684,3
2020-12-10,1200435,202050,37688,37687,1
2020-12-10,1200393,202050,37688,37688,0
2020-12-10,1200500,202050,37704,37688,16
2020-12-10,1200450,202050,37705,37704,1
2020-12-10,1200609,202050,37705,37705,0
2020-12-10,1200708,202050,37716,37705,11
2020-12-10,1200807,202050,37716,37716,0
2020-12-10,1200385,202050,37720,37716,4
2020-12-10,1200336,202050,37727,37720,7
2020-12-10,1200351,202050,37727,37727,0
2020-12-10,1200302,202050,37732,37727,5
2020-12-10,1200328,202050,37732,37732,0
2020-12-10,1200427,202050,37732,37732,0
2020-12-10,1200252,202050,37736,37732,4
2020-12-10,1200203,202050,37740,37736,4
2020-12-10,1200179,202050,37741,37740,1
2020-12-10,1200138,202050,37742,37741,1
2020-12-10,1200104,202050,37746,37742,4
2020-12-10,1200054,202050,37747,37746,1
2020-12-10,1200013,202050,37748,37747,1
2020-12-10,1200344,202050,37749,37748,1
2020-12-10,1200401,202050,37917,37749,168
2020-12-11,1200252,202050,37917,37917,0
2020-12-11,1200013,202050,37922,37917,5
2020-12-11,1200302,202050,37923,37922,1
2020-12-11,1200328,202050,37927,37923,4
2020-12-11,1200344,202050,37928,37927,1
2020-12-11,1200351,202050,37928,37928,0
2020-12-11,1200336,202050,37928,37928,0
2020-12-11,1200385,202050,37932,37928,4
2020-12-11,1200179,202050,37932,37932,0
2020-12-11,1200393,202050,37932,37932,0
2020-12-11,1200203,202050,37934,37932,2
2020-12-11,1200401,202050,38109,37934,175
2020-12-11,1200435,202050,38109,38109,0
2020-12-11,1200500,202050,38146,38109,37
2020-12-11,1200450,202050,38146,38146,0
2020-12-11,1200609,202050,38156,38146,10
2020-12-11,1200708,202050,38165,38156,9
2020-12-11,1200138,202050,38167,38165,2
2020-12-11,1200104,202050,38164,38167,-3
2020-12-11,1200054,202050,38163,38164,-1
2020-12-11,1200427,202050,38163,38163,0
2020-12-11,1200807,202050,38165,38163,2
2020-12-12,1200302,202050,38165,38165,0
2020-12-12,1200401,202050,38302,38165,137
2020-12-12,1200708,202050,38311,38302,9
2020-12-12,1200609,202050,38320,38311,9
2020-12-12,1200450,202050,38325,38320,5
2020-12-12,1200500,202050,38349,38325,24
2020-12-12,1200435,202050,38352,38349,3
2020-12-12,1200427,202050,38352,38352,0
2020-12-12,1200393,202050,38352,38352,0
2020-12-12,1200807,202050,38352,38352,0
2020-12-12,1200336,202050,38352,38352,0
2020-12-12,1200385,202050,38352,38352,0
2020-12-12,1200344,202050,38352,38352,0
2020-12-12,1200328,202050,38352,38352,0
2020-12-12,1200252,202050,38352,38352,0
2020-12-12,1200203,202050,38359,38352,7
2020-12-12,1200179,202050,38361,38359,2
2020-12-12,1200138,202050,38367,38361,6
2020-12-12,1200104,202050,38368,38367,1
2020-12-12,1200054,202050,38373,38368,5
2020-12-12,1200013,202050,38375,38373,2
2020-12-12,1200351,202050,38378,38375,3
2020-12-13,1200252,202051,38378,38378,0
2020-12-13,1200328,202051,38378,38378,0
2020-12-13,1200302,202051,38378,38378,0
2020-12-13,1200203,202051,38378,38378,0
2020-12-13,1200385,202051,38383,38378,5
2020-12-13,1200138,202051,38383,38383,0
2020-12-13,1200054,202051,38383,38383,0
2020-12-13,1200013,202051,38383,38383,0
2020-12-13,1200344,202051,38383,38383,0
2020-12-13,1200179,202051,38383,38383,0
2020-12-13,1200336,202051,38383,38383,0
2020-12-13,1200351,202051,38383,38383,0
2020-12-13,1200104,202051,38383,38383,0
2020-12-13,1200807,202051,38383,38383,0
2020-12-13,1200393,202051,38383,38383,0
2020-12-13,1200401,202051,38427,38383,44
2020-12-13,1200427,202051,38427,38427,0
2020-12-13,1200435,202051,38427,38427,0
2020-12-13,1200500,202051,38427,38427,0
2020-12-13,1200450,202051,38427,38427,0
2020-12-13,1200609,202051,38427,38427,0
2020-12-13,1200708,202051,38427,38427,0
2020-12-14,1200013,202051,38428,38427,1
2020-12-14,1200054,202051,38429,38428,1
2020-12-14,1200104,202051,38429,38429,0
2020-12-14,1200138,202051,38430,38429,1
2020-12-14,1200179,202051,38430,38430,0
2020-12-14,1200609,202051,38440,38430,10
2020-12-14,1200252,202051,38441,38440,1
2020-12-14,1200302,202051,38456,38441,15
2020-12-14,1200328,202051,38458,38456,2
2020-12-14,1200344,202051,38460,38458,2
2020-12-14,1200351,202051,38460,38460,0
2020-12-14,1200336,202051,38459,38460,-1
2020-12-14,1200385,202051,38459,38459,0
2020-12-14,1200807,202051,38463,38459,4
2020-12-14,1200393,202051,38463,38463,0
2020-12-14,1200401,202051,38561,38463,98
2020-12-14,1200427,202051,38561,38561,0
2020-12-14,1200435,202051,38561,38561,0
2020-12-14,1200500,202051,38607,38561,46
2020-12-14,1200450,202051,38608,38607,1
2020-12-14,1200708,202051,38615,38608,7
2020-12-14,1200203,202051,38643,38615,28
2020-12-15,1200500,202051,38650,38643,7
2020-12-15,1200054,202051,38650,38650,0
2020-12-15,1200708,202051,38651,38650,1
2020-12-15,1200609,202051,38651,38651,0
2020-12-15,1200450,202051,38651,38651,0
2020-12-15,1200435,202051,38651,38651,0
2020-12-15,1200401,202051,38715,38651,64
2020-12-15,1200393,202051,38715,38715,0
2020-12-15,1200807,202051,38717,38715,2
2020-12-15,1200385,202051,38717,38717,0
2020-12-15,1200336,202051,38718,38717,1
2020-12-15,1200427,202051,38720,38718,2
2020-12-15,1200344,202051,38720,38720,0
2020-12-15,1200328,202051,38720,38720,0
2020-12-15,1200302,202051,38721,38720,1
2020-12-15,1200252,202051,38721,38721,0
2020-12-15,1200203,202051,38727,38721,6
2020-12-15,1200179,202051,38727,38727,0
2020-12-15,1200138,202051,38727,38727,0
2020-12-15,1200104,202051,38727,38727,0
2020-12-15,1200013,202051,38727,38727,0
2020-12-15,1200351,202051,38727,38727,0
2020-12-16,1200344,202051,38729,38727,2
2020-12-16,1200328,202051,38729,38729,0
2020-12-16,1200302,202051,38744,38729,15
2020-12-16,1200252,202051,38744,38744,0
2020-12-16,1200203,202051,38751,38744,7
2020-12-16,1200013,202051,38751,38751,0
2020-12-16,1200138,202051,38751,38751,0
2020-12-16,1200104,202051,38751,38751,0
2020-12-16,1200054,202051,38751,38751,0
2020-12-16,1200351,202051,38751,38751,0
2020-12-16,1200179,202051,38751,38751,0
2020-12-16,1200336,202051,38751,38751,0
2020-12-16,1200385,202051,38751,38751,0
2020-12-16,1200807,202051,38750,38751,-1
2020-12-16,1200393,202051,38750,38750,0
2020-12-16,1200401,202051,38907,38750,157
2020-12-16,1200427,202051,38907,38907,0
2020-12-16,1200435,202051,38907,38907,0
2020-12-16,1200500,202051,38941,38907,34
2020-12-16,1200450,202051,38941,38941,0
2020-12-16,1200609,202051,38941,38941,0
2020-12-16,1200708,202051,38953,38941,12
2020-12-17,1200708,202051,38964,38953,11
2020-12-17,1200013,202051,38964,38964,0
2020-12-17,1200054,202051,38967,38964,3
2020-12-17,1200104,202051,38966,38967,-1
2020-12-17,1200138,202051,38974,38966,8
2020-12-17,1200179,202051,38974,38974,0
2020-12-17,1200203,202051,38984,38974,10
2020-12-17,1200807,202051,38989,38984,5
2020-12-17,1200450,202051,38989,38989,0
2020-12-17,1200500,202051,39030,38989,41
2020-12-17,1200435,202051,39031,39030,1
2020-12-17,1200427,202051,39033,39031,2
2020-12-17,1200401,202051,39162,39033,129
2020-12-17,1200393,202051,39162,39162,0
2020-12-17,1200252,202051,39165,39162,3
2020-12-17,1200609,202051,39166,39165,1
2020-12-17,1200336,202051,39166,39166,0
2020-12-17,1200351,202051,39169,39166,3
2020-12-17,1200344,202051,39172,39169,3
2020-12-17,1200328,202051,39175,39172,3
2020-12-17,1200302,202051,39180,39175,5
2020-12-17,1200385,202051,39181,39180,1
2020-12-18,1200054,202051,39181,39181,0
2020-12-18,1200013,202051,39183,39181,2
2020-12-18,1200104,202051,39183,39183,0
2020-12-18,1200708,202051,39193,39183,10
2020-12-18,1200450,202051,39193,39193,0
2020-12-18,1200500,202051,39225,39193,32
2020-12-18,1200435,202051,39225,39225,0
2020-12-18,1200427,202051,39226,39225,1
2020-12-18,1200401,202051,39323,39226,97
2020-12-18,1200393,202051,39324,39323,1
2020-12-18,1200807,202051,39323,39324,-1
2020-12-18,1200385,202051,39323,39323,0
2020-12-18,1200336,202051,39325,39323,2
2020-12-18,1200351,202051,39326,39325,1
2020-12-18,1200344,202051,39328,39326,2
2020-12-18,1200328,202051,39333,39328,5
2020-12-18,1200302,202051,39334,39333,1
2020-12-18,1200252,202051,39336,39334,2
2020-12-18,1200203,202051,39351,39336,15
2020-12-18,1200179,202051,39351,39351,0
2020-12-18,1200138,202051,39356,39351,5
2020-12-18,1200609,202051,39356,39356,0
2020-12-19,1200807,202051,39414,39356,58
2020-12-19,1200393,202051,39414,39414,0
2020-12-19,1200054,202051,39422,39414,8
2020-12-19,1200401,202051,39702,39422,280
2020-12-19,1200427,202051,39704,39702,2
2020-12-19,1200385,202051,39706,39704,2
2020-12-19,1200500,202051,39732,39706,26
2020-12-19,1200450,202051,39749,39732,17
2020-12-19,1200609,202051,39751,39749,2
2020-12-19,1200708,202051,39761,39751,10
2020-12-19,1200336,202051,39762,39761,1
2020-12-19,1200351,202051,39764,39762,2
2020-12-19,1200344,202051,39768,39764,4
2020-12-19,1200328,202051,39768,39768,0
2020-12-19,1200302,202051,39791,39768,23
2020-12-19,1200252,202051,39803,39791,12
2020-12-19,1200203,202051,39851,39803,48
2020-12-19,1200179,202051,39858,39851,7
2020-12-19,1200138,202051,39860,39858,2
2020-12-19,1200104,202051,39877,39860,17
2020-12-19,1200013,202051,39884,39877,7
2020-12-19,1200435,202051,39884,39884,0
2020-12-20,1200435,202052,39884,39884,0
2020-12-20,1200708,202052,39884,39884,0
2020-12-20,1200500,202052,39886,39884,2
2020-12-20,1200427,202052,39886,39886,0
2020-12-20,1200401,202052,40006,39886,120
2020-12-20,1200393,202052,40006,40006,0
2020-12-20,1200807,202052,40006,40006,0
2020-12-20,1200385,202052,40010,40006,4
2020-12-20,1200336,202052,40010,40010,0
2020-12-20,1200351,202052,40010,40010,0
2020-12-20,1200344,202052,40010,40010,0
2020-12-20,1200328,202052,40010,40010,0
2020-12-20,1200302,202052,40011,40010,1
2020-12-20,1200252,202052,40011,40011,0
2020-12-20,1200203,202052,40011,40011,0
2020-12-20,1200179,202052,40011,40011,0
2020-12-20,1200138,202052,40011,40011,0
2020-12-20,1200104,202052,40011,40011,0
2020-12-20,1200054,202052,40011,40011,0
2020-12-20,1200450,202052,40011,40011,0
2020-12-20,1200609,202052,40011,40011,0
2020-12-20,1200013,202052,40011,40011,0
2020-12-21,1200336,202052,40014,40011,3
2020-12-21,1200807,202052,40014,40014,0
2020-12-21,1200393,202052,40014,40014,0
2020-12-21,1200401,202052,40197,40014,183
2020-12-21,1200427,202052,40198,40197,1
2020-12-21,1200435,202052,40208,40198,10
2020-12-21,1200500,202052,40228,40208,20
2020-12-21,1200450,202052,40230,40228,2
2020-12-21,1200609,202052,40229,40230,-1
2020-12-21,1200708,202052,40229,40229,0
2020-12-21,1200351,202052,40231,40229,2
2020-12-21,1200344,202052,40232,40231,1
2020-12-21,1200328,202052,40233,40232,1
2020-12-21,1200302,202052,40233,40233,0
2020-12-21,1200252,202052,40237,40233,4
2020-12-21,1200203,202052,40252,40237,15
2020-12-21,1200179,202052,40252,40252,0
2020-12-21,1200138,202052,40252,40252,0
2020-12-21,1200104,202052,40254,40252,2
2020-12-21,1200054,202052,40254,40254,0
2020-12-21,1200013,202052,40264,40254,10
2020-12-21,1200385,202052,40264,40264,0
2020-12-22,1200252,202052,40265,40264,1
2020-12-22,1200427,202052,40265,40265,0
2020-12-22,1200708,202052,40265,40265,0
2020-12-22,1200609,202052,40265,40265,0
2020-12-22,1200450,202052,40266,40265,1
2020-12-22,1200500,202052,40277,40266,11
2020-12-22,1200435,202052,40277,40277,0
2020-12-22,1200401,202052,40297,40277,20
2020-12-22,1200393,202052,40297,40297,0
2020-12-22,1200807,202052,40300,40297,3
2020-12-22,1200336,202052,40301,40300,1
2020-12-22,1200385,202052,40302,40301,1
2020-12-22,1200344,202052,40302,40302,0
2020-12-22,1200328,202052,40302,40302,0
2020-12-22,1200302,202052,40321,40302,19
2020-12-22,1200203,202052,40321,40321,0
2020-12-22,1200179,202052,40322,40321,1
2020-12-22,1200138,202052,40323,40322,1
2020-12-22,1200104,202052,40328,40323,5
2020-12-22,1200054,202052,40328,40328,0
2020-12-22,1200013,202052,40329,40328,1
2020-12-22,1200351,202052,40329,40329,0
2020-12-23,1200252,202052,40332,40329,3
2020-12-23,1200344,202052,40336,40332,4
2020-12-23,1200328,202052,40342,40336,6
2020-12-23,1200302,202052,40344,40342,2
2020-12-23,1200203,202052,40347,40344,3
2020-12-23,1200385,202052,40348,40347,1
2020-12-23,1200138,202052,40347,40348,-1
2020-12-23,1200104,202052,40348,40347,1
2020-12-23,1200013,202052,40352,40348,4
2020-12-23,1200351,202052,40351,40352,-1
2020-12-23,1200179,202052,40351,40351,0
2020-12-23,1200336,202052,40352,40351,1
2020-12-23,1200054,202052,40352,40352,0
2020-12-23,1200393,202052,40352,40352,0
2020-12-23,1200401,202052,40379,40352,27
2020-12-23,1200427,202052,40383,40379,4
2020-12-23,1200435,202052,40382,40383,-1
2020-12-23,1200500,202052,40406,40382,24
2020-12-23,1200450,202052,40406,40406,0
2020-12-23,1200609,202052,40409,40406,3
2020-12-23,1200708,202052,40414,40409,5
2020-12-23,1200807,202052,40414,40414,0
2020-12-24,1200708,202052,40414,40414,0
2020-12-24,1200013,202052,40418,40414,4
2020-12-24,1200054,202052,40419,40418,1
2020-12-24,1200104,202052,40427,40419,8
2020-12-24,1200138,202052,40427,40427,0
2020-12-24,1200179,202052,40427,40427,0
2020-12-24,1200203,202052,40431,40427,4
2020-12-24,1200302,202052,40431,40431,0
2020-12-24,1200450,202052,40431,40431,0
2020-12-24,1200500,202052,40449,40431,18
2020-12-24,1200435,202052,40450,40449,1
2020-12-24,1200427,202052,40450,40450,0
2020-12-24,1200401,202052,40642,40450,192
2020-12-24,1200252,202052,40645,40642,3
2020-12-24,1200393,202052,40645,40645,0
2020-12-24,1200385,202052,40645,40645,0
2020-12-24,1200336,202052,40645,40645,0
2020-12-24,1200351,202052,40646,40645,1
2020-12-24,1200344,202052,40647,40646,1
2020-12-24,1200328,202052,40649,40647,2
2020-12-24,1200807,202052,40653,40649,4
2020-12-24,1200609,202052,40653,40653,0
2020-12-25,1200013,202052,40653,40653,0
2020-12-25,1200054,202052,40658,40653,5
2020-12-25,1200104,202052,40658,40658,0
2020-12-25,1200179,202052,40658,40658,0
2020-12-25,1200252,202052,40659,40658,1
2020-12-25,1200302,202052,40659,40659,0
2020-12-25,1200328,202052,40659,40659,0
2020-12-25,1200344,202052,40660,40659,1
2020-12-25,1200351,202052,40660,40660,0
2020-12-25,1200336,202052,40661,40660,1
2020-12-25,1200385,202052,40661,40661,0
2020-12-25,1200807,202052,40666,40661,5
2020-12-25,1200393,202052,40666,40666,0
2020-12-25,1200401,202052,40695,40666,29
2020-12-25,1200427,202052,40695,40695,0
2020-12-25,1200435,202052,40694,40695,-1
2020-12-25,1200500,202052,40710,40694,16
2020-12-25,1200203,202052,40720,40710,10
2020-12-25,1200450,202052,40720,40720,0
2020-12-25,1200609,202052,40721,40720,1
2020-12-25,1200708,202052,40737,40721,16
2020-12-25,1200138,202052,40738,40737,1
2020-12-26,1200013,202052,40738,40738,0
2020-12-26,1200054,202052,40738,40738,0
2020-12-26,1200104,202052,40738,40738,0
2020-12-26,1200138,202052,40738,40738,0
2020-12-26,1200179,202052,40738,40738,0
2020-12-26,1200203,202052,40738,40738,0
2020-12-26,1200252,202052,40738,40738,0
2020-12-26,1200302,202052,40740,40738,2
2020-12-26,1200328,202052,40740,40740,0
2020-12-26,1200344,202052,40740,40740,0
2020-12-26,1200351,202052,40740,40740,0
2020-12-26,1200385,202052,40740,40740,0
2020-12-26,1200393,202052,40740,40740,0
2020-12-26,1200807,202052,40740,40740,0
2020-12-26,1200401,202052,40749,40740,9
2020-12-26,1200427,202052,40749,40749,0
2020-12-26,1200435,202052,40749,40749,0
2020-12-26,1200500,202052,40751,40749,2
2020-12-26,1200450,202052,40751,40751,0
2020-12-26,1200609,202052,40751,40751,0
2020-12-26,1200708,202052,40751,40751,0
2020-12-26,1200336,202052,40751,40751,0
2020-12-27,1200013,202053,40751,40751,0
2020-12-27,1200054,202053,40751,40751,0
2020-12-27,1200104,202053,40773,40751,22
2020-12-27,1200138,202053,40773,40773,0
2020-12-27,1200179,202053,40773,40773,0
2020-12-27,1200203,202053,40785,40773,12
2020-12-27,1200708,202053,40785,40785,0
2020-12-27,1200328,202053,40785,40785,0
2020-12-27,1200344,202053,40785,40785,0
2020-12-27,1200351,202053,40785,40785,0
2020-12-27,1200336,202053,40785,40785,0
2020-12-27,1200385,202053,40785,40785,0
2020-12-27,1200807,202053,40790,40785,5
2020-12-27,1200393,202053,40790,40790,0
2020-12-27,1200401,202053,40904,40790,114
2020-12-27,1200427,202053,40904,40904,0
2020-12-27,1200435,202053,40904,40904,0
2020-12-27,1200500,202053,40915,40904,11
2020-12-27,1200450,202053,40915,40915,0
2020-12-27,1200609,202053,40915,40915,0
2020-12-27,1200302,202053,40915,40915,0
2020-12-27,1200252,202053,40915,40915,0
2020-12-28,1200435,202053,40915,40915,0
2020-12-28,1200393,202053,40915,40915,0
2020-12-28,1200708,202053,40915,40915,0
2020-12-28,1200609,202053,40915,40915,0
2020-12-28,1200450,202053,40915,40915,0
2020-12-28,1200500,202053,40917,40915,2
2020-12-28,1200427,202053,40917,40917,0
2020-12-28,1200401,202053,41020,40917,103
2020-12-28,1200807,202053,41020,41020,0
2020-12-28,1200385,202053,41023,41020,3
2020-12-28,1200351,202053,41023,41023,0
2020-12-28,1200336,202053,41024,41023,1
2020-12-28,1200328,202053,41024,41024,0
2020-12-28,1200302,202053,41025,41024,1
2020-12-28,1200252,202053,41025,41025,0
2020-12-28,1200203,202053,41025,41025,0
2020-12-28,1200179,202053,41025,41025,0
2020-12-28,1200138,202053,41025,41025,0
2020-12-28,1200104,202053,41025,41025,0
2020-12-28,1200054,202053,41025,41025,0
2020-12-28,1200013,202053,41025,41025,0
2020-12-28,1200344,202053,41025,41025,0
2020-12-29,1200203,202053,41037,41025,12
2020-12-29,1200302,202053,41069,41037,32
2020-12-29,1200252,202053,41073,41069,4
2020-12-29,1200179,202053,41075,41073,2
2020-12-29,1200351,202053,41075,41075,0
2020-12-29,1200104,202053,41077,41075,2
2020-12-29,1200054,202053,41077,41077,0
2020-12-29,1200013,202053,41078,41077,1
2020-12-29,1200328,202053,41079,41078,1
2020-12-29,1200138,202053,41079,41079,0
2020-12-29,1200336,202053,41079,41079,0
2020-12-29,1200344,202053,41087,41079,8
2020-12-29,1200385,202053,41095,41087,8
2020-12-29,1200807,202053,41098,41095,3
2020-12-29,1200393,202053,41098,41098,0
2020-12-29,1200401,202053,41179,41098,81
2020-12-29,1200427,202053,41180,41179,1
2020-12-29,1200435,202053,41180,41180,0
2020-12-29,1200500,202053,41227,41180,47
2020-12-29,1200450,202053,41229,41227,2
2020-12-29,1200609,202053,41232,41229,3
2020-12-29,1200708,202053,41247,41232,15
2020-12-30,1200013,202053,41253,41247,6
2020-12-30,1200054,202053,41253,41253,0
2020-12-30,1200104,202053,41255,41253,2
2020-12-30,1200138,202053,41255,41255,0
2020-12-30,1200179,202053,41256,41255,1
2020-12-30,1200609,202053,41257,41256,1
2020-12-30,1200252,202053,41258,41257,1
2020-12-30,1200302,202053,41258,41258,0
2020-12-30,1200328,202053,41258,41258,0
2020-12-30,1200344,202053,41260,41258,2
2020-12-30,1200351,202053,41260,41260,0
2020-12-30,1200336,202053,41260,41260,0
2020-12-30,1200385,202053,41264,41260,4
2020-12-30,1200807,202053,41264,41264,0
2020-12-30,1200393,202053,41264,41264,0
2020-12-30,1200401,202053,41349,41264,85
2020-12-30,1200427,202053,41349,41349,0
2020-12-30,1200435,202053,41349,41349,0
2020-12-30,1200500,202053,41353,41349,4
2020-12-30,1200450,202053,41356,41353,3
2020-12-30,1200708,202053,41359,41356,3
2020-12-30,1200203,202053,41370,41359,11
2020-12-31,1200336,202053,41363,41370,-7
2020-12-31,1200427,202053,41363,41363,0
2020-12-31,1200708,202053,41365,41363,2
2020-12-31,1200609,202053,41365,41365,0
2020-12-31,1200450,202053,41365,41365,0
2020-12-31,1200500,202053,41372,41365,7
2020-12-31,1200435,202053,41372,41372,0
2020-12-31,1200401,202053,41585,41372,213
2020-12-31,1200393,202053,41585,41585,0
2020-12-31,1200807,202053,41595,41585,10
2020-12-31,1200351,202053,41596,41595,1
2020-12-31,1200385,202053,41596,41596,0
2020-12-31,1200328,202053,41602,41596,6
2020-12-31,1200302,202053,41603,41602,1
2020-12-31,1200252,202053,41607,41603,4
2020-12-31,1200203,202053,41617,41607,10
2020-12-31,1200179,202053,41617,41617,0
2020-12-31,1200138,202053,41617,41617,0
2020-12-31,1200104,202053,41628,41617,11
2020-12-31,1200054,202053,41629,41628,1
2020-12-31,1200013,202053,41629,41629,0
2020-12-31,1200344,202053,41635,41629,6
2021-01-01,1200203,202053,41638,41635,3
2021-01-01,1200344,202053,41638,41638,0
2021-01-01,1200328,202053,41637,41638,-1
2021-01-01,1200302,202053,41637,41637,0
2021-01-01,1200179,202053,41637,41637,0
2021-01-01,1200385,202053,41637,41637,0
2021-01-01,1200104,202053,41637,41637,0
2021-01-01,1200054,202053,41637,41637,0
2021-01-01,1200013,202053,41637,41637,0
2021-01-01,1200351,202053,41637,41637,0
2021-01-01,1200138,202053,41637,41637,0
2021-01-01,1200336,202053,41637,41637,0
2021-01-01,1200252,202053,41637,41637,0
2021-01-01,1200807,202053,41648,41637,11
2021-01-01,1200393,202053,41648,41648,0
2021-01-01,1200401,202053,41681,41648,33
2021-01-01,1200427,202053,41681,41681,0
2021-01-01,1200435,202053,41681,41681,0
2021-01-01,1200500,202053,41704,41681,23
2021-01-01,1200450,202053,41704,41704,0
2021-01-01,1200609,202053,41704,41704,0
2021-01-01,1200708,202053,41704,41704,0
2021-01-02,1200708,202053,41704,41704,0
2021-01-02,1200013,202053,41704,41704,0
2021-01-02,1200054,202053,41704,41704,0
2021-01-02,1200104,202053,41711,41704,7
2021-01-02,1200138,202053,41711,41711,0
2021-01-02,1200179,202053,41712,41711,1
2021-01-02,1200203,202053,41713,41712,1
2021-01-02,1200807,202053,41720,41713,7
2021-01-02,1200450,202053,41720,41720,0
2021-01-02,1200500,202053,41722,41720,2
2021-01-02,1200435,202053,41722,41722,0
2021-01-02,1200427,202053,41722,41722,0
2021-01-02,1200401,202053,41917,41722,195
2021-01-02,1200393,202053,41917,41917,0
2021-01-02,1200252,202053,41918,41917,1
2021-01-02,1200609,202053,41918,41918,0
2021-01-02,1200336,202053,41918,41918,0
2021-01-02,1200351,202053,41918,41918,0
2021-01-02,1200344,202053,41918,41918,0
2021-01-02,1200328,202053,41918,41918,0
2021-01-02,1200302,202053,41948,41918,30
2021-01-02,1200385,202053,41956,41948,8
2021-01-03,1200054,202101,41956,41956,0
2021-01-03,1200013,202101,41956,41956,0
2021-01-03,1200104,202101,41956,41956,0
2021-01-03,1200708,202101,41956,41956,0
2021-01-03,1200450,202101,41956,41956,0
2021-01-03,1200500,202101,41956,41956,0
2021-01-03,1200435,202101,41956,41956,0
2021-01-03,1200427,202101,41956,41956,0
2021-01-03,1200401,202101,42057,41956,101
2021-01-03,1200393,202101,42057,42057,0
2021-01-03,1200807,202101,42057,42057,0
2021-01-03,1200385,202101,42061,42057,4
2021-01-03,1200336,202101,42061,42061,0
2021-01-03,1200351,202101,42061,42061,0
2021-01-03,1200344,202101,42061,42061,0
2021-01-03,1200328,202101,42061,42061,0
2021-01-03,1200302,202101,42061,42061,0
2021-01-03,1200252,202101,42061,42061,0
2021-01-03,1200203,202101,42061,42061,0
2021-01-03,1200179,202101,42061,42061,0
2021-01-03,1200138,202101,42061,42061,0
2021-01-03,1200609,202101,42061,42061,0
2021-01-04,1200807,202101,42067,42061,6
2021-01-04,1200393,202101,42067,42067,0
2021-01-04,1200054,202101,42067,42067,0
2021-01-04,1200401,202101,42074,42067,7
2021-01-04,1200427,202101,42075,42074,1
2021-01-04,1200385,202101,42088,42075,13
2021-01-04,1200500,202101,42094,42088,6
2021-01-04,1200450,202101,42095,42094,1
2021-01-04,1200609,202101,42095,42095,0
2021-01-04,1200708,202101,42096,42095,1
2021-01-04,1200336,202101,42096,42096,0
2021-01-04,1200351,202101,42096,42096,0
2021-01-04,1200344,202101,42095,42096,-1
2021-01-04,1200328,202101,42095,42095,0
2021-01-04,1200302,202101,42095,42095,0
2021-01-04,1200252,202101,42104,42095,9
2021-01-04,1200203,202101,42103,42104,-1
2021-01-04,1200179,202101,42103,42103,0
2021-01-04,1200138,202101,42103,42103,0
2021-01-04,1200104,202101,42132,42103,29
2021-01-04,1200013,202101,42132,42132,0
2021-01-04,1200435,202101,42132,42132,0
2021-01-05,1200435,202101,42132,42132,0
2021-01-05,1200708,202101,42133,42132,1
2021-01-05,1200500,202101,42133,42133,0
2021-01-05,1200427,202101,42133,42133,0
2021-01-05,1200401,202101,42177,42133,44
2021-01-05,1200393,202101,42177,42177,0
2021-01-05,1200807,202101,42179,42177,2
2021-01-05,1200385,202101,42179,42179,0
2021-01-05,1200336,202101,42179,42179,0
2021-01-05,1200351,202101,42180,42179,1
2021-01-05,1200344,202101,42180,42180,0
2021-01-05,1200328,202101,42180,42180,0
2021-01-05,1200302,202101,42180,42180,0
2021-01-05,1200252,202101,42180,42180,0
2021-01-05,1200203,202101,42183,42180,3
2021-01-05,1200179,202101,42183,42183,0
2021-01-05,1200138,202101,42184,42183,1
2021-01-05,1200104,202101,42185,42184,1
2021-01-05,1200054,202101,42185,42185,0
2021-01-05,1200450,202101,42186,42185,1
2021-01-05,1200609,202101,42185,42186,-1
2021-01-05,1200013,202101,42185,42185,0
2021-01-06,1200336,202101,42185,42185,0
2021-01-06,1200807,202101,42191,42185,6
2021-01-06,1200393,202101,42191,42191,0
2021-01-06,1200401,202101,42244,42191,53
2021-01-06,1200427,202101,42246,42244,2
2021-01-06,1200435,202101,42248,42246,2
2021-01-06,1200500,202101,42289,42248,41
2021-01-06,1200450,202101,42289,42289,0
2021-01-06,1200609,202101,42293,42289,4
2021-01-06,1200708,202101,42334,42293,41
2021-01-06,1200351,202101,42334,42334,0
2021-01-06,1200344,202101,42337,42334,3
2021-01-06,1200328,202101,42337,42337,0
2021-01-06,1200302,202101,42337,42337,0
2021-01-06,1200252,202101,42338,42337,1
2021-01-06,1200203,202101,42365,42338,27
2021-01-06,1200179,202101,42365,42365,0
2021-01-06,1200138,202101,42365,42365,0
2021-01-06,1200104,202101,42366,42365,1
2021-01-06,1200054,202101,42366,42366,0
2021-01-06,1200013,202101,42372,42366,6
2021-01-06,1200385,202101,42393,42372,21
2021-01-07,1200336,202101,42393,42393,0
2021-01-07,1200427,202101,42393,42393,0
2021-01-07,1200708,202101,42402,42393,9
2021-01-07,1200609,202101,42402,42402,0
2021-01-07,1200450,202101,42402,42402,0
2021-01-07,1200500,202101,42402,42402,0
2021-01-07,1200435,202101,42402,42402,0
2021-01-07,1200401,202101,42486,42402,84
2021-01-07,1200393,202101,42486,42486,0
2021-01-07,1200807,202101,42486,42486,0
2021-01-07,1200351,202101,42486,42486,0
2021-01-07,1200385,202101,42487,42486,1
2021-01-07,1200328,202101,42487,42487,0
2021-01-07,1200302,202101,42488,42487,1
2021-01-07,1200252,202101,42488,42488,0
2021-01-07,1200203,202101,42490,42488,2
2021-01-07,1200179,202101,42490,42490,0
2021-01-07,1200138,202101,42490,42490,0
2021-01-07,1200104,202101,42490,42490,0
2021-01-07,1200054,202101,42490,42490,0
2021-01-07,1200013,202101,42493,42490,3
2021-01-07,1200344,202101,42493,42493,0
2021-01-08,1200203,202101,42527,42493,34
2021-01-08,1200344,202101,42536,42527,9
2021-01-08,1200328,202101,42536,42536,0
2021-01-08,1200302,202101,42548,42536,12
2021-01-08,1200179,202101,42548,42548,0
2021-01-08,1200385,202101,42572,42548,24
2021-01-08,1200104,202101,42597,42572,25
2021-01-08,1200054,202101,42597,42597,0
2021-01-08,1200013,202101,42599,42597,2
2021-01-08,1200351,202101,42602,42599,3
2021-01-08,1200138,202101,42602,42602,0
2021-01-08,1200336,202101,42601,42602,-1
2021-01-08,1200252,202101,42616,42601,15
2021-01-08,1200393,202101,42617,42616,1
2021-01-08,1200401,202101,42743,42617,126
2021-01-08,1200427,202101,42745,42743,2
2021-01-08,1200435,202101,42745,42745,0
2021-01-08,1200500,202101,42790,42745,45
2021-01-08,1200450,202101,42791,42790,1
2021-01-08,1200609,202101,42794,42791,3
2021-01-08,1200708,202101,42820,42794,26
2021-01-08,1200807,202101,42829,42820,9
2021-01-09,1200708,202101,42838,42829,9
2021-01-09,1200013,202101,42838,42838,0
2021-01-09,1200054,202101,42838,42838,0
2021-01-09,1200104,202101,42870,42838,32
2021-01-09,1200138,202101,42870,42870,0
2021-01-09,1200179,202101,42872,42870,2
2021-01-09,1200203,202101,42875,42872,3
2021-01-09,1200302,202101,42875,42875,0
2021-01-09,1200450,202101,42877,42875,2
2021-01-09,1200500,202101,42881,42877,4
2021-01-09,1200435,202101,42881,42881,0
2021-01-09,1200427,202101,42880,42881,-1
2021-01-09,1200401,202101,42892,42880,12
2021-01-09,1200252,202101,42899,42892,7
2021-01-09,1200393,202101,42899,42899,0
2021-01-09,1200385,202101,42909,42899,10
2021-01-09,1200336,202101,42910,42909,1
2021-01-09,1200351,202101,42910,42910,0
2021-01-09,1200344,202101,42915,42910,5
2021-01-09,1200328,202101,42915,42915,0
2021-01-09,1200807,202101,42923,42915,8
2021-01-09,1200609,202101,42923,42923,0
2021-01-10,1200013,202102,42923,42923,0
2021-01-10,1200054,202102,42923,42923,0
2021-01-10,1200104,202102,42925,42923,2
2021-01-10,1200435,202102,42925,42925,0
2021-01-10,1200427,202102,42925,42925,0
2021-01-10,1200138,202102,42926,42925,1
2021-01-10,1200500,202102,42933,42926,7
2021-01-10,1200450,202102,42939,42933,6
2021-01-10,1200609,202102,42939,42939,0
2021-01-10,1200708,202102,42942,42939,3
2021-01-10,1200807,202102,42950,42942,8
2021-01-10,1200385,202102,42966,42950,16
2021-01-10,1200336,202102,42966,42966,0
2021-01-10,1200351,202102,42966,42966,0
2021-01-10,1200344,202102,42966,42966,0
2021-01-10,1200328,202102,42966,42966,0
2021-01-10,1200302,202102,42987,42966,21
2021-01-10,1200252,202102,42987,42987,0
2021-01-10,1200203,202102,42988,42987,1
2021-01-10,1200179,202102,42994,42988,6
2021-01-10,1200401,202102,43142,42994,148
2021-01-10,1200393,202102,43142,43142,0
2021-01-11,1200385,202102,43170,43142,28
2021-01-11,1200393,202102,43170,43170,0
2021-01-11,1200054,202102,43170,43170,0
2021-01-11,1200104,202102,43179,43170,9
2021-01-11,1200807,202102,43182,43179,3
2021-01-11,1200138,202102,43182,43182,0
2021-01-11,1200179,202102,43182,43182,0
2021-01-11,1200203,202102,43185,43182,3
2021-01-11,1200252,202102,43192,43185,7
2021-01-11,1200302,202102,43193,43192,1
2021-01-11,1200328,202102,43193,43193,0
2021-01-11,1200344,202102,43195,43193,2
2021-01-11,1200013,202102,43195,43195,0
2021-01-11,1200351,202102,43196,43195,1
2021-01-11,1200336,202102,43195,43196,-1
2021-01-11,1200500,202102,43232,43195,37
2021-01-11,1200609,202102,43232,43232,0
2021-01-11,1200427,202102,43234,43232,2
2021-01-11,1200708,202102,43256,43234,22
2021-01-11,1200435,202102,43256,43256,0
2021-01-11,1200401,202102,43361,43256,105
2021-01-11,1200450,202102,43361,43361,0
2021-01-12,1200013,202102,43361,43361,0
2021-01-12,1200054,202102,43361,43361,0
2021-01-12,1200104,202102,43361,43361,0
2021-01-12,1200138,202102,43361,43361,0
2021-01-12,1200179,202102,43361,43361,0
2021-01-12,1200203,202102,43365,43361,4
2021-01-12,1200252,202102,43365,43365,0
2021-01-12,1200328,202102,43365,43365,0
2021-01-12,1200302,202102,43365,43365,0
2021-01-12,1200336,202102,43365,43365,0
2021-01-12,1200385,202102,43365,43365,0
2021-01-12,1200807,202102,43365,43365,0
2021-01-12,1200393,202102,43365,43365,0
2021-01-12,1200401,202102,43447,43365,82
2021-01-12,1200427,202102,43447,43447,0
2021-01-12,1200435,202102,43447,43447,0
2021-01-12,1200500,202102,43447,43447,0
2021-01-12,1200450,202102,43447,43447,0
2021-01-12,1200609,202102,43447,43447,0
2021-01-12,1200708,202102,43447,43447,0
2021-01-12,1200351,202102,43447,43447,0
2021-01-12,1200344,202102,43447,43447,0
2021-01-13,1200179,202102,43451,43447,4
2021-01-13,1200138,202102,43452,43451,1
2021-01-13,1200104,202102,43453,43452,1
2021-01-13,1200013,202102,43455,43453,2
2021-01-13,1200054,202102,43456,43455,1
2021-01-13,1200807,202102,43462,43456,6
2021-01-13,1200500,202102,43489,43462,27
2021-01-13,1200435,202102,43494,43489,5
2021-01-13,1200427,202102,43496,43494,2
2021-01-13,1200401,202102,43673,43496,177
2021-01-13,1200393,202102,43673,43673,0
2021-01-13,1200708,202102,43701,43673,28
2021-01-13,1200450,202102,43713,43701,12
2021-01-13,1200385,202102,43749,43713,36
2021-01-13,1200351,202102,43750,43749,1
2021-01-13,1200344,202102,43755,43750,5
2021-01-13,1200328,202102,43755,43755,0
2021-01-13,1200302,202102,43779,43755,24
2021-01-13,1200252,202102,43785,43779,6
2021-01-13,1200203,202102,43794,43785,9
2021-01-13,1200336,202102,43796,43794,2
2021-01-13,1200609,202102,43800,43796,4
2021-01-14,1200427,202102,43805,43800,5
2021-01-14,1200401,202102,43913,43805,108
2021-01-14,1200013,202102,43917,43913,4
2021-01-14,1200104,202102,43937,43917,20
2021-01-14,1200435,202102,43938,43937,1
2021-01-14,1200393,202102,43938,43938,0
2021-01-14,1200450,202102,43944,43938,6
2021-01-14,1200609,202102,43966,43944,22
2021-01-14,1200708,202102,43990,43966,24
2021-01-14,1200807,202102,43991,43990,1
2021-01-14,1200385,202102,44002,43991,11
2021-01-14,1200054,202102,44010,44002,8
2021-01-14,1200336,202102,44010,44010,0
2021-01-14,1200344,202102,44012,44010,2
2021-01-14,1200328,202102,44012,44012,0
2021-01-14,1200302,202102,44012,44012,0
2021-01-14,1200252,202102,44025,44012,13
2021-01-14,1200203,202102,44051,44025,26
2021-01-14,1200179,202102,44051,44051,0
2021-01-14,1200138,202102,44057,44051,6
2021-01-14,1200351,202102,44058,44057,1
2021-01-14,1200500,202102,44083,44058,25
2021-01-15,1200385,202102,44085,44083,2
2021-01-15,1200401,202102,44128,44085,43
2021-01-15,1200708,202102,44128,44128,0
2021-01-15,1200609,202102,44128,44128,0
2021-01-15,1200450,202102,44129,44128,1
2021-01-15,1200500,202102,44132,44129,3
2021-01-15,1200435,202102,44132,44132,0
2021-01-15,1200427,202102,44132,44132,0
2021-01-15,1200393,202102,44132,44132,0
2021-01-15,1200807,202102,44139,44132,7
2021-01-15,1200351,202102,44139,44139,0
2021-01-15,1200336,202102,44139,44139,0
2021-01-15,1200328,202102,44139,44139,0
2021-01-15,1200302,202102,44153,44139,14
2021-01-15,1200252,202102,44159,44153,6
2021-01-15,1200203,202102,44163,44159,4
2021-01-15,1200179,202102,44166,44163,3
2021-01-15,1200138,202102,44167,44166,1
2021-01-15,1200104,202102,44167,44167,0
2021-01-15,1200054,202102,44167,44167,0
2021-01-15,1200013,202102,44171,44167,4
2021-01-15,1200344,202102,44171,44171,0
2021-01-16,1200203,202102,44202,44171,31
2021-01-16,1200328,202102,44202,44202,0
2021-01-16,1200252,202102,44205,44202,3
2021-01-16,1200179,202102,44206,44205,1
2021-01-16,1200385,202102,44232,44206,26
2021-01-16,1200104,202102,44249,44232,17
2021-01-16,1200054,202102,44291,44249,42
2021-01-16,1200013,202102,44299,44291,8
2021-01-16,1200344,202102,44302,44299,3
2021-01-16,1200138,202102,44306,44302,4
2021-01-16,1200336,202102,44319,44306,13
2021-01-16,1200351,202102,44319,44319,0
2021-01-16,1200302,202102,44329,44319,10
2021-01-16,1200807,202102,44337,44329,8
2021-01-16,1200393,202102,44337,44337,0
2021-01-16,1200401,202102,44390,44337,53
2021-01-16,1200427,202102,44393,44390,3
2021-01-16,1200435,202102,44395,44393,2
2021-01-16,1200500,202102,44417,44395,22
2021-01-16,1200450,202102,44422,44417,5
2021-01-16,1200609,202102,44570,44422,148
2021-01-16,1200708,202102,44636,44570,66
2021-01-17,1200013,202103,44634,44636,-2
2021-01-17,1200054,202103,44634,44634,0
2021-01-17,1200104,202103,44649,44634,15
2021-01-17,1200138,202103,44647,44649,-2
2021-01-17,1200179,202103,44647,44647,0
2021-01-17,1200609,202103,44648,44647,1
2021-01-17,1200252,202103,44690,44648,42
2021-01-17,1200302,202103,44692,44690,2
2021-01-17,1200328,202103,44692,44692,0
2021-01-17,1200344,202103,44692,44692,0
2021-01-17,1200351,202103,44692,44692,0
2021-01-17,1200336,202103,44692,44692,0
2021-01-17,1200385,202103,44692,44692,0
2021-01-17,1200807,202103,44691,44692,-1
2021-01-17,1200393,202103,44691,44691,0
2021-01-17,1200401,202103,44783,44691,92
2021-01-17,1200427,202103,44783,44783,0
2021-01-17,1200435,202103,44783,44783,0
2021-01-17,1200500,202103,44783,44783,0
2021-01-17,1200450,202103,44783,44783,0
2021-01-17,1200708,202103,44782,44783,-1
2021-01-17,1200203,202103,44782,44782,0
2021-01-18,1200252,202103,44782,44782,0
2021-01-18,1200427,202103,44782,44782,0
2021-01-18,1200708,202103,44782,44782,0
2021-01-18,1200609,202103,44782,44782,0
2021-01-18,1200450,202103,44782,44782,0
2021-01-18,1200500,202103,44782,44782,0
2021-01-18,1200435,202103,44782,44782,0
2021-01-18,1200401,202103,44784,44782,2
2021-01-18,1200393,202103,44784,44784,0
2021-01-18,1200807,202103,44786,44784,2
2021-01-18,1200336,202103,44787,44786,1
2021-01-18,1200385,202103,44787,44787,0
2021-01-18,1200344,202103,44787,44787,0
2021-01-18,1200328,202103,44787,44787,0
2021-01-18,1200302,202103,44787,44787,0
2021-01-18,1200203,202103,44787,44787,0
2021-01-18,1200179,202103,44787,44787,0
2021-01-18,1200138,202103,44789,44787,2
2021-01-18,1200104,202103,44789,44789,0
2021-01-18,1200054,202103,44789,44789,0
2021-01-18,1200013,202103,44790,44789,1
2021-01-18,1200351,202103,44790,44790,0
2021-01-19,1200252,202103,44790,44790,0
2021-01-19,1200344,202103,44795,44790,5
2021-01-19,1200328,202103,44795,44795,0
2021-01-19,1200302,202103,44809,44795,14
2021-01-19,1200203,202103,44866,44809,57
2021-01-19,1200385,202103,44893,44866,27
2021-01-19,1200138,202103,44893,44893,0
2021-01-19,1200104,202103,44894,44893,1
2021-01-19,1200013,202103,44897,44894,3
2021-01-19,1200351,202103,44897,44897,0
2021-01-19,1200179,202103,44898,44897,1
2021-01-19,1200336,202103,44900,44898,2
2021-01-19,1200054,202103,44901,44900,1
2021-01-19,1200807,202103,44902,44901,1
2021-01-19,1200393,202103,44902,44902,0
2021-01-19,1200401,202103,45024,44902,122
2021-01-19,1200427,202103,45025,45024,1
2021-01-19,1200435,202103,45027,45025,2
2021-01-19,1200500,202103,45075,45027,48
2021-01-19,1200450,202103,45078,45075,3
2021-01-19,1200609,202103,45174,45078,96
2021-01-19,1200708,202103,45223,45174,49
2021-01-20,1200708,202103,45242,45223,19
2021-01-20,1200013,202103,45245,45242,3
2021-01-20,1200054,202103,45243,45245,-2
2021-01-20,1200104,202103,45273,45243,30
2021-01-20,1200138,202103,45273,45273,0
2021-01-20,1200179,202103,45273,45273,0
2021-01-20,1200203,202103,45285,45273,12
2021-01-20,1200807,202103,45285,45285,0
2021-01-20,1200450,202103,45287,45285,2
2021-01-20,1200500,202103,45301,45287,14
2021-01-20,1200435,202103,45306,45301,5
2021-01-20,1200427,202103,45306,45306,0
2021-01-20,1200401,202103,45369,45306,63
2021-01-20,1200393,202103,45371,45369,2
2021-01-20,1200252,202103,45373,45371,2
2021-01-20,1200609,202103,45441,45373,68
2021-01-20,1200336,202103,45441,45441,0
2021-01-20,1200351,202103,45441,45441,0
2021-01-20,1200344,202103,45442,45441,1
2021-01-20,1200328,202103,45442,45442,0
2021-01-20,1200302,202103,45442,45442,0
2021-01-20,1200385,202103,45444,45442,2
2021-01-21,1200054,202103,45444,45444,0
2021-01-21,1200013,202103,45450,45444,6
2021-01-21,1200104,202103,45464,45450,14
2021-01-21,1200708,202103,45483,45464,19
2021-01-21,1200450,202103,45488,45483,5
2021-01-21,1200500,202103,45502,45488,14
2021-01-21,1200435,202103,45507,45502,5
2021-01-21,1200427,202103,45509,45507,2
2021-01-21,1200401,202103,45609,45509,100
2021-01-21,1200393,202103,45616,45609,7
2021-01-21,1200807,202103,45617,45616,1
2021-01-21,1200385,202103,45632,45617,15
2021-01-21,1200336,202103,45632,45632,0
2021-01-21,1200351,202103,45634,45632,2
2021-01-21,1200344,202103,45635,45634,1
2021-01-21,1200328,202103,45635,45635,0
2021-01-21,1200302,202103,45636,45635,1
2021-01-21,1200252,202103,45638,45636,2
2021-01-21,1200203,202103,45663,45638,25
2021-01-21,1200179,202103,45663,45663,0
2021-01-21,1200138,202103,45664,45663,1
2021-01-21,1200609,202103,45744,45664,80
2021-01-22,1200807,202103,45747,45744,3
2021-01-22,1200393,202103,45753,45747,6
2021-01-22,1200054,202103,45753,45753,0
2021-01-22,1200401,202103,45770,45753,17
2021-01-22,1200427,202103,45788,45770,18
2021-01-22,1200385,202103,45800,45788,12
2021-01-22,1200500,202103,45818,45800,18
2021-01-22,1200450,202103,45828,45818,10
2021-01-22,1200609,202103,45917,45828,89
2021-01-22,1200708,202103,45929,45917,12
2021-01-22,1200336,202103,45932,45929,3
2021-01-22,1200351,202103,45932,45932,0
2021-01-22,1200344,202103,45932,45932,0
2021-01-22,1200328,202103,45932,45932,0
2021-01-22,1200302,202103,45933,45932,1
2021-01-22,1200252,202103,45942,45933,9
2021-01-22,1200203,202103,45967,45942,25
2021-01-22,1200179,202103,45967,45967,0
2021-01-22,1200138,202103,45969,45967,2
2021-01-22,1200104,202103,45987,45969,18
2021-01-22,1200013,202103,45998,45987,11
2021-01-22,1200435,202103,46002,45998,4
2021-01-23,1200435,202103,46004,46002,2
2021-01-23,1200708,202103,46045,46004,41
2021-01-23,1200500,202103,46074,46045,29
2021-01-23,1200427,202103,46074,46074,0
2021-01-23,1200401,202103,46169,46074,95
2021-01-23,1200393,202103,46169,46169,0
2021-01-23,1200807,202103,46169,46169,0
2021-01-23,1200385,202103,46167,46169,-2
2021-01-23,1200336,202103,46181,46167,14
2021-01-23,1200351,202103,46182,46181,1
2021-01-23,1200344,202103,46183,46182,1
2021-01-23,1200328,202103,46183,46183,0
2021-01-23,1200302,202103,46182,46183,-1
2021-01-23,1200252,202103,46184,46182,2
2021-01-23,1200203,202103,46185,46184,1
2021-01-23,1200179,202103,46185,46185,0
2021-01-23,1200138,202103,46185,46185,0
2021-01-23,1200104,202103,46192,46185,7
2021-01-23,1200054,202103,46196,46192,4
2021-01-23,1200450,202103,46201,46196,5
2021-01-23,1200609,202103,46246,46201,45
2021-01-23,1200013,202103,46254,46246,8
2021-01-24,1200336,202104,46255,46254,1
2021-01-24,1200807,202104,46260,46255,5
2021-01-24,1200393,202104,46260,46260,0
2021-01-24,1200401,202104,46392,46260,132
2021-01-24,1200427,202104,46392,46392,0
2021-01-24,1200435,202104,46392,46392,0
2021-01-24,1200500,202104,46396,46392,4
2021-01-24,1200450,202104,46396,46396,0
2021-01-24,1200609,202104,46397,46396,1
2021-01-24,1200708,202104,46399,46397,2
2021-01-24,1200351,202104,46400,46399,1
2021-01-24,1200344,202104,46400,46400,0
2021-01-24,1200328,202104,46400,46400,0
2021-01-24,1200302,202104,46400,46400,0
2021-01-24,1200252,202104,46413,46400,13
2021-01-24,1200203,202104,46414,46413,1
2021-01-24,1200179,202104,46414,46414,0
2021-01-24,1200138,202104,46415,46414,1
2021-01-24,1200104,202104,46438,46415,23
2021-01-24,1200054,202104,46440,46438,2
2021-01-24,1200013,202104,46440,46440,0
2021-01-24,1200385,202104,46444,46440,4
2021-01-25,1200336,202104,46458,46444,14
2021-01-25,1200427,202104,46458,46458,0
2021-01-25,1200708,202104,46460,46458,2
2021-01-25,1200609,202104,46460,46460,0
2021-01-25,1200450,202104,46468,46460,8
2021-01-25,1200500,202104,46471,46468,3
2021-01-25,1200435,202104,46472,46471,1
2021-01-25,1200401,202104,46527,46472,55
2021-01-25,1200393,202104,46527,46527,0
2021-01-25,1200807,202104,46527,46527,0
2021-01-25,1200351,202104,46527,46527,0
2021-01-25,1200385,202104,46533,46527,6
2021-01-25,1200328,202104,46533,46533,0
2021-01-25,1200302,202104,46533,46533,0
2021-01-25,1200252,202104,46534,46533,1
2021-01-25,1200203,202104,46535,46534,1
2021-01-25,1200179,202104,46536,46535,1
2021-01-25,1200138,202104,46540,46536,4
2021-01-25,1200104,202104,46540,46540,0
2021-01-25,1200054,202104,46553,46540,13
2021-01-25,1200013,202104,46554,46553,1
2021-01-25,1200344,202104,46554,46554,0
2021-01-26,1200203,202104,46564,46554,10
2021-01-26,1200344,202104,46564,46564,0
2021-01-26,1200328,202104,46564,46564,0
2021-01-26,1200302,202104,46574,46564,10
2021-01-26,1200179,202104,46574,46574,0
2021-01-26,1200385,202104,46589,46574,15
2021-01-26,1200104,202104,46607,46589,18
2021-01-26,1200054,202104,46610,46607,3
2021-01-26,1200013,202104,46610,46610,0
2021-01-26,1200351,202104,46609,46610,-1
2021-01-26,1200138,202104,46609,46609,0
2021-01-26,1200336,202104,46610,46609,1
2021-01-26,1200252,202104,46625,46610,15
2021-01-26,1200393,202104,46625,46625,0
2021-01-26,1200401,202104,46754,46625,129
2021-01-26,1200427,202104,46755,46754,1
2021-01-26,1200435,202104,46755,46755,0
2021-01-26,1200500,202104,46757,46755,2
2021-01-26,1200450,202104,46760,46757,3
2021-01-26,1200609,202104,46772,46760,12
2021-01-26,1200708,202104,46789,46772,17
2021-01-26,1200807,202104,46789,46789,0
2021-01-27,1200708,202104,46806,46789,17
2021-01-27,1200013,202104,46808,46806,2
2021-01-27,1200054,202104,46810,46808,2
2021-01-27,1200104,202104,46820,46810,10
2021-01-27,1200138,202104,46820,46820,0
2021-01-27,1200179,202104,46824,46820,4
2021-01-27,1200203,202104,46830,46824,6
2021-01-27,1200302,202104,46836,46830,6
2021-01-27,1200450,202104,46837,46836,1
2021-01-27,1200500,202104,46872,46837,35
2021-01-27,1200435,202104,46877,46872,5
2021-01-27,1200427,202104,46877,46877,0
2021-01-27,1200401,202104,47002,46877,125
2021-01-27,1200252,202104,47004,47002,2
2021-01-27,1200393,202104,47009,47004,5
2021-01-27,1200385,202104,47042,47009,33
2021-01-27,1200336,202104,47081,47042,39
2021-01-27,1200351,202104,47082,47081,1
2021-01-27,1200344,202104,47084,47082,2
2021-01-27,1200328,202104,47084,47084,0
2021-01-27,1200807,202104,47092,47084,8
2021-01-27,1200609,202104,47134,47092,42
2021-01-28,1200013,202104,47147,47134,13
2021-01-28,1200054,202104,47173,47147,26
2021-01-28,1200104,202104,47186,47173,13
2021-01-28,1200179,202104,47186,47186,0
2021-01-28,1200252,202104,47194,47186,8
2021-01-28,1200302,202104,47204,47194,10
2021-01-28,1200328,202104,47204,47204,0
2021-01-28,1200344,202104,47205,47204,1
2021-01-28,1200351,202104,47207,47205,2
2021-01-28,1200336,202104,47244,47207,37
2021-01-28,1200385,202104,47258,47244,14
2021-01-28,1200807,202104,47258,47258,0
2021-01-28,1200393,202104,47275,47258,17
2021-01-28,1200401,202104,47411,47275,136
2021-01-28,1200427,202104,47411,47411,0
2021-01-28,1200435,202104,47411,47411,0
2021-01-28,1200500,202104,47442,47411,31
2021-01-28,1200203,202104,47466,47442,24
2021-01-28,1200450,202104,47466,47466,0
2021-01-28,1200609,202104,47468,47466,2
2021-01-28,1200708,202104,47476,47468,8
2021-01-28,1200138,202104,47476,47476,0
2021-01-29,1200013,202104,47480,47476,4
2021-01-29,1200054,202104,47516,47480,36
2021-01-29,1200104,202104,47525,47516,9
2021-01-29,1200138,202104,47526,47525,1
2021-01-29,1200179,202104,47526,47526,0
2021-01-29,1200203,202104,47557,47526,31
2021-01-29,1200252,202104,47561,47557,4
2021-01-29,1200302,202104,47562,47561,1
2021-01-29,1200328,202104,47562,47562,0
2021-01-29,1200344,202104,47562,47562,0
2021-01-29,1200351,202104,47563,47562,1
2021-01-29,1200385,202104,47583,47563,20
2021-01-29,1200393,202104,47597,47583,14
2021-01-29,1200807,202104,47600,47597,3
2021-01-29,1200401,202104,47777,47600,177
2021-01-29,1200427,202104,47783,47777,6
2021-01-29,1200435,202104,47789,47783,6
2021-01-29,1200500,202104,47820,47789,31
2021-01-29,1200450,202104,47825,47820,5
2021-01-29,1200609,202104,47919,47825,94
2021-01-29,1200708,202104,47933,47919,14
2021-01-29,1200336,202104,47951,47933,18
2021-01-30,1200013,202104,47956,47951,5
2021-01-30,1200054,202104,47956,47956,0
2021-01-30,1200104,202104,47958,47956,2
2021-01-30,1200138,202104,47964,47958,6
2021-01-30,1200179,202104,47968,47964,4
2021-01-30,1200203,202104,47990,47968,22
2021-01-30,1200708,202104,48002,47990,12
2021-01-30,1200328,202104,48002,48002,0
2021-01-30,1200344,202104,48004,48002,2
2021-01-30,1200351,202104,48004,48004,0
2021-01-30,1200336,202104,48031,48004,27
2021-01-30,1200385,202104,48038,48031,7
2021-01-30,1200807,202104,48041,48038,3
2021-01-30,1200393,202104,48042,48041,1
2021-01-30,1200401,202104,48186,48042,144
2021-01-30,1200427,202104,48204,48186,18
2021-01-30,1200435,202104,48211,48204,7
2021-01-30,1200500,202104,48219,48211,8
2021-01-30,1200450,202104,48222,48219,3
2021-01-30,1200609,202104,48318,48222,96
2021-01-30,1200302,202104,48341,48318,23
2021-01-30,1200252,202104,48362,48341,21
2021-01-31,1200435,202105,48362,48362,0
2021-01-31,1200393,202105,48362,48362,0
2021-01-31,1200708,202105,48366,48362,4
2021-01-31,1200609,202105,48366,48366,0
2021-01-31,1200450,202105,48365,48366,-1
2021-01-31,1200500,202105,48374,48365,9
2021-01-31,1200427,202105,48374,48374,0
2021-01-31,1200401,202105,48441,48374,67
2021-01-31,1200807,202105,48441,48441,0
2021-01-31,1200385,202105,48451,48441,10
2021-01-31,1200351,202105,48453,48451,2
2021-01-31,1200336,202105,48453,48453,0
2021-01-31,1200328,202105,48453,48453,0
2021-01-31,1200302,202105,48452,48453,-1
2021-01-31,1200252,202105,48452,48452,0
2021-01-31,1200203,202105,48459,48452,7
2021-01-31,1200179,202105,48460,48459,1
2021-01-31,1200138,202105,48461,48460,1
2021-01-31,1200104,202105,48481,48461,20
2021-01-31,1200054,202105,48482,48481,1
2021-01-31,1200013,202105,48482,48482,0
2021-01-31,1200344,202105,48482,48482,0
2021-02-01,1200203,202105,48518,48482,36
2021-02-01,1200302,202105,48517,48518,-1
2021-02-01,1200252,202105,48520,48517,3
2021-02-01,1200179,202105,48520,48520,0
2021-02-01,1200351,202105,48521,48520,1
2021-02-01,1200104,202105,48525,48521,4
2021-02-01,1200054,202105,48522,48525,-3
2021-02-01,1200013,202105,48522,48522,0
2021-02-01,1200328,202105,48522,48522,0
2021-02-01,1200138,202105,48522,48522,0
2021-02-01,1200336,202105,48547,48522,25
2021-02-01,1200344,202105,48549,48547,2
2021-02-01,1200385,202105,48550,48549,1
2021-02-01,1200807,202105,48551,48550,1
2021-02-01,1200393,202105,48550,48551,-1
2021-02-01,1200401,202105,48713,48550,163
2021-02-01,1200427,202105,48717,48713,4
2021-02-01,1200435,202105,48717,48717,0
2021-02-01,1200500,202105,48746,48717,29
2021-02-01,1200450,202105,48748,48746,2
2021-02-01,1200609,202105,48826,48748,78
2021-02-01,1200708,202105,48835,48826,9
2021-02-02,1200013,202105,48835,48835,0
2021-02-02,1200054,202105,48859,48835,24
2021-02-02,1200104,202105,48867,48859,8
2021-02-02,1200138,202105,48870,48867,3
2021-02-02,1200179,202105,48874,48870,4
2021-02-02,1200609,202105,48882,48874,8
2021-02-02,1200252,202105,48887,48882,5
2021-02-02,1200302,202105,48906,48887,19
2021-02-02,1200328,202105,48906,48906,0
2021-02-02,1200344,202105,48906,48906,0
2021-02-02,1200351,202105,48906,48906,0
2021-02-02,1200336,202105,48906,48906,0
2021-02-02,1200385,202105,48925,48906,19
2021-02-02,1200807,202105,48928,48925,3
2021-02-02,1200393,202105,48928,48928,0
2021-02-02,1200401,202105,49046,48928,118
2021-02-02,1200427,202105,49046,49046,0
2021-02-02,1200435,202105,49046,49046,0
2021-02-02,1200500,202105,49059,49046,13
2021-02-02,1200450,202105,49060,49059,1
2021-02-02,1200708,202105,49059,49060,-1
2021-02-02,1200203,202105,49064,49059,5
2021-02-03,1200336,202105,49120,49064,56
2021-02-03,1200427,202105,49121,49120,1
2021-02-03,1200708,202105,49144,49121,23
2021-02-03,1200609,202105,49256,49144,112
2021-02-03,1200450,202105,49261,49256,5
2021-02-03,1200500,202105,49289,49261,28
2021-02-03,1200435,202105,49290,49289,1
2021-02-03,1200401,202105,49471,49290,181
2021-02-03,1200393,202105,49471,49471,0
2021-02-03,1200807,202105,49470,49471,-1
2021-02-03,1200351,202105,49470,49470,0
2021-02-03,1200385,202105,49476,49470,6
2021-02-03,1200328,202105,49476,49476,0
2021-02-03,1200302,202105,49477,49476,1
2021-02-03,1200252,202105,49495,49477,18
2021-02-03,1200203,202105,49510,49495,15
2021-02-03,1200179,202105,49510,49510,0
2021-02-03,1200138,202105,49510,49510,0
2021-02-03,1200104,202105,49558,49510,48
2021-02-03,1200054,202105,49558,49558,0
2021-02-03,1200013,202105,49559,49558,1
2021-02-03,1200344,202105,49562,49559,3
2021-02-04,1200203,202105,49605,49562,43
2021-02-04,1200344,202105,49609,49605,4
2021-02-04,1200328,202105,49609,49609,0
2021-02-04,1200302,202105,49610,49609,1
2021-02-04,1200179,202105,49610,49610,0
2021-02-04,1200385,202105,49615,49610,5
2021-02-04,1200104,202105,49627,49615,12
2021-02-04,1200054,202105,49627,49627,0
2021-02-04,1200013,202105,49661,49627,34
2021-02-04,1200351,202105,49661,49661,0
2021-02-04,1200138,202105,49662,49661,1
2021-02-04,1200336,202105,49728,49662,66
2021-02-04,1200252,202105,49762,49728,34
2021-02-04,1200807,202105,49763,49762,1
2021-02-04,1200393,202105,49768,49763,5
2021-02-04,1200401,202105,49905,49768,137
2021-02-04,1200427,202105,49905,49905,0
2021-02-04,1200435,202105,49909,49905,4
2021-02-04,1200500,202105,49925,49909,16
2021-02-04,1200450,202105,49925,49925,0
2021-02-04,1200609,202105,49957,49925,32
2021-02-04,1200708,202105,49959,49957,2
2021-02-05,1200708,202105,49966,49959,7
2021-02-05,1200013,202105,49971,49966,5
2021-02-05,1200054,202105,49971,49971,0
2021-02-05,1200104,202105,49971,49971,0
2021-02-05,1200138,202105,49971,49971,0
2021-02-05,1200179,202105,49972,49971,1
2021-02-05,1200203,202105,49973,49972,1
2021-02-05,1200807,202105,49974,49973,1
2021-02-05,1200450,202105,49973,49974,-1
2021-02-05,1200500,202105,49974,49973,1
2021-02-05,1200435,202105,49974,49974,0
2021-02-05,1200427,202105,49975,49974,1
2021-02-05,1200401,202105,50100,49975,125
2021-02-05,1200393,202105,50100,50100,0
2021-02-05,1200252,202105,50101,50100,1
2021-02-05,1200609,202105,50102,50101,1
2021-02-05,1200336,202105,50102,50102,0
2021-02-05,1200351,202105,50102,50102,0
2021-02-05,1200344,202105,50102,50102,0
2021-02-05,1200328,202105,50102,50102,0
2021-02-05,1200302,202105,50125,50102,23
2021-02-05,1200385,202105,50137,50125,12
2021-02-06,1200054,202105,50171,50137,34
2021-02-06,1200013,202105,50183,50171,12
2021-02-06,1200104,202105,50212,50183,29
2021-02-06,1200708,202105,50230,50212,18
2021-02-06,1200450,202105,50232,50230,2
2021-02-06,1200500,202105,50242,50232,10
2021-02-06,1200435,202105,50244,50242,2
2021-02-06,1200427,202105,50249,50244,5
2021-02-06,1200401,202105,50280,50249,31
2021-02-06,1200393,202105,50280,50280,0
2021-02-06,1200807,202105,50279,50280,-1
2021-02-06,1200385,202105,50284,50279,5
2021-02-06,1200336,202105,50322,50284,38
2021-02-06,1200351,202105,50323,50322,1
2021-02-06,1200344,202105,50325,50323,2
2021-02-06,1200328,202105,50325,50325,0
2021-02-06,1200302,202105,50326,50325,1
2021-02-06,1200252,202105,50372,50326,46
2021-02-06,1200203,202105,50413,50372,41
2021-02-06,1200179,202105,50413,50413,0
2021-02-06,1200138,202105,50422,50413,9
2021-02-06,1200609,202105,50469,50422,47
2021-02-07,1200807,202106,50469,50469,0
2021-02-07,1200393,202106,50469,50469,0
2021-02-07,1200054,202106,50469,50469,0
2021-02-07,1200401,202106,50533,50469,64
2021-02-07,1200427,202106,50533,50533,0
2021-02-07,1200385,202106,50534,50533,1
2021-02-07,1200500,202106,50540,50534,6
2021-02-07,1200450,202106,50540,50540,0
2021-02-07,1200609,202106,50540,50540,0
2021-02-07,1200708,202106,50554,50540,14
2021-02-07,1200336,202106,50554,50554,0
2021-02-07,1200351,202106,50554,50554,0
2021-02-07,1200344,202106,50554,50554,0
2021-02-07,1200328,202106,50554,50554,0
2021-02-07,1200302,202106,50554,50554,0
2021-02-07,1200252,202106,50554,50554,0
2021-02-07,1200203,202106,50557,50554,3
2021-02-07,1200179,202106,50557,50557,0
2021-02-07,1200138,202106,50557,50557,0
2021-02-07,1200104,202106,50557,50557,0
2021-02-07,1200013,202106,50561,50557,4
2021-02-07,1200435,202106,50561,50561,0
2021-02-08,1200435,202106,50561,50561,0
2021-02-08,1200708,202106,50562,50561,1
2021-02-08,1200500,202106,50561,50562,-1
2021-02-08,1200427,202106,50561,50561,0
2021-02-08,1200401,202106,50663,50561,102
2021-02-08,1200393,202106,50663,50663,0
2021-02-08,1200807,202106,50663,50663,0
2021-02-08,1200385,202106,50663,50663,0
2021-02-08,1200336,202106,50663,50663,0
2021-02-08,1200351,202106,50663,50663,0
2021-02-08,1200344,202106,50663,50663,0
2021-02-08,1200328,202106,50663,50663,0
2021-02-08,1200302,202106,50663,50663,0
2021-02-08,1200252,202106,50669,50663,6
2021-02-08,1200203,202106,50677,50669,8
2021-02-08,1200179,202106,50677,50677,0
2021-02-08,1200138,202106,50681,50677,4
2021-02-08,1200104,202106,50696,50681,15
2021-02-08,1200054,202106,50696,50696,0
2021-02-08,1200450,202106,50697,50696,1
2021-02-08,1200609,202106,50699,50697,2
2021-02-08,1200013,202106,50709,50699,10
2021-02-09,1200336,202106,50772,50709,63
2021-02-09,1200807,202106,50774,50772,2
2021-02-09,1200393,202106,50776,50774,2
2021-02-09,1200401,202106,50886,50776,110
2021-02-09,1200427,202106,50899,50886,13
2021-02-09,1200435,202106,50899,50899,0
2021-02-09,1200500,202106,50937,50899,38
2021-02-09,1200450,202106,50938,50937,1
2021-02-09,1200609,202106,51052,50938,114
2021-02-09,1200708,202106,51062,51052,10
2021-02-09,1200351,202106,51063,51062,1
2021-02-09,1200344,202106,51065,51063,2
2021-02-09,1200328,202106,51072,51065,7
2021-02-09,1200302,202106,51072,51072,0
2021-02-09,1200252,202106,51098,51072,26
2021-02-09,1200203,202106,51191,51098,93
2021-02-09,1200179,202106,51191,51191,0
2021-02-09,1200138,202106,51192,51191,1
2021-02-09,1200104,202106,51201,51192,9
2021-02-09,1200054,202106,51231,51201,30
2021-02-09,1200013,202106,51247,51231,16
2021-02-09,1200385,202106,51284,51247,37
2021-02-10,1200054,202106,51300,51284,16
2021-02-10,1200427,202106,51305,51300,5
2021-02-10,1200708,202106,51325,51305,20
2021-02-10,1200609,202106,51408,51325,83
2021-02-10,1200450,202106,51410,51408,2
2021-02-10,1200500,202106,51429,51410,19
2021-02-10,1200435,202106,51429,51429,0
2021-02-10,1200401,202106,51541,51429,112
2021-02-10,1200393,202106,51541,51541,0
2021-02-10,1200807,202106,51542,51541,1
2021-02-10,1200336,202106,51542,51542,0
2021-02-10,1200385,202106,51545,51542,3
2021-02-10,1200344,202106,51551,51545,6
2021-02-10,1200328,202106,51551,51551,0
2021-02-10,1200302,202106,51573,51551,22
2021-02-10,1200252,202106,51582,51573,9
2021-02-10,1200203,202106,51649,51582,67
2021-02-10,1200179,202106,51657,51649,8
2021-02-10,1200138,202106,51660,51657,3
2021-02-10,1200104,202106,51675,51660,15
2021-02-10,1200013,202106,51681,51675,6
2021-02-10,1200351,202106,51694,51681,13
2021-02-11,1200203,202106,51770,51694,76
2021-02-11,1200344,202106,51774,51770,4
2021-02-11,1200328,202106,51774,51774,0
2021-02-11,1200302,202106,51776,51774,2
2021-02-11,1200179,202106,51777,51776,1
2021-02-11,1200385,202106,51788,51777,11
2021-02-11,1200104,202106,51802,51788,14
2021-02-11,1200054,202106,51803,51802,1
2021-02-11,1200013,202106,51820,51803,17
2021-02-11,1200351,202106,51825,51820,5
2021-02-11,1200138,202106,51836,51825,11
2021-02-11,1200336,202106,51836,51836,0
2021-02-11,1200252,202106,51844,51836,8
2021-02-11,1200393,202106,51846,51844,2
2021-02-11,1200401,202106,52019,51846,173
2021-02-11,1200427,202106,52027,52019,8
2021-02-11,1200435,202106,52028,52027,1
2021-02-11,1200500,202106,52077,52028,49
2021-02-11,1200450,202106,52082,52077,5
2021-02-11,1200609,202106,52172,52082,90
2021-02-11,1200708,202106,52183,52172,11
2021-02-11,1200807,202106,52187,52183,4
2021-02-12,1200708,202106,52215,52187,28
2021-02-12,1200013,202106,52215,52215,0
2021-02-12,1200054,202106,52224,52215,9
2021-02-12,1200104,202106,52225,52224,1
2021-02-12,1200138,202106,52228,52225,3
2021-02-12,1200179,202106,52228,52228,0
2021-02-12,1200203,202106,52329,52228,101
2021-02-12,1200302,202106,52328,52329,-1
2021-02-12,1200450,202106,52327,52328,-1
2021-02-12,1200500,202106,52350,52327,23
2021-02-12,1200435,202106,52350,52350,0
2021-02-12,1200427,202106,52362,52350,12
2021-02-12,1200401,202106,52537,52362,175
2021-02-12,1200252,202106,52538,52537,1
2021-02-12,1200393,202106,52538,52538,0
2021-02-12,1200385,202106,52537,52538,-1
2021-02-12,1200336,202106,52539,52537,2
2021-02-12,1200351,202106,52550,52539,11
2021-02-12,1200344,202106,52550,52550,0
2021-02-12,1200328,202106,52559,52550,9
2021-02-12,1200807,202106,52562,52559,3
2021-02-12,1200609,202106,52563,52562,1
2021-02-13,1200013,202106,52568,52563,5
2021-02-13,1200054,202106,52577,52568,9
2021-02-13,1200104,202106,52592,52577,15
2021-02-13,1200435,202106,52592,52592,0
2021-02-13,1200427,202106,52608,52592,16
2021-02-13,1200138,202106,52613,52608,5
2021-02-13,1200500,202106,52661,52613,48
2021-02-13,1200450,202106,52672,52661,11
2021-02-13,1200609,202106,52672,52672,0
2021-02-13,1200708,202106,52667,52672,-5
2021-02-13,1200807,202106,52669,52667,2
2021-02-13,1200385,202106,52677,52669,8
2021-02-13,1200336,202106,52677,52677,0
2021-02-13,1200351,202106,52689,52677,12
2021-02-13,1200344,202106,52690,52689,1
2021-02-13,1200328,202106,52695,52690,5
2021-02-13,1200302,202106,52697,52695,2
2021-02-13,1200252,202106,52724,52697,27
2021-02-13,1200203,202106,52792,52724,68
2021-02-13,1200179,202106,52794,52792,2
2021-02-13,1200401,202106,52935,52794,141
2021-02-13,1200393,202106,52935,52935,0
2021-02-14,1200385,202107,52935,52935,0
2021-02-14,1200393,202107,52935,52935,0
2021-02-14,1200054,202107,52935,52935,0
2021-02-14,1200104,202107,52936,52935,1
2021-02-14,1200807,202107,52938,52936,2
2021-02-14,1200138,202107,52944,52938,6
2021-02-14,1200179,202107,52944,52944,0
2021-02-14,1200203,202107,52946,52944,2
2021-02-14,1200252,202107,52946,52946,0
2021-02-14,1200302,202107,52963,52946,17
2021-02-14,1200328,202107,52963,52963,0
2021-02-14,1200344,202107,52963,52963,0
2021-02-14,1200013,202107,52964,52963,1
2021-02-14,1200351,202107,52964,52964,0
2021-02-14,1200336,202107,52964,52964,0
2021-02-14,1200427,202107,52964,52964,0
2021-02-14,1200500,202107,52964,52964,0
2021-02-14,1200450,202107,52965,52964,1
2021-02-14,1200609,202107,52965,52965,0
2021-02-14,1200708,202107,52965,52965,0
2021-02-14,1200401,202107,53042,52965,77
2021-02-14,1200435,202107,53042,53042,0
2021-02-15,1200013,202107,53052,53042,10
2021-02-15,1200054,202107,53070,53052,18
2021-02-15,1200104,202107,53061,53070,-9
2021-02-15,1200138,202107,53061,53061,0
2021-02-15,1200179,202107,53061,53061,0
2021-02-15,1200203,202107,53233,53061,172
2021-02-15,1200252,202107,53238,53233,5
2021-02-15,1200328,202107,53253,53238,15
2021-02-15,1200302,202107,53253,53253,0
2021-02-15,1200351,202107,53252,53253,-1
2021-02-15,1200336,202107,53250,53252,-2
2021-02-15,1200385,202107,53252,53250,2
2021-02-15,1200807,202107,53255,53252,3
2021-02-15,1200393,202107,53255,53255,0
2021-02-15,1200401,202107,53423,53255,168
2021-02-15,1200427,202107,53448,53423,25
2021-02-15,1200435,202107,53448,53448,0
2021-02-15,1200500,202107,53463,53448,15
2021-02-15,1200450,202107,53464,53463,1
2021-02-15,1200609,202107,53460,53464,-4
2021-02-15,1200708,202107,53465,53460,5
2021-02-15,1200344,202107,53470,53465,5
2021-02-16,1200104,202107,53477,53470,7
2021-02-16,1200179,202107,53480,53477,3
2021-02-16,1200138,202107,53481,53480,1
2021-02-16,1200013,202107,53485,53481,4
2021-02-16,1200054,202107,53484,53485,-1
2021-02-16,1200609,202107,53485,53484,1
2021-02-16,1200450,202107,53482,53485,-3
2021-02-16,1200500,202107,53484,53482,2
2021-02-16,1200435,202107,53484,53484,0
2021-02-16,1200427,202107,53484,53484,0
2021-02-16,1200401,202107,53575,53484,91
2021-02-16,1200393,202107,53575,53575,0
2021-02-16,1200708,202107,53584,53575,9
2021-02-16,1200807,202107,53583,53584,-1
2021-02-16,1200336,202107,53584,53583,1
2021-02-16,1200351,202107,53584,53584,0
2021-02-16,1200344,202107,53584,53584,0
2021-02-16,1200328,202107,53584,53584,0
2021-02-16,1200302,202107,53583,53584,-1
2021-02-16,1200252,202107,53588,53583,5
2021-02-16,1200385,202107,53592,53588,4
2021-02-16,1200203,202107,53605,53592,13
2021-02-17,1200427,202107,53617,53605,12
2021-02-17,1200393,202107,53618,53617,1
2021-02-17,1200054,202107,53619,53618,1
2021-02-17,1200104,202107,53625,53619,6
2021-02-17,1200138,202107,53628,53625,3
2021-02-17,1200179,202107,53629,53628,1
2021-02-17,1200203,202107,53689,53629,60
2021-02-17,1200252,202107,53693,53689,4
2021-02-17,1200302,202107,53726,53693,33
2021-02-17,1200328,202107,53726,53726,0
2021-02-17,1200344,202107,53726,53726,0
2021-02-17,1200351,202107,53727,53726,1
2021-02-17,1200336,202107,53727,53727,0
2021-02-17,1200385,202107,53728,53727,1
2021-02-17,1200013,202107,53741,53728,13
2021-02-17,1200807,202107,53743,53741,2
2021-02-17,1200401,202107,53886,53743,143
2021-02-17,1200609,202107,53887,53886,1
2021-02-17,1200500,202107,53896,53887,9
2021-02-17,1200435,202107,53896,53896,0
2021-02-17,1200450,202107,53900,53896,4
2021-02-17,1200708,202107,53907,53900,7
2021-02-18,1200013,202107,53909,53907,2
2021-02-18,1200054,202107,53909,53909,0
2021-02-18,1200104,202107,53909,53909,0
2021-02-18,1200138,202107,53909,53909,0
2021-02-18,1200179,202107,53908,53909,-1
2021-02-18,1200203,202107,53922,53908,14
2021-02-18,1200252,202107,53922,53922,0
2021-02-18,1200302,202107,53927,53922,5
2021-02-18,1200328,202107,53927,53927,0
2021-02-18,1200351,202107,53943,53927,16
2021-02-18,1200344,202107,53943,53943,0
2021-02-18,1200807,202107,53942,53943,-1
2021-02-18,1200393,202107,53942,53942,0
2021-02-18,1200401,202107,54126,53942,184
2021-02-18,1200427,202107,54129,54126,3
2021-02-18,1200435,202107,54129,54129,0
2021-02-18,1200500,202107,54134,54129,5
2021-02-18,1200450,202107,54135,54134,1
2021-02-18,1200609,202107,54136,54135,1
2021-02-18,1200708,202107,54142,54136,6
2021-02-18,1200336,202107,54144,54142,2
2021-02-18,1200385,202107,54145,54144,1
2021-02-19,1200179,202107,54147,54145,2
2021-02-19,1200252,202107,54148,54147,1
2021-02-19,1200013,202107,54151,54148,3
2021-02-19,1200054,202107,54152,54151,1
2021-02-19,1200203,202107,54167,54152,15
2021-02-19,1200104,202107,54170,54167,3
2021-02-19,1200138,202107,54178,54170,8
2021-02-19,1200708,202107,54179,54178,1
2021-02-19,1200328,202107,54179,54179,0
2021-02-19,1200344,202107,54180,54179,1
2021-02-19,1200351,202107,54180,54180,0
2021-02-19,1200336,202107,54180,54180,0
2021-02-19,1200385,202107,54190,54180,10
2021-02-19,1200807,202107,54193,54190,3
2021-02-19,1200393,202107,54193,54193,0
2021-02-19,1200401,202107,54551,54193,358
2021-02-19,1200427,202107,54551,54551,0
2021-02-19,1200435,202107,54551,54551,0
2021-02-19,1200500,202107,54555,54551,4
2021-02-19,1200450,202107,54566,54555,11
2021-02-19,1200609,202107,54566,54566,0
2021-02-19,1200302,202107,54577,54566,11
2021-02-20,1200427,202107,54580,54577,3
2021-02-20,1200500,202107,54617,54580,37
2021-02-20,1200054,202107,54623,54617,6
2021-02-20,1200104,202107,54635,54623,12
2021-02-20,1200138,202107,54639,54635,4
2021-02-20,1200179,202107,54642,54639,3
2021-02-20,1200203,202107,54650,54642,8
2021-02-20,1200252,202107,54652,54650,2
2021-02-20,1200302,202107,54653,54652,1
2021-02-20,1200328,202107,54659,54653,6
2021-02-20,1200435,202107,54659,54659,0
2021-02-20,1200344,202107,54665,54659,6
2021-02-20,1200351,202107,54666,54665,1
2021-02-20,1200336,202107,54666,54666,0
2021-02-20,1200385,202107,54672,54666,6
2021-02-20,1200807,202107,54676,54672,4
2021-02-20,1200013,202107,54687,54676,11
2021-02-20,1200393,202107,54687,54687,0
2021-02-20,1200401,202107,54735,54687,48
2021-02-20,1200450,202107,54751,54735,16
2021-02-20,1200609,202107,54751,54751,0
2021-02-20,1200708,202107,54758,54751,7
2021-02-21,1200500,202108,54758,54758,0
2021-02-21,1200450,202108,54758,54758,0
2021-02-21,1200609,202108,54758,54758,0
2021-02-21,1200708,202108,54761,54758,3
2021-02-21,1200401,202108,54780,54761,19
2021-02-21,1200393,202108,54780,54780,0
2021-02-21,1200807,202108,54786,54780,6
2021-02-21,1200385,202108,54787,54786,1
2021-02-21,1200336,202108,54787,54787,0
2021-02-21,1200351,202108,54787,54787,0
2021-02-21,1200328,202108,54787,54787,0
2021-02-21,1200427,202108,54787,54787,0
2021-02-21,1200302,202108,54788,54787,1
2021-02-21,1200252,202108,54788,54788,0
2021-02-21,1200203,202108,54790,54788,2
2021-02-21,1200179,202108,54790,54790,0
2021-02-21,1200138,202108,54794,54790,4
2021-02-21,1200104,202108,54794,54794,0
2021-02-21,1200054,202108,54794,54794,0
2021-02-21,1200013,202108,54801,54794,7
2021-02-21,1200344,202108,54801,54801,0
2021-02-21,1200435,202108,54801,54801,0
2021-02-22,1200328,202108,54801,54801,0
2021-02-22,1200013,202108,54815,54801,14
2021-02-22,1200344,202108,54815,54815,0
2021-02-22,1200351,202108,54815,54815,0
2021-02-22,1200336,202108,54815,54815,0
2021-02-22,1200385,202108,54817,54815,2
2021-02-22,1200807,202108,54819,54817,2
2021-02-22,1200252,202108,54820,54819,1
2021-02-22,1200401,202108,54931,54820,111
2021-02-22,1200427,202108,54931,54931,0
2021-02-22,1200302,202108,54946,54931,15
2021-02-22,1200435,202108,54946,54946,0
2021-02-22,1200450,202108,54946,54946,0
2021-02-22,1200609,202108,54946,54946,0
2021-02-22,1200708,202108,54955,54946,9
2021-02-22,1200203,202108,54960,54955,5
2021-02-22,1200179,202108,54960,54960,0
2021-02-22,1200138,202108,54960,54960,0
2021-02-22,1200104,202108,54973,54960,13
2021-02-22,1200054,202108,54973,54973,0
2021-02-22,1200500,202108,54984,54973,11
2021-02-22,1200393,202108,54984,54984,0
2021-02-23,1200328,202108,54985,54984,1
2021-02-23,1200401,202108,55362,54985,377
2021-02-23,1200708,202108,55367,55362,5
2021-02-23,1200609,202108,55371,55367,4
2021-02-23,1200450,202108,55385,55371,14
2021-02-23,1200500,202108,55429,55385,44
2021-02-23,1200435,202108,55430,55429,1
2021-02-23,1200427,202108,55453,55430,23
2021-02-23,1200393,202108,55453,55453,0
2021-02-23,1200807,202108,55456,55453,3
2021-02-23,1200336,202108,55457,55456,1
2021-02-23,1200385,202108,55465,55457,8
2021-02-23,1200344,202108,55477,55465,12
2021-02-23,1200302,202108,55479,55477,2
2021-02-23,1200252,202108,55480,55479,1
2021-02-23,1200203,202108,55590,55480,110
2021-02-23,1200179,202108,55590,55590,0
2021-02-23,1200138,202108,55590,55590,0
2021-02-23,1200104,202108,55592,55590,2
2021-02-23,1200054,202108,55594,55592,2
2021-02-23,1200013,202108,55596,55594,2
2021-02-23,1200351,202108,55605,55596,9
2021-02-24,1200252,202108,55606,55605,1
2021-02-24,1200328,202108,55609,55606,3
2021-02-24,1200302,202108,55619,55609,10
2021-02-24,1200203,202108,55661,55619,42
2021-02-24,1200385,202108,55675,55661,14
2021-02-24,1200104,202108,55679,55675,4
2021-02-24,1200054,202108,55697,55679,18
2021-02-24,1200013,202108,55699,55697,2
2021-02-24,1200344,202108,55708,55699,9
2021-02-24,1200179,202108,55709,55708,1
2021-02-24,1200336,202108,55709,55709,0
2021-02-24,1200351,202108,55711,55709,2
2021-02-24,1200138,202108,55717,55711,6
2021-02-24,1200807,202108,55721,55717,4
2021-02-24,1200393,202108,55721,55721,0
2021-02-24,1200401,202108,55844,55721,123
2021-02-24,1200427,202108,55850,55844,6
2021-02-24,1200435,202108,55850,55850,0
2021-02-24,1200500,202108,55884,55850,34
2021-02-24,1200450,202108,55890,55884,6
2021-02-24,1200609,202108,55891,55890,1
2021-02-24,1200708,202108,55896,55891,5
2021-02-25,1200013,202108,55911,55896,15
2021-02-25,1200054,202108,55966,55911,55
2021-02-25,1200104,202108,55974,55966,8
2021-02-25,1200138,202108,55974,55974,0
2021-02-25,1200179,202108,55975,55974,1
2021-02-25,1200609,202108,55977,55975,2
2021-02-25,1200252,202108,55977,55977,0
2021-02-25,1200302,202108,55980,55977,3
2021-02-25,1200328,202108,55982,55980,2
2021-02-25,1200344,202108,55988,55982,6
2021-02-25,1200351,202108,55996,55988,8
2021-02-25,1200336,202108,55996,55996,0
2021-02-25,1200385,202108,55997,55996,1
2021-02-25,1200807,202108,55997,55997,0
2021-02-25,1200393,202108,55997,55997,0
2021-02-25,1200401,202108,56170,55997,173
2021-02-25,1200427,202108,56183,56170,13
2021-02-25,1200435,202108,56183,56183,0
2021-02-25,1200500,202108,56206,56183,23
2021-02-25,1200450,202108,56224,56206,18
2021-02-25,1200708,202108,56226,56224,2
2021-02-25,1200203,202108,56272,56226,46
2021-02-26,1200450,202108,56281,56272,9
2021-02-26,1200104,202108,56286,56281,5
2021-02-26,1200708,202108,56306,56286,20
2021-02-26,1200609,202108,56307,56306,1
2021-02-26,1200500,202108,56323,56307,16
2021-02-26,1200435,202108,56323,56323,0
2021-02-26,1200401,202108,56553,56323,230
2021-02-26,1200393,202108,56553,56553,0
2021-02-26,1200807,202108,56556,56553,3
2021-02-26,1200385,202108,56577,56556,21
2021-02-26,1200336,202108,56577,56577,0
2021-02-26,1200427,202108,56582,56577,5
2021-02-26,1200344,202108,56584,56582,2
2021-02-26,1200328,202108,56584,56584,0
2021-02-26,1200302,202108,56585,56584,1
2021-02-26,1200252,202108,56596,56585,11
2021-02-26,1200203,202108,56711,56596,115
2021-02-26,1200179,202108,56715,56711,4
2021-02-26,1200138,202108,56733,56715,18
2021-02-26,1200054,202108,56736,56733,3
2021-02-26,1200013,202108,56742,56736,6
2021-02-26,1200351,202108,56746,56742,4
2021-02-27,1200344,202108,56746,56746,0
2021-02-27,1200328,202108,56747,56746,1
2021-02-27,1200302,202108,56773,56747,26
2021-02-27,1200252,202108,56773,56773,0
2021-02-27,1200203,202108,56875,56773,102
2021-02-27,1200013,202108,56886,56875,11
2021-02-27,1200138,202108,56888,56886,2
2021-02-27,1200104,202108,56896,56888,8
2021-02-27,1200054,202108,56920,56896,24
2021-02-27,1200351,202108,56927,56920,7
2021-02-27,1200179,202108,56927,56927,0
2021-02-27,1200336,202108,56944,56927,17
2021-02-27,1200385,202108,56965,56944,21
2021-02-27,1200807,202108,56967,56965,2
2021-02-27,1200393,202108,56969,56967,2
2021-02-27,1200401,202108,57243,56969,274
2021-02-27,1200427,202108,57255,57243,12
2021-02-27,1200435,202108,57274,57255,19
2021-02-27,1200500,202108,57322,57274,48
2021-02-27,1200450,202108,57338,57322,16
2021-02-27,1200609,202108,57341,57338,3
2021-02-27,1200708,202108,57352,57341,11
2021-02-28,1200708,202109,57354,57352,2
2021-02-28,1200013,202109,57356,57354,2
2021-02-28,1200054,202109,57364,57356,8
2021-02-28,1200104,202109,57365,57364,1
2021-02-28,1200138,202109,57371,57365,6
2021-02-28,1200179,202109,57371,57371,0
2021-02-28,1200203,202109,57375,57371,4
2021-02-28,1200807,202109,57378,57375,3
2021-02-28,1200450,202109,57380,57378,2
2021-02-28,1200500,202109,57381,57380,1
2021-02-28,1200435,202109,57381,57381,0
2021-02-28,1200427,202109,57381,57381,0
2021-02-28,1200401,202109,57528,57381,147
2021-02-28,1200393,202109,57528,57528,0
2021-02-28,1200252,202109,57533,57528,5
2021-02-28,1200609,202109,57533,57533,0
2021-02-28,1200336,202109,57533,57533,0
2021-02-28,1200351,202109,57533,57533,0
2021-02-28,1200344,202109,57537,57533,4
2021-02-28,1200328,202109,57537,57537,0
2021-02-28,1200302,202109,57537,57537,0
2021-02-28,1200385,202109,57549,57537,12
2021-03-01,1200054,202109,57549,57549,0
2021-03-01,1200013,202109,57568,57549,19
2021-03-01,1200104,202109,57573,57568,5
2021-03-01,1200708,202109,57583,57573,10
2021-03-01,1200450,202109,57586,57583,3
2021-03-01,1200500,202109,57598,57586,12
2021-03-01,1200435,202109,57605,57598,7
2021-03-01,1200427,202109,57608,57605,3
2021-03-01,1200401,202109,57876,57608,268
2021-03-01,1200393,202109,57876,57876,0
2021-03-01,1200807,202109,57882,57876,6
2021-03-01,1200385,202109,57883,57882,1
2021-03-01,1200336,202109,57883,57883,0
2021-03-01,1200351,202109,57883,57883,0
2021-03-01,1200344,202109,57887,57883,4
2021-03-01,1200328,202109,57887,57887,0
2021-03-01,1200302,202109,57888,57887,1
2021-03-01,1200252,202109,57891,57888,3
2021-03-01,1200203,202109,57894,57891,3
2021-03-01,1200179,202109,57895,57894,1
2021-03-01,1200138,202109,57906,57895,11
2021-03-01,1200609,202109,57909,57906,3
2021-03-02,1200807,202109,57907,57909,-2
2021-03-02,1200393,202109,57905,57907,-2
2021-03-02,1200054,202109,57905,57905,0
2021-03-02,1200401,202109,58077,57905,172
2021-03-02,1200427,202109,58079,58077,2
2021-03-02,1200385,202109,58077,58079,-2
2021-03-02,1200500,202109,58079,58077,2
2021-03-02,1200450,202109,58076,58079,-3
2021-03-02,1200609,202109,58070,58076,-6
2021-03-02,1200708,202109,58070,58070,0
2021-03-02,1200336,202109,58070,58070,0
2021-03-02,1200351,202109,58069,58070,-1
2021-03-02,1200344,202109,58068,58069,-1
2021-03-02,1200328,202109,58067,58068,-1
2021-03-02,1200302,202109,58097,58067,30
2021-03-02,1200252,202109,58096,58097,-1
2021-03-02,1200203,202109,58095,58096,-1
2021-03-02,1200179,202109,58095,58095,0
2021-03-02,1200138,202109,58097,58095,2
2021-03-02,1200104,202109,58097,58097,0
2021-03-02,1200013,202109,58096,58097,-1
2021-03-02,1200435,202109,58096,58096,0
2021-03-03,1200435,202109,58104,58096,8
2021-03-03,1200708,202109,58117,58104,13
2021-03-03,1200500,202109,58154,58117,37
2021-03-03,1200427,202109,58157,58154,3
2021-03-03,1200401,202109,58369,58157,212
2021-03-03,1200393,202109,58387,58369,18
2021-03-03,1200807,202109,58402,58387,15
2021-03-03,1200385,202109,58417,58402,15
2021-03-03,1200336,202109,58420,58417,3
2021-03-03,1200351,202109,58450,58420,30
2021-03-03,1200344,202109,58459,58450,9
2021-03-03,1200328,202109,58461,58459,2
2021-03-03,1200302,202109,58462,58461,1
2021-03-03,1200252,202109,58463,58462,1
2021-03-03,1200203,202109,58473,58463,10
2021-03-03,1200179,202109,58474,58473,1
2021-03-03,1200138,202109,58475,58474,1
2021-03-03,1200104,202109,58485,58475,10
2021-03-03,1200054,202109,58503,58485,18
2021-03-03,1200450,202109,58508,58503,5
2021-03-03,1200609,202109,58509,58508,1
2021-03-03,1200013,202109,58521,58509,12
2021-03-04,1200336,202109,58514,58521,-7
2021-03-04,1200807,202109,58527,58514,13
2021-03-04,1200393,202109,58528,58527,1
2021-03-04,1200401,202109,58743,58528,215
2021-03-04,1200427,202109,58752,58743,9
2021-03-04,1200435,202109,58754,58752,2
2021-03-04,1200500,202109,58772,58754,18
2021-03-04,1200450,202109,58782,58772,10
2021-03-04,1200609,202109,58811,58782,29
2021-03-04,1200708,202109,58825,58811,14
2021-03-04,1200351,202109,58826,58825,1
2021-03-04,1200344,202109,58829,58826,3
2021-03-04,1200328,202109,58828,58829,-1
2021-03-04,1200302,202109,58826,58828,-2
2021-03-04,1200252,202109,58827,58826,1
2021-03-04,1200203,202109,58864,58827,37
2021-03-04,1200179,202109,58863,58864,-1
2021-03-04,1200138,202109,58892,58863,29
2021-03-04,1200104,202109,58893,58892,1
2021-03-04,1200054,202109,58895,58893,2
2021-03-04,1200013,202109,58902,58895,7
2021-03-04,1200385,202109,58899,58902,-3
2021-03-05,1200500,202109,58949,58899,50
2021-03-05,1200401,202109,59260,58949,311
2021-03-05,1200708,202109,59282,59260,22
2021-03-05,1200609,202109,59301,59282,19
2021-03-05,1200450,202109,59304,59301,3
2021-03-05,1200435,202109,59306,59304,2
2021-03-05,1200427,202109,59306,59306,0
2021-03-05,1200393,202109,59306,59306,0
2021-03-05,1200807,202109,59314,59306,8
2021-03-05,1200385,202109,59333,59314,19
2021-03-05,1200351,202109,59333,59333,0
2021-03-05,1200336,202109,59334,59333,1
2021-03-05,1200328,202109,59334,59334,0
2021-03-05,1200302,202109,59357,59334,23
2021-03-05,1200252,202109,59359,59357,2
2021-03-05,1200203,202109,59471,59359,112
2021-03-05,1200179,202109,59473,59471,2
2021-03-05,1200138,202109,59489,59473,16
2021-03-05,1200104,202109,59497,59489,8
2021-03-05,1200054,202109,59504,59497,7
2021-03-05,1200013,202109,59513,59504,9
2021-03-05,1200344,202109,59515,59513,2
2021-03-06,1200203,202109,59551,59515,36
2021-03-06,1200328,202109,59552,59551,1
2021-03-06,1200302,202109,59556,59552,4
2021-03-06,1200252,202109,59563,59556,7
2021-03-06,1200179,202109,59565,59563,2
2021-03-06,1200385,202109,59574,59565,9
2021-03-06,1200104,202109,59607,59574,33
2021-03-06,1200054,202109,59610,59607,3
2021-03-06,1200013,202109,59644,59610,34
2021-03-06,1200344,202109,59647,59644,3
2021-03-06,1200138,202109,59664,59647,17
2021-03-06,1200336,202109,59662,59664,-2
2021-03-06,1200807,202109,59672,59662,10
2021-03-06,1200351,202109,59684,59672,12
2021-03-06,1200393,202109,59684,59684,0
2021-03-06,1200401,202109,59982,59684,298
2021-03-06,1200427,202109,59985,59982,3
2021-03-06,1200435,202109,59992,59985,7
2021-03-06,1200500,202109,60044,59992,52
2021-03-06,1200450,202109,60060,60044,16
2021-03-06,1200609,202109,60082,60060,22
2021-03-06,1200708,202109,60085,60082,3
2021-03-07,1200708,202110,60085,60085,0
2021-03-07,1200013,202110,60089,60085,4
2021-03-07,1200054,202110,60088,60089,-1
2021-03-07,1200104,202110,60089,60088,1
2021-03-07,1200138,202110,60116,60089,27
2021-03-07,1200179,202110,60125,60116,9
2021-03-07,1200203,202110,60127,60125,2
2021-03-07,1200807,202110,60142,60127,15
2021-03-07,1200450,202110,60143,60142,1
2021-03-07,1200500,202110,60163,60143,20
2021-03-07,1200435,202110,60163,60163,0
2021-03-07,1200427,202110,60162,60163,-1
2021-03-07,1200401,202110,60296,60162,134
2021-03-07,1200393,202110,60296,60296,0
2021-03-07,1200252,202110,60296,60296,0
2021-03-07,1200609,202110,60295,60296,-1
2021-03-07,1200336,202110,60295,60295,0
2021-03-07,1200351,202110,60295,60295,0
2021-03-07,1200344,202110,60294,60295,-1
2021-03-07,1200328,202110,60293,60294,-1
2021-03-07,1200302,202110,60292,60293,-1
2021-03-07,1200385,202110,60303,60292,11
2021-03-08,1200054,202110,60307,60303,4
2021-03-08,1200013,202110,60324,60307,17
2021-03-08,1200104,202110,60331,60324,7
2021-03-08,1200435,202110,60331,60331,0
2021-03-08,1200427,202110,60347,60331,16
2021-03-08,1200138,202110,60353,60347,6
2021-03-08,1200500,202110,60374,60353,21
2021-03-08,1200450,202110,60378,60374,4
2021-03-08,1200609,202110,60381,60378,3
2021-03-08,1200708,202110,60381,60381,0
2021-03-08,1200807,202110,60385,60381,4
2021-03-08,1200385,202110,60387,60385,2
2021-03-08,1200336,202110,60387,60387,0
2021-03-08,1200351,202110,60408,60387,21
2021-03-08,1200344,202110,60415,60408,7
2021-03-08,1200328,202110,60415,60415,0
2021-03-08,1200302,202110,60448,60415,33
2021-03-08,1200252,202110,60456,60448,8
2021-03-08,1200203,202110,60486,60456,30
2021-03-08,1200179,202110,60486,60486,0
2021-03-08,1200401,202110,60671,60486,185
2021-03-08,1200393,202110,60671,60671,0
2021-03-09,1200385,202110,60671,60671,0
2021-03-09,1200393,202110,60671,60671,0
2021-03-09,1200054,202110,60671,60671,0
2021-03-09,1200104,202110,60672,60671,1
2021-03-09,1200807,202110,60672,60672,0
2021-03-09,1200138,202110,60672,60672,0
2021-03-09,1200179,202110,60673,60672,1
2021-03-09,1200203,202110,60676,60673,3
2021-03-09,1200252,202110,60680,60676,4
2021-03-09,1200302,202110,60680,60680,0
2021-03-09,1200328,202110,60680,60680,0
2021-03-09,1200344,202110,60684,60680,4
2021-03-09,1200013,202110,60696,60684,12
2021-03-09,1200351,202110,60702,60696,6
2021-03-09,1200336,202110,60703,60702,1
2021-03-09,1200401,202110,60730,60703,27
2021-03-09,1200427,202110,60729,60730,-1
2021-03-09,1200435,202110,60729,60729,0
2021-03-09,1200500,202110,60729,60729,0
2021-03-09,1200450,202110,60730,60729,1
2021-03-09,1200609,202110,60736,60730,6
2021-03-09,1200708,202110,60736,60736,0
2021-03-10,1200427,202110,60739,60736,3
2021-03-10,1200708,202110,60739,60739,0
2021-03-10,1200609,202110,60739,60739,0
2021-03-10,1200450,202110,60741,60739,2
2021-03-10,1200401,202110,61061,60741,320
2021-03-10,1200435,202110,61061,61061,0
2021-03-10,1200385,202110,61072,61061,11
2021-03-10,1200336,202110,61073,61072,1
2021-03-10,1200500,202110,61095,61073,22
2021-03-10,1200351,202110,61095,61095,0
2021-03-10,1200252,202110,61095,61095,0
2021-03-10,1200328,202110,61094,61095,-1
2021-03-10,1200302,202110,61098,61094,4
2021-03-10,1200393,202110,61098,61098,0
2021-03-10,1200203,202110,61118,61098,20
2021-03-10,1200179,202110,61118,61118,0
2021-03-10,1200138,202110,61122,61118,4
2021-03-10,1200104,202110,61122,61122,0
2021-03-10,1200054,202110,61130,61122,8
2021-03-10,1200013,202110,61129,61130,-1
2021-03-10,1200344,202110,61133,61129,4
2021-03-10,1200807,202110,61136,61133,3
2021-03-11,1200179,202110,61135,61136,-1
2021-03-11,1200013,202110,61144,61135,9
2021-03-11,1200203,202110,61202,61144,58
2021-03-11,1200252,202110,61203,61202,1
2021-03-11,1200302,202110,61204,61203,1
2021-03-11,1200328,202110,61204,61204,0
2021-03-11,1200344,202110,61219,61204,15
2021-03-11,1200351,202110,61225,61219,6
2021-03-11,1200336,202110,61224,61225,-1
2021-03-11,1200104,202110,61229,61224,5
2021-03-11,1200138,202110,61270,61229,41
2021-03-11,1200807,202110,61287,61270,17
2021-03-11,1200401,202110,61357,61287,70
2021-03-11,1200427,202110,61361,61357,4
2021-03-11,1200435,202110,61361,61361,0
2021-03-11,1200500,202110,61382,61361,21
2021-03-11,1200450,202110,61389,61382,7
2021-03-11,1200609,202110,61398,61389,9
2021-03-11,1200708,202110,61404,61398,6
2021-03-11,1200054,202110,61409,61404,5
2021-03-11,1200393,202110,61409,61409,0
2021-03-11,1200385,202110,61409,61409,0
2021-03-12,1200252,202110,61411,61409,2
2021-03-12,1200401,202110,61476,61411,65
2021-03-12,1200708,202110,61483,61476,7
2021-03-12,1200609,202110,61490,61483,7
2021-03-12,1200450,202110,61490,61490,0
2021-03-12,1200500,202110,61548,61490,58
2021-03-12,1200435,202110,61548,61548,0
2021-03-12,1200427,202110,61560,61548,12
2021-03-12,1200393,202110,61560,61560,0
2021-03-12,1200807,202110,61573,61560,13
2021-03-12,1200336,202110,61574,61573,1
2021-03-12,1200385,202110,61588,61574,14
2021-03-12,1200344,202110,61590,61588,2
2021-03-12,1200328,202110,61591,61590,1
2021-03-12,1200302,202110,61592,61591,1
2021-03-12,1200203,202110,61676,61592,84
2021-03-12,1200179,202110,61676,61676,0
2021-03-12,1200138,202110,61694,61676,18
2021-03-12,1200104,202110,61705,61694,11
2021-03-12,1200054,202110,61721,61705,16
2021-03-12,1200013,202110,61721,61721,0
2021-03-12,1200351,202110,61724,61721,3
2021-03-13,1200252,202110,61731,61724,7
2021-03-13,1200328,202110,61731,61731,0
2021-03-13,1200302,202110,61732,61731,1
2021-03-13,1200203,202110,61912,61732,180
2021-03-13,1200385,202110,61934,61912,22
2021-03-13,1200138,202110,61936,61934,2
2021-03-13,1200104,202110,61954,61936,18
2021-03-13,1200013,202110,61985,61954,31
2021-03-13,1200344,202110,62010,61985,25
2021-03-13,1200179,202110,62010,62010,0
2021-03-13,1200336,202110,62013,62010,3
2021-03-13,1200351,202110,62037,62013,24
2021-03-13,1200054,202110,62051,62037,14
2021-03-13,1200807,202110,62057,62051,6
2021-03-13,1200393,202110,62057,62057,0
2021-03-13,1200401,202110,62257,62057,200
2021-03-13,1200427,202110,62263,62257,6
2021-03-13,1200435,202110,62264,62263,1
2021-03-13,1200500,202110,62313,62264,49
2021-03-13,1200450,202110,62323,62313,10
2021-03-13,1200609,202110,62334,62323,11
2021-03-13,1200708,202110,62347,62334,13
2021-03-14,1200013,202111,62346,62347,-1
2021-03-14,1200054,202111,62347,62346,1
2021-03-14,1200104,202111,62348,62347,1
2021-03-14,1200138,202111,62357,62348,9
2021-03-14,1200179,202111,62360,62357,3
2021-03-14,1200609,202111,62370,62360,10
2021-03-14,1200252,202111,62373,62370,3
2021-03-14,1200302,202111,62397,62373,24
2021-03-14,1200328,202111,62397,62397,0
2021-03-14,1200344,202111,62397,62397,0
2021-03-14,1200351,202111,62398,62397,1
2021-03-14,1200336,202111,62398,62398,0
2021-03-14,1200385,202111,62413,62398,15
2021-03-14,1200807,202111,62428,62413,15
2021-03-14,1200393,202111,62428,62428,0
2021-03-14,1200401,202111,62618,62428,190
2021-03-14,1200427,202111,62618,62618,0
2021-03-14,1200435,202111,62618,62618,0
2021-03-14,1200500,202111,62630,62618,12
2021-03-14,1200450,202111,62630,62630,0
2021-03-14,1200708,202111,62634,62630,4
2021-03-14,1200203,202111,62635,62634,1
2021-03-15,1200435,202111,62635,62635,0
2021-03-15,1200013,202111,62656,62635,21
2021-03-15,1200708,202111,62658,62656,2
2021-03-15,1200609,202111,62659,62658,1
2021-03-15,1200450,202111,62662,62659,3
2021-03-15,1200500,202111,62663,62662,1
2021-03-15,1200401,202111,62902,62663,239
2021-03-15,1200393,202111,62902,62902,0
2021-03-15,1200807,202111,62902,62902,0
2021-03-15,1200385,202111,62907,62902,5
2021-03-15,1200336,202111,62907,62907,0
2021-03-15,1200427,202111,62907,62907,0
2021-03-15,1200344,202111,62909,62907,2
2021-03-15,1200328,202111,62909,62909,0
2021-03-15,1200302,202111,62912,62909,3
2021-03-15,1200252,202111,62915,62912,3
2021-03-15,1200203,202111,62914,62915,-1
2021-03-15,1200179,202111,62919,62914,5
2021-03-15,1200138,202111,62953,62919,34
2021-03-15,1200104,202111,62956,62953,3
2021-03-15,1200054,202111,62956,62956,0
2021-03-15,1200351,202111,62955,62956,-1
2021-03-16,1200344,202111,62963,62955,8
2021-03-16,1200328,202111,62963,62963,0
2021-03-16,1200302,202111,63009,62963,46
2021-03-16,1200252,202111,63009,63009,0
2021-03-16,1200203,202111,63076,63009,67
2021-03-16,1200013,202111,63103,63076,27
2021-03-16,1200138,202111,63102,63103,-1
2021-03-16,1200104,202111,63103,63102,1
2021-03-16,1200054,202111,63109,63103,6
2021-03-16,1200351,202111,63143,63109,34
2021-03-16,1200179,202111,63145,63143,2
2021-03-16,1200336,202111,63147,63145,2
2021-03-16,1200385,202111,63143,63147,-4
2021-03-16,1200807,202111,63144,63143,1
2021-03-16,1200393,202111,63144,63144,0
2021-03-16,1200401,202111,63267,63144,123
2021-03-16,1200427,202111,63273,63267,6
2021-03-16,1200435,202111,63273,63273,0
2021-03-16,1200500,202111,63378,63273,105
2021-03-16,1200450,202111,63387,63378,9
2021-03-16,1200609,202111,63388,63387,1
2021-03-16,1200708,202111,63393,63388,5
2021-03-17,1200708,202111,63408,63393,15
2021-03-17,1200013,202111,63410,63408,2
2021-03-17,1200054,202111,63410,63410,0
2021-03-17,1200104,202111,63426,63410,16
2021-03-17,1200138,202111,63435,63426,9
2021-03-17,1200179,202111,63435,63435,0
2021-03-17,1200203,202111,63525,63435,90
2021-03-17,1200807,202111,63544,63525,19
2021-03-17,1200450,202111,63545,63544,1
2021-03-17,1200500,202111,63589,63545,44
2021-03-17,1200435,202111,63594,63589,5
2021-03-17,1200427,202111,63609,63594,15
2021-03-17,1200401,202111,63676,63609,67
2021-03-17,1200393,202111,63684,63676,8
2021-03-17,1200252,202111,63685,63684,1
2021-03-17,1200609,202111,63711,63685,26
2021-03-17,1200336,202111,63712,63711,1
2021-03-17,1200351,202111,63718,63712,6
2021-03-17,1200344,202111,63729,63718,11
2021-03-17,1200328,202111,63729,63729,0
2021-03-17,1200302,202111,63730,63729,1
2021-03-17,1200385,202111,63736,63730,6
2021-03-18,1200054,202111,63740,63736,4
2021-03-18,1200013,202111,63781,63740,41
2021-03-18,1200104,202111,63801,63781,20
2021-03-18,1200708,202111,63822,63801,21
2021-03-18,1200450,202111,63828,63822,6
2021-03-18,1200500,202111,63855,63828,27
2021-03-18,1200435,202111,63856,63855,1
2021-03-18,1200427,202111,63858,63856,2
2021-03-18,1200401,202111,64090,63858,232
2021-03-18,1200393,202111,64092,64090,2
2021-03-18,1200807,202111,64103,64092,11
2021-03-18,1200385,202111,64104,64103,1
2021-03-18,1200336,202111,64105,64104,1
2021-03-18,1200351,202111,64121,64105,16
2021-03-18,1200344,202111,64142,64121,21
2021-03-18,1200328,202111,64142,64142,0
2021-03-18,1200302,202111,64147,64142,5
2021-03-18,1200252,202111,64153,64147,6
2021-03-18,1200203,202111,64207,64153,54
2021-03-18,1200179,202111,64207,64207,0
2021-03-18,1200138,202111,64222,64207,15
2021-03-18,1200609,202111,64249,64222,27
2021-03-19,1200807,202111,64261,64249,12
2021-03-19,1200393,202111,64261,64261,0
2021-03-19,1200054,202111,64289,64261,28
2021-03-19,1200401,202111,64675,64289,386
2021-03-19,1200427,202111,64676,64675,1
2021-03-19,1200385,202111,64699,64676,23
2021-03-19,1200500,202111,64751,64699,52
2021-03-19,1200450,202111,64759,64751,8
2021-03-19,1200609,202111,64787,64759,28
2021-03-19,1200708,202111,64786,64787,-1
2021-03-19,1200336,202111,64786,64786,0
2021-03-19,1200351,202111,64792,64786,6
2021-03-19,1200344,202111,64818,64792,26
2021-03-19,1200328,202111,64818,64818,0
2021-03-19,1200302,202111,64825,64818,7
2021-03-19,1200252,202111,64828,64825,3
2021-03-19,1200203,202111,64853,64828,25
2021-03-19,1200179,202111,64855,64853,2
2021-03-19,1200138,202111,64871,64855,16
2021-03-19,1200104,202111,64879,64871,8
2021-03-19,1200013,202111,64892,64879,13
2021-03-19,1200435,202111,64893,64892,1
2021-03-20,1200435,202111,64892,64893,-1
2021-03-20,1200708,202111,64902,64892,10
2021-03-20,1200500,202111,64961,64902,59
2021-03-20,1200427,202111,64963,64961,2
2021-03-20,1200401,202111,65111,64963,148
2021-03-20,1200393,202111,65115,65111,4
2021-03-20,1200807,202111,65127,65115,12
2021-03-20,1200385,202111,65127,65127,0
2021-03-20,1200336,202111,65127,65127,0
2021-03-20,1200351,202111,65134,65127,7
2021-03-20,1200344,202111,65149,65134,15
2021-03-20,1200328,202111,65155,65149,6
2021-03-20,1200302,202111,65171,65155,16
2021-03-20,1200252,202111,65177,65171,6
2021-03-20,1200203,202111,65185,65177,8
2021-03-20,1200179,202111,65184,65185,-1
2021-03-20,1200138,202111,65199,65184,15
2021-03-20,1200104,202111,65213,65199,14
2021-03-20,1200054,202111,65236,65213,23
2021-03-20,1200450,202111,65252,65236,16
2021-03-20,1200609,202111,65265,65252,13
2021-03-20,1200013,202111,65290,65265,25
2021-03-21,1200336,202112,65290,65290,0
2021-03-21,1200807,202112,65294,65290,4
2021-03-21,1200393,202112,65293,65294,-1
2021-03-21,1200401,202112,65399,65293,106
2021-03-21,1200427,202112,65399,65399,0
2021-03-21,1200435,202112,65399,65399,0
2021-03-21,1200500,202112,65429,65399,30
2021-03-21,1200450,202112,65425,65429,-4
2021-03-21,1200609,202112,65429,65425,4
2021-03-21,1200708,202112,65425,65429,-4
2021-03-21,1200351,202112,65425,65425,0
2021-03-21,1200344,202112,65425,65425,0
2021-03-21,1200328,202112,65425,65425,0
2021-03-21,1200302,202112,65445,65425,20
2021-03-21,1200252,202112,65445,65445,0
2021-03-21,1200203,202112,65445,65445,0
2021-03-21,1200179,202112,65443,65445,-2
2021-03-21,1200138,202112,65449,65443,6
2021-03-21,1200104,202112,65446,65449,-3
2021-03-21,1200054,202112,65445,65446,-1
2021-03-21,1200013,202112,65446,65445,1
2021-03-21,1200385,202112,65461,65446,15
2021-03-22,1200500,202112,65498,65461,37
2021-03-22,1200054,202112,65517,65498,19
2021-03-22,1200708,202112,65519,65517,2
2021-03-22,1200609,202112,65529,65519,10
2021-03-22,1200450,202112,65535,65529,6
2021-03-22,1200435,202112,65535,65535,0
2021-03-22,1200401,202112,65782,65535,247
2021-03-22,1200393,202112,65782,65782,0
2021-03-22,1200807,202112,65791,65782,9
2021-03-22,1200385,202112,65794,65791,3
2021-03-22,1200336,202112,65795,65794,1
2021-03-22,1200427,202112,65801,65795,6
2021-03-22,1200344,202112,65804,65801,3
2021-03-22,1200328,202112,65808,65804,4
2021-03-22,1200302,202112,65811,65808,3
2021-03-22,1200252,202112,65821,65811,10
2021-03-22,1200203,202112,65907,65821,86
2021-03-22,1200179,202112,65931,65907,24
2021-03-22,1200138,202112,65935,65931,4
2021-03-22,1200104,202112,65944,65935,9
2021-03-22,1200013,202112,65960,65944,16
2021-03-22,1200351,202112,65974,65960,14
2021-03-23,1200344,202112,65975,65974,1
2021-03-23,1200328,202112,65975,65975,0
2021-03-23,1200302,202112,66019,65975,44
2021-03-23,1200252,202112,66019,66019,0
2021-03-23,1200203,202112,66018,66019,-1
2021-03-23,1200013,202112,66018,66018,0
2021-03-23,1200138,202112,66019,66018,1
2021-03-23,1200104,202112,66019,66019,0
2021-03-23,1200054,202112,66019,66019,0
2021-03-23,1200351,202112,66019,66019,0
2021-03-23,1200179,202112,66023,66019,4
2021-03-23,1200336,202112,66023,66023,0
2021-03-23,1200385,202112,66024,66023,1
2021-03-23,1200393,202112,66024,66024,0
2021-03-23,1200401,202112,66283,66024,259
2021-03-23,1200427,202112,66283,66283,0
2021-03-23,1200435,202112,66285,66283,2
2021-03-23,1200500,202112,66301,66285,16
2021-03-23,1200450,202112,66303,66301,2
2021-03-23,1200609,202112,66303,66303,0
2021-03-23,1200708,202112,66303,66303,0
2021-03-23,1200807,202112,66305,66303,2
2021-03-24,1200708,202112,66305,66305,0
2021-03-24,1200013,202112,66359,66305,54
2021-03-24,1200054,202112,66361,66359,2
2021-03-24,1200104,202112,66382,66361,21
2021-03-24,1200138,202112,66383,66382,1
2021-03-24,1200179,202112,66382,66383,-1
2021-03-24,1200203,202112,66449,66382,67
2021-03-24,1200302,202112,66469,66449,20
2021-03-24,1200450,202112,66469,66469,0
2021-03-24,1200500,202112,66475,66469,6
2021-03-24,1200435,202112,66486,66475,11
2021-03-24,1200427,202112,66490,66486,4
2021-03-24,1200401,202112,66668,66490,178
2021-03-24,1200252,202112,66682,66668,14
2021-03-24,1200393,202112,66687,66682,5
2021-03-24,1200385,202112,66691,66687,4
2021-03-24,1200336,202112,66692,66691,1
2021-03-24,1200351,202112,66699,66692,7
2021-03-24,1200344,202112,66707,66699,8
2021-03-24,1200328,202112,66713,66707,6
2021-03-24,1200807,202112,66740,66713,27
2021-03-24,1200609,202112,66759,66740,19
2021-03-25,1200013,202112,66808,66759,49
2021-03-25,1200054,202112,66808,66808,0
2021-03-25,1200104,202112,66809,66808,1
2021-03-25,1200435,202112,66823,66809,14
2021-03-25,1200427,202112,66824,66823,1
2021-03-25,1200138,202112,66836,66824,12
2021-03-25,1200500,202112,66905,66836,69
2021-03-25,1200450,202112,66910,66905,5
2021-03-25,1200609,202112,66944,66910,34
2021-03-25,1200708,202112,66947,66944,3
2021-03-25,1200807,202112,66955,66947,8
2021-03-25,1200385,202112,66960,66955,5
2021-03-25,1200336,202112,66962,66960,2
2021-03-25,1200351,202112,66971,66962,9
2021-03-25,1200344,202112,67005,66971,34
2021-03-25,1200328,202112,67007,67005,2
2021-03-25,1200302,202112,67057,67007,50
2021-03-25,1200252,202112,67068,67057,11
2021-03-25,1200203,202112,67105,67068,37
2021-03-25,1200179,202112,67106,67105,1
2021-03-25,1200401,202112,67296,67106,190
2021-03-25,1200393,202112,67307,67296,11
2021-03-26,1200385,202112,67318,67307,11
2021-03-26,1200393,202112,67319,67318,1
2021-03-26,1200054,202112,67324,67319,5
2021-03-26,1200104,202112,67348,67324,24
2021-03-26,1200807,202112,67366,67348,18
2021-03-26,1200138,202112,67372,67366,6
2021-03-26,1200179,202112,67385,67372,13
2021-03-26,1200203,202112,67412,67385,27
2021-03-26,1200252,202112,67420,67412,8
2021-03-26,1200302,202112,67423,67420,3
2021-03-26,1200328,202112,67424,67423,1
2021-03-26,1200344,202112,67441,67424,17
2021-03-26,1200013,202112,67450,67441,9
2021-03-26,1200351,202112,67452,67450,2
2021-03-26,1200336,202112,67455,67452,3
2021-03-26,1200500,202112,67506,67455,51
2021-03-26,1200609,202112,67551,67506,45
2021-03-26,1200427,202112,67551,67551,0
2021-03-26,1200708,202112,67557,67551,6
2021-03-26,1200435,202112,67576,67557,19
2021-03-26,1200401,202112,67788,67576,212
2021-03-26,1200450,202112,67792,67788,4
2021-03-27,1200013,202112,67810,67792,18
2021-03-27,1200054,202112,67812,67810,2
2021-03-27,1200104,202112,67823,67812,11
2021-03-27,1200138,202112,67828,67823,5
2021-03-27,1200179,202112,67830,67828,2
2021-03-27,1200203,202112,67882,67830,52
2021-03-27,1200252,202112,67886,67882,4
2021-03-27,1200328,202112,67889,67886,3
2021-03-27,1200302,202112,67900,67889,11
2021-03-27,1200336,202112,67902,67900,2
2021-03-27,1200385,202112,67909,67902,7
2021-03-27,1200807,202112,67918,67909,9
2021-03-27,1200393,202112,67922,67918,4
2021-03-27,1200401,202112,68165,67922,243
2021-03-27,1200427,202112,68177,68165,12
2021-03-27,1200435,202112,68203,68177,26
2021-03-27,1200500,202112,68282,68203,79
2021-03-27,1200450,202112,68292,68282,10
2021-03-27,1200609,202112,68555,68292,263
2021-03-27,1200708,202112,68568,68555,13
2021-03-27,1200351,202112,68569,68568,1
2021-03-27,1200344,202112,68590,68569,21
2021-03-28,1200179,202113,68593,68590,3
2021-03-28,1200138,202113,68607,68593,14
2021-03-28,1200104,202113,68607,68607,0
2021-03-28,1200013,202113,68617,68607,10
2021-03-28,1200054,202113,68617,68617,0
2021-03-28,1200807,202113,68640,68617,23
2021-03-28,1200500,202113,68640,68640,0
2021-03-28,1200435,202113,68640,68640,0
2021-03-28,1200427,202113,68640,68640,0
2021-03-28,1200401,202113,68750,68640,110
2021-03-28,1200393,202113,68750,68750,0
2021-03-28,1200708,202113,68750,68750,0
2021-03-28,1200450,202113,68746,68750,-4
2021-03-28,1200385,202113,68754,68746,8
2021-03-28,1200351,202113,68754,68754,0
2021-03-28,1200344,202113,68752,68754,-2
2021-03-28,1200328,202113,68751,68752,-1
2021-03-28,1200302,202113,68750,68751,-1
2021-03-28,1200252,202113,68750,68750,0
2021-03-28,1200203,202113,68750,68750,0
2021-03-28,1200336,202113,68750,68750,0
2021-03-28,1200609,202113,68757,68750,7
2021-03-29,1200427,202113,68757,68757,0
2021-03-29,1200401,202113,68853,68757,96
2021-03-29,1200013,202113,68853,68853,0
2021-03-29,1200104,202113,68866,68853,13
2021-03-29,1200435,202113,68866,68866,0
2021-03-29,1200393,202113,68866,68866,0
2021-03-29,1200450,202113,68867,68866,1
2021-03-29,1200609,202113,68867,68867,0
2021-03-29,1200708,202113,68867,68867,0
2021-03-29,1200807,202113,68870,68867,3
2021-03-29,1200385,202113,68871,68870,1
2021-03-29,1200054,202113,68872,68871,1
2021-03-29,1200336,202113,68872,68872,0
2021-03-29,1200344,202113,68872,68872,0
2021-03-29,1200328,202113,68872,68872,0
2021-03-29,1200302,202113,68911,68872,39
2021-03-29,1200252,202113,68917,68911,6
2021-03-29,1200203,202113,68917,68917,0
2021-03-29,1200179,202113,68919,68917,2
2021-03-29,1200138,202113,68920,68919,1
2021-03-29,1200351,202113,68920,68920,0
2021-03-29,1200500,202113,68920,68920,0
2021-03-30,1200385,202113,68918,68920,-2
2021-03-30,1200401,202113,69023,68918,105
2021-03-30,1200708,202113,69025,69023,2
2021-03-30,1200609,202113,69026,69025,1
2021-03-30,1200450,202113,69026,69026,0
2021-03-30,1200500,202113,69101,69026,75
2021-03-30,1200435,202113,69101,69101,0
2021-03-30,1200427,202113,69114,69101,13
2021-03-30,1200393,202113,69115,69114,1
2021-03-30,1200807,202113,69114,69115,-1
2021-03-30,1200351,202113,69115,69114,1
2021-03-30,1200336,202113,69115,69115,0
2021-03-30,1200328,202113,69115,69115,0
2021-03-30,1200302,202113,69114,69115,-1
2021-03-30,1200252,202113,69113,69114,-1
2021-03-30,1200203,202113,69116,69113,3
2021-03-30,1200179,202113,69116,69116,0
2021-03-30,1200138,202113,69116,69116,0
2021-03-30,1200104,202113,69117,69116,1
2021-03-30,1200054,202113,69117,69117,0
2021-03-30,1200013,202113,69117,69117,0
2021-03-30,1200344,202113,69118,69117,1
2021-03-31,1200203,202113,69158,69118,40
2021-03-31,1200328,202113,69165,69158,7
2021-03-31,1200252,202113,69169,69165,4
2021-03-31,1200179,202113,69173,69169,4
2021-03-31,1200385,202113,69186,69173,13
2021-03-31,1200104,202113,69200,69186,14
2021-03-31,1200054,202113,69202,69200,2
2021-03-31,1200013,202113,69224,69202,22
2021-03-31,1200344,202113,69226,69224,2
2021-03-31,1200138,202113,69237,69226,11
2021-03-31,1200336,202113,69238,69237,1
2021-03-31,1200351,202113,69238,69238,0
2021-03-31,1200302,202113,69254,69238,16
2021-03-31,1200807,202113,69264,69254,10
2021-03-31,1200393,202113,69264,69264,0
2021-03-31,1200401,202113,69484,69264,220
2021-03-31,1200427,202113,69486,69484,2
2021-03-31,1200435,202113,69538,69486,52
2021-03-31,1200500,202113,69578,69538,40
2021-03-31,1200450,202113,69585,69578,7
2021-03-31,1200609,202113,69667,69585,82
2021-03-31,1200708,202113,69672,69667,5
2021-04-01,1200013,202113,69684,69672,12
2021-04-01,1200054,202113,69693,69684,9
2021-04-01,1200104,202113,69693,69693,0
2021-04-01,1200138,202113,69709,69693,16
2021-04-01,1200179,202113,69709,69709,0
2021-04-01,1200609,202113,69768,69709,59
2021-04-01,1200252,202113,69769,69768,1
2021-04-01,1200302,202113,69769,69769,0
2021-04-01,1200328,202113,69770,69769,1
2021-04-01,1200344,202113,69770,69770,0
2021-04-01,1200351,202113,69771,69770,1
2021-04-01,1200336,202113,69771,69771,0
2021-04-01,1200385,202113,69786,69771,15
2021-04-01,1200807,202113,69795,69786,9
2021-04-01,1200393,202113,69795,69795,0
2021-04-01,1200401,202113,69916,69795,121
2021-04-01,1200427,202113,69918,69916,2
2021-04-01,1200435,202113,69923,69918,5
2021-04-01,1200500,202113,69952,69923,29
2021-04-01,1200450,202113,69963,69952,11
2021-04-01,1200708,202113,69971,69963,8
2021-04-01,1200203,202113,70003,69971,32
2021-04-02,1200252,202113,70011,70003,8
2021-04-02,1200427,202113,70026,70011,15
2021-04-02,1200708,202113,70041,70026,15
2021-04-02,1200609,202113,70384,70041,343
2021-04-02,1200450,202113,70386,70384,2
2021-04-02,1200500,202113,70464,70386,78
2021-04-02,1200435,202113,70484,70464,20
2021-04-02,1200401,202113,70721,70484,237
2021-04-02,1200393,202113,70721,70721,0
2021-04-02,1200807,202113,70747,70721,26
2021-04-02,1200336,202113,70751,70747,4
2021-04-02,1200385,202113,70762,70751,11
2021-04-02,1200344,202113,70763,70762,1
2021-04-02,1200328,202113,70769,70763,6
2021-04-02,1200302,202113,70813,70769,44
2021-04-02,1200203,202113,70841,70813,28
2021-04-02,1200179,202113,70843,70841,2
2021-04-02,1200138,202113,70842,70843,-1
2021-04-02,1200104,202113,70845,70842,3
2021-04-02,1200054,202113,70856,70845,11
2021-04-02,1200013,202113,70866,70856,10
2021-04-02,1200351,202113,70866,70866,0
2021-04-03,1200252,202113,70868,70866,2
2021-04-03,1200344,202113,70868,70868,0
2021-04-03,1200328,202113,70868,70868,0
2021-04-03,1200302,202113,70871,70868,3
2021-04-03,1200203,202113,70873,70871,2
2021-04-03,1200385,202113,70874,70873,1
2021-04-03,1200138,202113,70879,70874,5
2021-04-03,1200104,202113,70903,70879,24
2021-04-03,1200013,202113,70903,70903,0
2021-04-03,1200351,202113,70903,70903,0
2021-04-03,1200179,202113,70919,70903,16
2021-04-03,1200336,202113,70919,70919,0
2021-04-03,1200054,202113,70919,70919,0
2021-04-03,1200807,202113,70920,70919,1
2021-04-03,1200393,202113,70920,70920,0
2021-04-03,1200401,202113,71057,70920,137
2021-04-03,1200427,202113,71056,71057,-1
2021-04-03,1200435,202113,71056,71056,0
2021-04-03,1200500,202113,71084,71056,28
2021-04-03,1200450,202113,71086,71084,2
2021-04-03,1200609,202113,71078,71086,-8
2021-04-03,1200708,202113,71077,71078,-1
2021-04-04,1200708,202114,71077,71077,0
2021-04-04,1200013,202114,71077,71077,0
2021-04-04,1200054,202114,71077,71077,0
2021-04-04,1200104,202114,71077,71077,0
2021-04-04,1200138,202114,71079,71077,2
2021-04-04,1200179,202114,71079,71079,0
2021-04-04,1200203,202114,71080,71079,1
2021-04-04,1200807,202114,71088,71080,8
2021-04-04,1200450,202114,71087,71088,-1
2021-04-04,1200500,202114,71097,71087,10
2021-04-04,1200435,202114,71097,71097,0
2021-04-04,1200427,202114,71097,71097,0
2021-04-04,1200401,202114,71162,71097,65
2021-04-04,1200393,202114,71162,71162,0
2021-04-04,1200252,202114,71162,71162,0
2021-04-04,1200609,202114,71167,71162,5
2021-04-04,1200336,202114,71167,71167,0
2021-04-04,1200351,202114,71167,71167,0
2021-04-04,1200344,202114,71167,71167,0
2021-04-04,1200328,202114,71167,71167,0
2021-04-04,1200302,202114,71166,71167,-1
2021-04-04,1200385,202114,71172,71166,6
2021-04-05,1200054,202114,71172,71172,0
2021-04-05,1200013,202114,71173,71172,1
2021-04-05,1200104,202114,71173,71173,0
2021-04-05,1200708,202114,71173,71173,0
2021-04-05,1200450,202114,71173,71173,0
2021-04-05,1200500,202114,71196,71173,23
2021-04-05,1200435,202114,71197,71196,1
2021-04-05,1200427,202114,71213,71197,16
2021-04-05,1200401,202114,71329,71213,116
2021-04-05,1200393,202114,71329,71329,0
2021-04-05,1200807,202114,71328,71329,-1
2021-04-05,1200385,202114,71334,71328,6
2021-04-05,1200336,202114,71334,71334,0
2021-04-05,1200351,202114,71333,71334,-1
2021-04-05,1200344,202114,71333,71333,0
2021-04-05,1200328,202114,71333,71333,0
2021-04-05,1200302,202114,71332,71333,-1
2021-04-05,1200252,202114,71334,71332,2
2021-04-05,1200203,202114,71335,71334,1
2021-04-05,1200179,202114,71343,71335,8
2021-04-05,1200138,202114,71344,71343,1
2021-04-05,1200609,202114,71345,71344,1
2021-04-06,1200807,202114,71345,71345,0
2021-04-06,1200393,202114,71345,71345,0
2021-04-06,1200054,202114,71345,71345,0
2021-04-06,1200401,202114,71362,71345,17
2021-04-06,1200427,202114,71362,71362,0
2021-04-06,1200385,202114,71363,71362,1
2021-04-06,1200500,202114,71374,71363,11
2021-04-06,1200450,202114,71375,71374,1
2021-04-06,1200609,202114,71394,71375,19
2021-04-06,1200708,202114,71394,71394,0
2021-04-06,1200336,202114,71395,71394,1
2021-04-06,1200351,202114,71395,71395,0
2021-04-06,1200344,202114,71395,71395,0
2021-04-06,1200328,202114,71395,71395,0
2021-04-06,1200302,202114,71396,71395,1
2021-04-06,1200252,202114,71395,71396,-1
2021-04-06,1200203,202114,71401,71395,6
2021-04-06,1200179,202114,71402,71401,1
2021-04-06,1200138,202114,71403,71402,1
2021-04-06,1200104,202114,71428,71403,25
2021-04-06,1200013,202114,71429,71428,1
2021-04-06,1200435,202114,71435,71429,6
2021-04-07,1200435,202114,71456,71435,21
2021-04-07,1200708,202114,71462,71456,6
2021-04-07,1200500,202114,71483,71462,21
2021-04-07,1200427,202114,71484,71483,1
2021-04-07,1200401,202114,71663,71484,179
2021-04-07,1200393,202114,71663,71663,0
2021-04-07,1200807,202114,71692,71663,29
2021-04-07,1200385,202114,71699,71692,7
2021-04-07,1200336,202114,71700,71699,1
2021-04-07,1200351,202114,71702,71700,2
2021-04-07,1200344,202114,71710,71702,8
2021-04-07,1200328,202114,71710,71710,0
2021-04-07,1200302,202114,71715,71710,5
2021-04-07,1200252,202114,71716,71715,1
2021-04-07,1200203,202114,71753,71716,37
2021-04-07,1200179,202114,71754,71753,1
2021-04-07,1200138,202114,71768,71754,14
2021-04-07,1200104,202114,71777,71768,9
2021-04-07,1200054,202114,71777,71777,0
2021-04-07,1200450,202114,71780,71777,3
2021-04-07,1200609,202114,71886,71780,106
2021-04-07,1200013,202114,71895,71886,9
2021-04-08,1200336,202114,71896,71895,1
2021-04-08,1200807,202114,71911,71896,15
2021-04-08,1200393,202114,71911,71911,0
2021-04-08,1200401,202114,72094,71911,183
2021-04-08,1200427,202114,72106,72094,12
2021-04-08,1200435,202114,72128,72106,22
2021-04-08,1200500,202114,72202,72128,74
2021-04-08,1200450,202114,72210,72202,8
2021-04-08,1200609,202114,72304,72210,94
2021-04-08,1200708,202114,72308,72304,4
2021-04-08,1200351,202114,72319,72308,11
2021-04-08,1200344,202114,72319,72319,0
2021-04-08,1200328,202114,72319,72319,0
2021-04-08,1200302,202114,72347,72319,28
2021-04-08,1200252,202114,72358,72347,11
2021-04-08,1200203,202114,72382,72358,24
2021-04-08,1200179,202114,72392,72382,10
2021-04-08,1200138,202114,72399,72392,7
2021-04-08,1200104,202114,72407,72399,8
2021-04-08,1200054,202114,72418,72407,11
2021-04-08,1200013,202114,72418,72418,0
2021-04-08,1200385,202114,72418,72418,0
2021-04-09,1200336,202114,72419,72418,1
2021-04-09,1200427,202114,72425,72419,6
2021-04-09,1200708,202114,72442,72425,17
2021-04-09,1200609,202114,72563,72442,121
2021-04-09,1200450,202114,72566,72563,3
2021-04-09,1200500,202114,72604,72566,38
2021-04-09,1200435,202114,72606,72604,2
2021-04-09,1200401,202114,72789,72606,183
2021-04-09,1200393,202114,72807,72789,18
2021-04-09,1200807,202114,72820,72807,13
2021-04-09,1200351,202114,72834,72820,14
2021-04-09,1200385,202114,72851,72834,17
2021-04-09,1200328,202114,72859,72851,8
2021-04-09,1200302,202114,72869,72859,10
2021-04-09,1200252,202114,72871,72869,2
2021-04-09,1200203,202114,72879,72871,8
2021-04-09,1200179,202114,72890,72879,11
2021-04-09,1200138,202114,72891,72890,1
2021-04-09,1200104,202114,72895,72891,4
2021-04-09,1200054,202114,72899,72895,4
2021-04-09,1200013,202114,72910,72899,11
2021-04-09,1200344,202114,72912,72910,2
2021-04-10,1200203,202114,72918,72912,6
2021-04-10,1200344,202114,72922,72918,4
2021-04-10,1200328,202114,72925,72922,3
2021-04-10,1200302,202114,72963,72925,38
2021-04-10,1200179,202114,72964,72963,1
2021-04-10,1200385,202114,72966,72964,2
2021-04-10,1200104,202114,72989,72966,23
2021-04-10,1200054,202114,72995,72989,6
2021-04-10,1200013,202114,73012,72995,17
2021-04-10,1200351,202114,73019,73012,7
2021-04-10,1200138,202114,73019,73019,0
2021-04-10,1200336,202114,73019,73019,0
2021-04-10,1200252,202114,73029,73019,10
2021-04-10,1200393,202114,73054,73029,25
2021-04-10,1200401,202114,73129,73054,75
2021-04-10,1200427,202114,73137,73129,8
2021-04-10,1200435,202114,73144,73137,7
2021-04-10,1200500,202114,73191,73144,47
2021-04-10,1200450,202114,73192,73191,1
2021-04-10,1200609,202114,73284,73192,92
2021-04-10,1200708,202114,73284,73284,0
2021-04-10,1200807,202114,73290,73284,6
2021-04-11,1200708,202115,73293,73290,3
2021-04-11,1200013,202115,73291,73293,-2
2021-04-11,1200054,202115,73291,73291,0
2021-04-11,1200104,202115,73291,73291,0
2021-04-11,1200138,202115,73297,73291,6
2021-04-11,1200179,202115,73301,73297,4
2021-04-11,1200203,202115,73301,73301,0
2021-04-11,1200302,202115,73303,73301,2
2021-04-11,1200450,202115,73307,73303,4
2021-04-11,1200500,202115,73329,73307,22
2021-04-11,1200435,202115,73329,73329,0
2021-04-11,1200427,202115,73330,73329,1
2021-04-11,1200401,202115,73412,73330,82
2021-04-11,1200252,202115,73415,73412,3
2021-04-11,1200393,202115,73415,73415,0
2021-04-11,1200385,202115,73418,73415,3
2021-04-11,1200336,202115,73418,73418,0
2021-04-11,1200351,202115,73418,73418,0
2021-04-11,1200344,202115,73419,73418,1
2021-04-11,1200328,202115,73421,73419,2
2021-04-11,1200807,202115,73431,73421,10
2021-04-11,1200609,202115,73440,73431,9
2021-04-12,1200013,202115,73447,73440,7
2021-04-12,1200054,202115,73447,73447,0
2021-04-12,1200104,202115,73478,73447,31
2021-04-12,1200179,202115,73485,73478,7
2021-04-12,1200252,202115,73490,73485,5
2021-04-12,1200302,202115,73527,73490,37
2021-04-12,1200328,202115,73527,73527,0
2021-04-12,1200344,202115,73528,73527,1
2021-04-12,1200351,202115,73528,73528,0
2021-04-12,1200336,202115,73528,73528,0
2021-04-12,1200385,202115,73528,73528,0
2021-04-12,1200807,202115,73528,73528,0
2021-04-12,1200393,202115,73528,73528,0
2021-04-12,1200401,202115,73620,73528,92
2021-04-12,1200427,202115,73620,73620,0
2021-04-12,1200435,202115,73620,73620,0
2021-04-12,1200500,202115,73619,73620,-1
2021-04-12,1200203,202115,73619,73619,0
2021-04-12,1200450,202115,73622,73619,3
2021-04-12,1200609,202115,73625,73622,3
2021-04-12,1200708,202115,73627,73625,2
2021-04-12,1200138,202115,73628,73627,1
2021-04-13,1200013,202115,73631,73628,3
2021-04-13,1200054,202115,73631,73631,0
2021-04-13,1200104,202115,73637,73631,6
2021-04-13,1200138,202115,73641,73637,4
2021-04-13,1200179,202115,73641,73641,0
2021-04-13,1200203,202115,73661,73641,20
2021-04-13,1200252,202115,73664,73661,3
2021-04-13,1200302,202115,73664,73664,0
2021-04-13,1200328,202115,73664,73664,0
2021-04-13,1200344,202115,73664,73664,0
2021-04-13,1200351,202115,73672,73664,8
2021-04-13,1200385,202115,73680,73672,8
2021-04-13,1200393,202115,73681,73680,1
2021-04-13,1200807,202115,73687,73681,6
2021-04-13,1200401,202115,73906,73687,219
2021-04-13,1200427,202115,73918,73906,12
2021-04-13,1200435,202115,73918,73918,0
2021-04-13,1200500,202115,73937,73918,19
2021-04-13,1200450,202115,73936,73937,-1
2021-04-13,1200609,202115,74020,73936,84
2021-04-13,1200708,202115,74022,74020,2
2021-04-13,1200336,202115,74022,74022,0
2021-04-14,1200013,202115,74022,74022,0
2021-04-14,1200054,202115,74030,74022,8
2021-04-14,1200104,202115,74051,74030,21
2021-04-14,1200138,202115,74063,74051,12
2021-04-14,1200179,202115,74063,74063,0
2021-04-14,1200203,202115,74100,74063,37
2021-04-14,1200708,202115,74108,74100,8
2021-04-14,1200328,202115,74112,74108,4
2021-04-14,1200344,202115,74116,74112,4
2021-04-14,1200351,202115,74124,74116,8
2021-04-14,1200336,202115,74125,74124,1
2021-04-14,1200385,202115,74125,74125,0
2021-04-14,1200807,202115,74134,74125,9
2021-04-14,1200393,202115,74137,74134,3
2021-04-14,1200401,202115,74286,74137,149
2021-04-14,1200427,202115,74297,74286,11
2021-04-14,1200435,202115,74305,74297,8
2021-04-14,1200500,202115,74336,74305,31
2021-04-14,1200450,202115,74357,74336,21
2021-04-14,1200609,202115,74542,74357,185
2021-04-14,1200302,202115,74544,74542,2
2021-04-14,1200252,202115,74548,74544,4
2021-04-15,1200435,202115,74548,74548,0
2021-04-15,1200393,202115,74548,74548,0
2021-04-15,1200708,202115,74549,74548,1
2021-04-15,1200609,202115,74546,74549,-3
2021-04-15,1200450,202115,74549,74546,3
2021-04-15,1200500,202115,74549,74549,0
2021-04-15,1200427,202115,74549,74549,0
2021-04-15,1200401,202115,74602,74549,53
2021-04-15,1200807,202115,74612,74602,10
2021-04-15,1200385,202115,74623,74612,11
2021-04-15,1200351,202115,74623,74623,0
2021-04-15,1200336,202115,74623,74623,0
2021-04-15,1200328,202115,74623,74623,0
2021-04-15,1200302,202115,74624,74623,1
2021-04-15,1200252,202115,74626,74624,2
2021-04-15,1200203,202115,74627,74626,1
2021-04-15,1200179,202115,74642,74627,15
2021-04-15,1200138,202115,74652,74642,10
2021-04-15,1200104,202115,74665,74652,13
2021-04-15,1200054,202115,74666,74665,1
2021-04-15,1200013,202115,74679,74666,13
2021-04-15,1200344,202115,74679,74679,0
2021-04-16,1200203,202115,74683,74679,4
2021-04-16,1200302,202115,74729,74683,46
2021-04-16,1200252,202115,74735,74729,6
2021-04-16,1200179,202115,74739,74735,4
2021-04-16,1200351,202115,74739,74739,0
2021-04-16,1200104,202115,74742,74739,3
2021-04-16,1200054,202115,74750,74742,8
2021-04-16,1200013,202115,74752,74750,2
2021-04-16,1200328,202115,74758,74752,6
2021-04-16,1200138,202115,74763,74758,5
2021-04-16,1200336,202115,74763,74763,0
2021-04-16,1200344,202115,74765,74763,2
2021-04-16,1200385,202115,74766,74765,1
2021-04-16,1200807,202115,74774,74766,8
2021-04-16,1200393,202115,74783,74774,9
2021-04-16,1200401,202115,74901,74783,118
2021-04-16,1200427,202115,74910,74901,9
2021-04-16,1200435,202115,74942,74910,32
2021-04-16,1200500,202115,75012,74942,70
2021-04-16,1200450,202115,75019,75012,7
2021-04-16,1200609,202115,75049,75019,30
2021-04-16,1200708,202115,75062,75049,13
2021-04-17,1200013,202115,75072,75062,10
2021-04-17,1200054,202115,75072,75072,0
2021-04-17,1200104,202115,75105,75072,33
2021-04-17,1200138,202115,75113,75105,8
2021-04-17,1200179,202115,75120,75113,7
2021-04-17,1200609,202115,75148,75120,28
2021-04-17,1200252,202115,75156,75148,8
2021-04-17,1200302,202115,75157,75156,1
2021-04-17,1200328,202115,75159,75157,2
2021-04-17,1200344,202115,75169,75159,10
2021-04-17,1200351,202115,75175,75169,6
2021-04-17,1200336,202115,75176,75175,1
2021-04-17,1200385,202115,75177,75176,1
2021-04-17,1200807,202115,75178,75177,1
2021-04-17,1200393,202115,75179,75178,1
2021-04-17,1200401,202115,75266,75179,87
2021-04-17,1200427,202115,75269,75266,3
2021-04-17,1200435,202115,75298,75269,29
2021-04-17,1200500,202115,75313,75298,15
2021-04-17,1200450,202115,75332,75313,19
2021-04-17,1200708,202115,75336,75332,4
2021-04-17,1200203,202115,75349,75336,13
2021-04-18,1200336,202116,75349,75349,0
2021-04-18,1200427,202116,75349,75349,0
2021-04-18,1200708,202116,75351,75349,2
2021-04-18,1200609,202116,75352,75351,1
2021-04-18,1200450,202116,75348,75352,-4
2021-04-18,1200500,202116,75386,75348,38
2021-04-18,1200435,202116,75386,75386,0
2021-04-18,1200401,202116,75397,75386,11
2021-04-18,1200393,202116,75397,75397,0
2021-04-18,1200807,202116,75409,75397,12
2021-04-18,1200351,202116,75409,75409,0
2021-04-18,1200385,202116,75414,75409,5
2021-04-18,1200328,202116,75414,75414,0
2021-04-18,1200302,202116,75415,75414,1
2021-04-18,1200252,202116,75415,75415,0
2021-04-18,1200203,202116,75414,75415,-1
2021-04-18,1200179,202116,75414,75414,0
2021-04-18,1200138,202116,75417,75414,3
2021-04-18,1200104,202116,75416,75417,-1
2021-04-18,1200054,202116,75416,75416,0
2021-04-18,1200013,202116,75419,75416,3
2021-04-18,1200344,202116,75420,75419,1
2021-04-19,1200203,202116,75433,75420,13
2021-04-19,1200344,202116,75436,75433,3
2021-04-19,1200328,202116,75436,75436,0
2021-04-19,1200302,202116,75469,75436,33
2021-04-19,1200179,202116,75473,75469,4
2021-04-19,1200385,202116,75473,75473,0
2021-04-19,1200104,202116,75493,75473,20
2021-04-19,1200054,202116,75498,75493,5
2021-04-19,1200013,202116,75507,75498,9
2021-04-19,1200351,202116,75507,75507,0
2021-04-19,1200138,202116,75509,75507,2
2021-04-19,1200336,202116,75509,75509,0
2021-04-19,1200252,202116,75518,75509,9
2021-04-19,1200807,202116,75519,75518,1
2021-04-19,1200393,202116,75520,75519,1
2021-04-19,1200401,202116,75564,75520,44
2021-04-19,1200427,202116,75568,75564,4
2021-04-19,1200435,202116,75576,75568,8
2021-04-19,1200500,202116,75588,75576,12
2021-04-19,1200450,202116,75595,75588,7
2021-04-19,1200609,202116,75607,75595,12
2021-04-19,1200708,202116,75614,75607,7
2021-04-20,1200708,202116,75614,75614,0
2021-04-20,1200013,202116,75614,75614,0
2021-04-20,1200054,202116,75615,75614,1
2021-04-20,1200104,202116,75620,75615,5
2021-04-20,1200138,202116,75619,75620,-1
2021-04-20,1200179,202116,75619,75619,0
2021-04-20,1200203,202116,75619,75619,0
2021-04-20,1200807,202116,75619,75619,0
2021-04-20,1200450,202116,75618,75619,-1
2021-04-20,1200500,202116,75620,75618,2
2021-04-20,1200435,202116,75620,75620,0
2021-04-20,1200427,202116,75620,75620,0
2021-04-20,1200401,202116,75644,75620,24
2021-04-20,1200393,202116,75644,75644,0
2021-04-20,1200252,202116,75645,75644,1
2021-04-20,1200609,202116,75646,75645,1
2021-04-20,1200336,202116,75646,75646,0
2021-04-20,1200351,202116,75646,75646,0
2021-04-20,1200344,202116,75646,75646,0
2021-04-20,1200328,202116,75646,75646,0
2021-04-20,1200302,202116,75648,75646,2
2021-04-20,1200385,202116,75655,75648,7
2021-04-21,1200054,202116,75666,75655,11
2021-04-21,1200013,202116,75680,75666,14
2021-04-21,1200104,202116,75679,75680,-1
2021-04-21,1200708,202116,75684,75679,5
2021-04-21,1200450,202116,75685,75684,1
2021-04-21,1200500,202116,75710,75685,25
2021-04-21,1200435,202116,75711,75710,1
2021-04-21,1200427,202116,75717,75711,6
2021-04-21,1200401,202116,75801,75717,84
2021-04-21,1200393,202116,75801,75801,0
2021-04-21,1200807,202116,75814,75801,13
2021-04-21,1200385,202116,75814,75814,0
2021-04-21,1200336,202116,75814,75814,0
2021-04-21,1200351,202116,75822,75814,8
2021-04-21,1200344,202116,75822,75822,0
2021-04-21,1200328,202116,75823,75822,1
2021-04-21,1200302,202116,75830,75823,7
2021-04-21,1200252,202116,75831,75830,1
2021-04-21,1200203,202116,75853,75831,22
2021-04-21,1200179,202116,75861,75853,8
2021-04-21,1200138,202116,75867,75861,6
2021-04-21,1200609,202116,75894,75867,27
2021-04-22,1200807,202116,75895,75894,1
2021-04-22,1200393,202116,75895,75895,0
2021-04-22,1200054,202116,75907,75895,12
2021-04-22,1200401,202116,76048,75907,141
2021-04-22,1200427,202116,76049,76048,1
2021-04-22,1200385,202116,76058,76049,9
2021-04-22,1200500,202116,76102,76058,44
2021-04-22,1200450,202116,76107,76102,5
2021-04-22,1200609,202116,76118,76107,11
2021-04-22,1200708,202116,76130,76118,12
2021-04-22,1200336,202116,76133,76130,3
2021-04-22,1200351,202116,76141,76133,8
2021-04-22,1200344,202116,76148,76141,7
2021-04-22,1200328,202116,76149,76148,1
2021-04-22,1200302,202116,76153,76149,4
2021-04-22,1200252,202116,76166,76153,13
2021-04-22,1200203,202116,76173,76166,7
2021-04-22,1200179,202116,76176,76173,3
2021-04-22,1200138,202116,76177,76176,1
2021-04-22,1200104,202116,76210,76177,33
2021-04-22,1200013,202116,76215,76210,5
2021-04-22,1200435,202116,76227,76215,12
2021-04-23,1200435,202116,76228,76227,1
2021-04-23,1200708,202116,76231,76228,3
2021-04-23,1200500,202116,76248,76231,17
2021-04-23,1200427,202116,76248,76248,0
2021-04-23,1200401,202116,76274,76248,26
2021-04-23,1200393,202116,76276,76274,2
2021-04-23,1200807,202116,76276,76276,0
2021-04-23,1200385,202116,76276,76276,0
2021-04-23,1200336,202116,76275,76276,-1
2021-04-23,1200351,202116,76276,76275,1
2021-04-23,1200344,202116,76276,76276,0
2021-04-23,1200328,202116,76277,76276,1
2021-04-23,1200302,202116,76313,76277,36
2021-04-23,1200252,202116,76316,76313,3
2021-04-23,1200203,202116,76315,76316,-1
2021-04-23,1200179,202116,76319,76315,4
2021-04-23,1200138,202116,76319,76319,0
2021-04-23,1200104,202116,76342,76319,23
2021-04-23,1200054,202116,76354,76342,12
2021-04-23,1200450,202116,76354,76354,0
2021-04-23,1200609,202116,76391,76354,37
2021-04-23,1200013,202116,76391,76391,0
2021-04-24,1200336,202116,76393,76391,2
2021-04-24,1200807,202116,76401,76393,8
2021-04-24,1200393,202116,76401,76401,0
2021-04-24,1200401,202116,76496,76401,95
2021-04-24,1200427,202116,76498,76496,2
2021-04-24,1200435,202116,76502,76498,4
2021-04-24,1200500,202116,76541,76502,39
2021-04-24,1200450,202116,76551,76541,10
2021-04-24,1200609,202116,76549,76551,-2
2021-04-24,1200708,202116,76555,76549,6
2021-04-24,1200351,202116,76561,76555,6
2021-04-24,1200344,202116,76561,76561,0
2021-04-24,1200328,202116,76560,76561,-1
2021-04-24,1200302,202116,76561,76560,1
2021-04-24,1200252,202116,76562,76561,1
2021-04-24,1200203,202116,76578,76562,16
2021-04-24,1200179,202116,76579,76578,1
2021-04-24,1200138,202116,76585,76579,6
2021-04-24,1200104,202116,76585,76585,0
2021-04-24,1200054,202116,76594,76585,9
2021-04-24,1200013,202116,76612,76594,18
2021-04-24,1200385,202116,76618,76612,6
2021-04-25,1200252,202117,76618,76618,0
2021-04-25,1200427,202117,76618,76618,0
2021-04-25,1200708,202117,76623,76618,5
2021-04-25,1200609,202117,76630,76623,7
2021-04-25,1200450,202117,76632,76630,2
2021-04-25,1200500,202117,76652,76632,20
2021-04-25,1200435,202117,76652,76652,0
2021-04-25,1200401,202117,76749,76652,97
2021-04-25,1200393,202117,76749,76749,0
2021-04-25,1200807,202117,76749,76749,0
2021-04-25,1200336,202117,76749,76749,0
2021-04-25,1200385,202117,76749,76749,0
2021-04-25,1200344,202117,76749,76749,0
2021-04-25,1200328,202117,76749,76749,0
2021-04-25,1200302,202117,76754,76749,5
2021-04-25,1200203,202117,76755,76754,1
2021-04-25,1200179,202117,76756,76755,1
2021-04-25,1200138,202117,76758,76756,2
2021-04-25,1200104,202117,76758,76758,0
2021-04-25,1200054,202117,76758,76758,0
2021-04-25,1200013,202117,76762,76758,4
2021-04-25,1200351,202117,76762,76762,0
2021-04-26,1200252,202117,76778,76762,16
2021-04-26,1200344,202117,76778,76778,0
2021-04-26,1200328,202117,76778,76778,0
2021-04-26,1200302,202117,76802,76778,24
2021-04-26,1200203,202117,76801,76802,-1
2021-04-26,1200385,202117,76802,76801,1
2021-04-26,1200138,202117,76800,76802,-2
2021-04-26,1200104,202117,76830,76800,30
2021-04-26,1200013,202117,76830,76830,0
2021-04-26,1200351,202117,76830,76830,0
2021-04-26,1200179,202117,76834,76830,4
2021-04-26,1200336,202117,76834,76834,0
2021-04-26,1200054,202117,76834,76834,0
2021-04-26,1200393,202117,76835,76834,1
2021-04-26,1200401,202117,76975,76835,140
2021-04-26,1200427,202117,76975,76975,0
2021-04-26,1200435,202117,76975,76975,0
2021-04-26,1200500,202117,76979,76975,4
2021-04-26,1200450,202117,76981,76979,2
2021-04-26,1200609,202117,76983,76981,2
2021-04-26,1200708,202117,76984,76983,1
2021-04-26,1200807,202117,76986,76984,2
2021-04-27,1200708,202117,76999,76986,13
2021-04-27,1200013,202117,77002,76999,3
2021-04-27,1200054,202117,77002,77002,0
2021-04-27,1200104,202117,77003,77002,1
2021-04-27,1200138,202117,77004,77003,1
2021-04-27,1200179,202117,77003,77004,-1
2021-04-27,1200203,202117,77023,77003,20
2021-04-27,1200302,202117,77026,77023,3
2021-04-27,1200450,202117,77030,77026,4
2021-04-27,1200500,202117,77057,77030,27
2021-04-27,1200435,202117,77057,77057,0
2021-04-27,1200427,202117,77068,77057,11
2021-04-27,1200401,202117,77149,77068,81
2021-04-27,1200252,202117,77148,77149,-1
2021-04-27,1200393,202117,77147,77148,-1
2021-04-27,1200385,202117,77154,77147,7
2021-04-27,1200336,202117,77154,77154,0
2021-04-27,1200351,202117,77156,77154,2
2021-04-27,1200344,202117,77156,77156,0
2021-04-27,1200328,202117,77159,77156,3
2021-04-27,1200807,202117,77159,77159,0
2021-04-27,1200609,202117,77161,77159,2
2021-04-28,1200013,202117,77163,77161,2
2021-04-28,1200054,202117,77173,77163,10
2021-04-28,1200104,202117,77175,77173,2
2021-04-28,1200435,202117,77182,77175,7
2021-04-28,1200427,202117,77187,77182,5
2021-04-28,1200138,202117,77187,77187,0
2021-04-28,1200500,202117,77192,77187,5
2021-04-28,1200450,202117,77193,77192,1
2021-04-28,1200609,202117,77220,77193,27
2021-04-28,1200708,202117,77229,77220,9
2021-04-28,1200807,202117,77232,77229,3
2021-04-28,1200385,202117,77233,77232,1
2021-04-28,1200336,202117,77234,77233,1
2021-04-28,1200351,202117,77236,77234,2
2021-04-28,1200344,202117,77236,77236,0
2021-04-28,1200328,202117,77238,77236,2
2021-04-28,1200302,202117,77240,77238,2
2021-04-28,1200252,202117,77243,77240,3
2021-04-28,1200203,202117,77267,77243,24
2021-04-28,1200179,202117,77272,77267,5
2021-04-28,1200401,202117,77313,77272,41
2021-04-28,1200393,202117,77313,77313,0
2021-04-29,1200385,202117,77324,77313,11
2021-04-29,1200393,202117,77326,77324,2
2021-04-29,1200054,202117,77335,77326,9
2021-04-29,1200104,202117,77354,77335,19
2021-04-29,1200807,202117,77358,77354,4
2021-04-29,1200138,202117,77362,77358,4
2021-04-29,1200179,202117,77363,77362,1
2021-04-29,1200203,202117,77388,77363,25
2021-04-29,1200252,202117,77395,77388,7
2021-04-29,1200302,202117,77421,77395,26
2021-04-29,1200328,202117,77421,77421,0
2021-04-29,1200344,202117,77425,77421,4
2021-04-29,1200013,202117,77448,77425,23
2021-04-29,1200351,202117,77452,77448,4
2021-04-29,1200336,202117,77453,77452,1
2021-04-29,1200427,202117,77454,77453,1
2021-04-29,1200500,202117,77476,77454,22
2021-04-29,1200450,202117,77490,77476,14
2021-04-29,1200609,202117,77494,77490,4
2021-04-29,1200708,202117,77500,77494,6
2021-04-29,1200401,202117,77550,77500,50
2021-04-29,1200435,202117,77550,77550,0
2021-04-30,1200013,202117,77550,77550,0
2021-04-30,1200054,202117,77593,77550,43
2021-04-30,1200104,202117,77600,77593,7
2021-04-30,1200138,202117,77602,77600,2
2021-04-30,1200179,202117,77604,77602,2
2021-04-30,1200203,202117,77614,77604,10
2021-04-30,1200252,202117,77616,77614,2
2021-04-30,1200328,202117,77616,77616,0
2021-04-30,1200302,202117,77627,77616,11
2021-04-30,1200351,202117,77632,77627,5
2021-04-30,1200336,202117,77633,77632,1
2021-04-30,1200385,202117,77638,77633,5
2021-04-30,1200807,202117,77640,77638,2
2021-04-30,1200393,202117,77640,77640,0
2021-04-30,1200401,202117,77754,77640,114
2021-04-30,1200427,202117,77759,77754,5
2021-04-30,1200435,202117,77759,77759,0
2021-04-30,1200500,202117,77782,77759,23
2021-04-30,1200450,202117,77785,77782,3
2021-04-30,1200609,202117,77802,77785,17
2021-04-30,1200708,202117,77817,77802,15
2021-04-30,1200344,202117,77818,77817,1
2021-05-01,1200104,202117,77834,77818,16
2021-05-01,1200179,202117,77845,77834,11
2021-05-01,1200138,202117,77845,77845,0
2021-05-01,1200013,202117,77847,77845,2
2021-05-01,1200054,202117,77872,77847,25
2021-05-01,1200450,202117,77872,77872,0
2021-05-01,1200609,202117,77875,77872,3
2021-05-01,1200708,202117,77882,77875,7
2021-05-01,1200435,202117,77885,77882,3
2021-05-01,1200427,202117,77890,77885,5
2021-05-01,1200401,202117,77966,77890,76
2021-05-01,1200393,202117,77966,77966,0
2021-05-01,1200807,202117,77970,77966,4
2021-05-01,1200385,202117,77988,77970,18
2021-05-01,1200336,202117,77988,77988,0
2021-05-01,1200351,202117,78001,77988,13
2021-05-01,1200344,202117,78001,78001,0
2021-05-01,1200328,202117,78004,78001,3
2021-05-01,1200302,202117,78005,78004,1
2021-05-01,1200252,202117,78009,78005,4
2021-05-01,1200203,202117,78023,78009,14
2021-05-01,1200500,202117,78031,78023,8
2021-05-02,1200393,202118,78031,78031,0
2021-05-02,1200427,202118,78031,78031,0
2021-05-02,1200054,202118,78032,78031,1
2021-05-02,1200104,202118,78052,78032,20
2021-05-02,1200138,202118,78056,78052,4
2021-05-02,1200179,202118,78056,78056,0
2021-05-02,1200203,202118,78057,78056,1
2021-05-02,1200401,202118,78121,78057,64
2021-05-02,1200252,202118,78123,78121,2
2021-05-02,1200302,202118,78146,78123,23
2021-05-02,1200328,202118,78146,78146,0
2021-05-02,1200344,202118,78147,78146,1
2021-05-02,1200351,202118,78147,78147,0
2021-05-02,1200336,202118,78148,78147,1
2021-05-02,1200013,202118,78149,78148,1
2021-05-02,1200385,202118,78150,78149,1
2021-05-02,1200807,202118,78151,78150,1
2021-05-02,1200435,202118,78151,78151,0
2021-05-02,1200500,202118,78160,78151,9
2021-05-02,1200450,202118,78161,78160,1
2021-05-02,1200609,202118,78161,78161,0
2021-05-02,1200708,202118,78167,78161,6
2021-05-03,1200435,202118,78174,78167,7
2021-05-03,1200393,202118,78175,78174,1
2021-05-03,1200500,202118,78193,78175,18
2021-05-03,1200450,202118,78195,78193,2
2021-05-03,1200609,202118,78195,78195,0
2021-05-03,1200708,202118,78200,78195,5
2021-05-03,1200807,202118,78200,78200,0
2021-05-03,1200385,202118,78202,78200,2
2021-05-03,1200336,202118,78201,78202,-1
2021-05-03,1200351,202118,78218,78201,17
2021-05-03,1200302,202118,78224,78218,6
2021-05-03,1200328,202118,78224,78224,0
2021-05-03,1200427,202118,78232,78224,8
2021-05-03,1200252,202118,78242,78232,10
2021-05-03,1200203,202118,78242,78242,0
2021-05-03,1200179,202118,78247,78242,5
2021-05-03,1200138,202118,78247,78247,0
2021-05-03,1200104,202118,78248,78247,1
2021-05-03,1200054,202118,78247,78248,-1
2021-05-03,1200013,202118,78249,78247,2
2021-05-03,1200344,202118,78250,78249,1
2021-05-03,1200401,202118,78340,78250,90
2021-05-04,1200252,202118,78340,78340,0
2021-05-04,1200013,202118,78341,78340,1
2021-05-04,1200302,202118,78344,78341,3
2021-05-04,1200328,202118,78344,78344,0
2021-05-04,1200344,202118,78344,78344,0
2021-05-04,1200351,202118,78350,78344,6
2021-05-04,1200336,202118,78350,78350,0
2021-05-04,1200385,202118,78352,78350,2
2021-05-04,1200179,202118,78353,78352,1
2021-05-04,1200393,202118,78371,78353,18
2021-05-04,1200203,202118,78391,78371,20
2021-05-04,1200401,202118,78446,78391,55
2021-05-04,1200435,202118,78446,78446,0
2021-05-04,1200500,202118,78448,78446,2
2021-05-04,1200450,202118,78448,78448,0
2021-05-04,1200609,202118,78449,78448,1
2021-05-04,1200708,202118,78449,78449,0
2021-05-04,1200138,202118,78450,78449,1
2021-05-04,1200104,202118,78450,78450,0
2021-05-04,1200054,202118,78451,78450,1
2021-05-04,1200427,202118,78455,78451,4
2021-05-04,1200807,202118,78455,78455,0
2021-05-05,1200302,202118,78456,78455,1
2021-05-05,1200401,202118,78547,78456,91
2021-05-05,1200708,202118,78550,78547,3
2021-05-05,1200609,202118,78565,78550,15
2021-05-05,1200450,202118,78568,78565,3
2021-05-05,1200500,202118,78581,78568,13
2021-05-05,1200435,202118,78581,78581,0
2021-05-05,1200427,202118,78583,78581,2
2021-05-05,1200393,202118,78582,78583,-1
2021-05-05,1200807,202118,78586,78582,4
2021-05-05,1200336,202118,78586,78586,0
2021-05-05,1200385,202118,78590,78586,4
2021-05-05,1200344,202118,78590,78590,0
2021-05-05,1200328,202118,78590,78590,0
2021-05-05,1200252,202118,78594,78590,4
2021-05-05,1200203,202118,78594,78594,0
2021-05-05,1200179,202118,78601,78594,7
2021-05-05,1200138,202118,78603,78601,2
2021-05-05,1200104,202118,78621,78603,18
2021-05-05,1200054,202118,78621,78621,0
2021-05-05,1200013,202118,78625,78621,4
2021-05-05,1200351,202118,78625,78625,0
2021-05-06,1200252,202118,78628,78625,3
2021-05-06,1200328,202118,78628,78628,0
2021-05-06,1200302,202118,78673,78628,45
2021-05-06,1200203,202118,78683,78673,10
2021-05-06,1200385,202118,78691,78683,8
2021-05-06,1200138,202118,78698,78691,7
2021-05-06,1200054,202118,78706,78698,8
2021-05-06,1200013,202118,78709,78706,3
2021-05-06,1200344,202118,78712,78709,3
2021-05-06,1200179,202118,78721,78712,9
2021-05-06,1200336,202118,78749,78721,28
2021-05-06,1200351,202118,78756,78749,7
2021-05-06,1200104,202118,78768,78756,12
2021-05-06,1200807,202118,78768,78768,0
2021-05-06,1200393,202118,78771,78768,3
2021-05-06,1200401,202118,78832,78771,61
2021-05-06,1200427,202118,78837,78832,5
2021-05-06,1200435,202118,78869,78837,32
2021-05-06,1200500,202118,78888,78869,19
2021-05-06,1200450,202118,78890,78888,2
2021-05-06,1200609,202118,78898,78890,8
2021-05-06,1200708,202118,78904,78898,6
2021-05-07,1200013,202118,78917,78904,13
2021-05-07,1200054,202118,78931,78917,14
2021-05-07,1200104,202118,78947,78931,16
2021-05-07,1200138,202118,78952,78947,5
2021-05-07,1200179,202118,78953,78952,1
2021-05-07,1200609,202118,78956,78953,3
2021-05-07,1200252,202118,78964,78956,8
2021-05-07,1200302,202118,78970,78964,6
2021-05-07,1200328,202118,78970,78970,0
2021-05-07,1200344,202118,78970,78970,0
2021-05-07,1200351,202118,78971,78970,1
2021-05-07,1200336,202118,79020,78971,49
2021-05-07,1200385,202118,79022,79020,2
2021-05-07,1200807,202118,79025,79022,3
2021-05-07,1200393,202118,79025,79025,0
2021-05-07,1200401,202118,79081,79025,56
2021-05-07,1200427,202118,79082,79081,1
2021-05-07,1200435,202118,79103,79082,21
2021-05-07,1200500,202118,79108,79103,5
2021-05-07,1200450,202118,79111,79108,3
2021-05-07,1200708,202118,79112,79111,1
2021-05-07,1200203,202118,79115,79112,3
2021-05-08,1200500,202118,79134,79115,19
2021-05-08,1200054,202118,79135,79134,1
2021-05-08,1200708,202118,79151,79135,16
2021-05-08,1200609,202118,79164,79151,13
2021-05-08,1200450,202118,79165,79164,1
2021-05-08,1200435,202118,79167,79165,2
2021-05-08,1200401,202118,79237,79167,70
2021-05-08,1200393,202118,79237,79237,0
2021-05-08,1200807,202118,79240,79237,3
2021-05-08,1200385,202118,79247,79240,7
2021-05-08,1200336,202118,79258,79247,11
2021-05-08,1200427,202118,79262,79258,4
2021-05-08,1200344,202118,79262,79262,0
2021-05-08,1200328,202118,79263,79262,1
2021-05-08,1200302,202118,79265,79263,2
2021-05-08,1200252,202118,79265,79265,0
2021-05-08,1200203,202118,79275,79265,10
2021-05-08,1200179,202118,79278,79275,3
2021-05-08,1200138,202118,79284,79278,6
2021-05-08,1200104,202118,79290,79284,6
2021-05-08,1200013,202118,79291,79290,1
2021-05-08,1200351,202118,79291,79291,0
2021-05-09,1200344,202119,79291,79291,0
2021-05-09,1200328,202119,79291,79291,0
2021-05-09,1200302,202119,79322,79291,31
2021-05-09,1200252,202119,79322,79322,0
2021-05-09,1200203,202119,79322,79322,0
2021-05-09,1200013,202119,79323,79322,1
2021-05-09,1200138,202119,79325,79323,2
2021-05-09,1200104,202119,79333,79325,8
2021-05-09,1200054,202119,79333,79333,0
2021-05-09,1200351,202119,79333,79333,0
2021-05-09,1200179,202119,79334,79333,1
2021-05-09,1200336,202119,79334,79334,0
2021-05-09,1200385,202119,79334,79334,0
2021-05-09,1200807,202119,79335,79334,1
2021-05-09,1200393,202119,79335,79335,0
2021-05-09,1200401,202119,79352,79335,17
2021-05-09,1200427,202119,79352,79352,0
2021-05-09,1200435,202119,79352,79352,0
2021-05-09,1200500,202119,79357,79352,5
2021-05-09,1200450,202119,79357,79357,0
2021-05-09,1200609,202119,79357,79357,0
2021-05-09,1200708,202119,79366,79357,9
2021-05-10,1200708,202119,79372,79366,6
2021-05-10,1200013,202119,79373,79372,1
2021-05-10,1200054,202119,79372,79373,-1
2021-05-10,1200104,202119,79377,79372,5
2021-05-10,1200138,202119,79377,79377,0
2021-05-10,1200179,202119,79378,79377,1
2021-05-10,1200203,202119,79383,79378,5
2021-05-10,1200807,202119,79383,79383,0
2021-05-10,1200450,202119,79383,79383,0
2021-05-10,1200500,202119,79386,79383,3
2021-05-10,1200435,202119,79397,79386,11
2021-05-10,1200427,202119,79398,79397,1
2021-05-10,1200401,202119,79455,79398,57
2021-05-10,1200393,202119,79455,79455,0
2021-05-10,1200252,202119,79460,79455,5
2021-05-10,1200609,202119,79466,79460,6
2021-05-10,1200336,202119,79486,79466,20
2021-05-10,1200351,202119,79489,79486,3
2021-05-10,1200344,202119,79490,79489,1
2021-05-10,1200328,202119,79490,79490,0
2021-05-10,1200302,202119,79492,79490,2
2021-05-10,1200385,202119,79491,79492,-1
2021-05-11,1200054,202119,79492,79491,1
2021-05-11,1200013,202119,79492,79492,0
2021-05-11,1200104,202119,79492,79492,0
2021-05-11,1200708,202119,79492,79492,0
2021-05-11,1200450,202119,79492,79492,0
2021-05-11,1200500,202119,79492,79492,0
2021-05-11,1200435,202119,79492,79492,0
2021-05-11,1200427,202119,79492,79492,0
2021-05-11,1200401,202119,79524,79492,32
2021-05-11,1200393,202119,79524,79524,0
2021-05-11,1200807,202119,79524,79524,0
2021-05-11,1200385,202119,79526,79524,2
2021-05-11,1200336,202119,79526,79526,0
2021-05-11,1200351,202119,79526,79526,0
2021-05-11,1200344,202119,79526,79526,0
2021-05-11,1200328,202119,79526,79526,0
2021-05-11,1200302,202119,79526,79526,0
2021-05-11,1200252,202119,79526,79526,0
2021-05-11,1200203,202119,79525,79526,-1
2021-05-11,1200179,202119,79525,79525,0
2021-05-11,1200138,202119,79525,79525,0
2021-05-11,1200609,202119,79525,79525,0
2021-05-12,1200807,202119,79530,79525,5
2021-05-12,1200393,202119,79530,79530,0
2021-05-12,1200054,202119,79530,79530,0
2021-05-12,1200401,202119,79570,79530,40
2021-05-12,1200427,202119,79570,79570,0
2021-05-12,1200385,202119,79573,79570,3
2021-05-12,1200500,202119,79590,79573,17
2021-05-12,1200450,202119,79592,79590,2
2021-05-12,1200609,202119,79604,79592,12
2021-05-12,1200708,202119,79611,79604,7
2021-05-12,1200336,202119,79660,79611,49
2021-05-12,1200351,202119,79663,79660,3
2021-05-12,1200344,202119,79663,79663,0
2021-05-12,1200328,202119,79663,79663,0
2021-05-12,1200302,202119,79668,79663,5
2021-05-12,1200252,202119,79682,79668,14
2021-05-12,1200203,202119,79705,79682,23
2021-05-12,1200179,202119,79710,79705,5
2021-05-12,1200138,202119,79710,79710,0
2021-05-12,1200104,202119,79725,79710,15
2021-05-12,1200013,202119,79729,79725,4
2021-05-12,1200435,202119,79733,79729,4
2021-05-13,1200435,202119,79737,79733,4
2021-05-13,1200708,202119,79753,79737,16
2021-05-13,1200500,202119,79760,79753,7
2021-05-13,1200427,202119,79765,79760,5
2021-05-13,1200401,202119,79847,79765,82
2021-05-13,1200393,202119,79847,79847,0
2021-05-13,1200807,202119,79853,79847,6
2021-05-13,1200385,202119,79859,79853,6
2021-05-13,1200336,202119,79878,79859,19
2021-05-13,1200351,202119,79879,79878,1
2021-05-13,1200344,202119,79884,79879,5
2021-05-13,1200328,202119,79892,79884,8
2021-05-13,1200302,202119,79925,79892,33
2021-05-13,1200252,202119,79926,79925,1
2021-05-13,1200203,202119,79940,79926,14
2021-05-13,1200179,202119,79943,79940,3
2021-05-13,1200138,202119,79952,79943,9
2021-05-13,1200104,202119,79961,79952,9
2021-05-13,1200054,202119,79960,79961,-1
2021-05-13,1200450,202119,79961,79960,1
2021-05-13,1200609,202119,79971,79961,10
2021-05-13,1200013,202119,79970,79971,-1
2021-05-14,1200336,202119,79994,79970,24
2021-05-14,1200807,202119,79997,79994,3
2021-05-14,1200393,202119,80000,79997,3
2021-05-14,1200401,202119,80063,80000,63
2021-05-14,1200427,202119,80069,80063,6
2021-05-14,1200435,202119,80069,80069,0
2021-05-14,1200500,202119,80076,80069,7
2021-05-14,1200450,202119,80078,80076,2
2021-05-14,1200609,202119,80097,80078,19
2021-05-14,1200708,202119,80099,80097,2
2021-05-14,1200351,202119,80115,80099,16
2021-05-14,1200344,202119,80116,80115,1
2021-05-14,1200328,202119,80118,80116,2
2021-05-14,1200302,202119,80120,80118,2
2021-05-14,1200252,202119,80123,80120,3
2021-05-14,1200203,202119,80140,80123,17
2021-05-14,1200179,202119,80143,80140,3
2021-05-14,1200138,202119,80143,80143,0
2021-05-14,1200104,202119,80170,80143,27
2021-05-14,1200054,202119,80184,80170,14
2021-05-14,1200013,202119,80190,80184,6
2021-05-14,1200385,202119,80192,80190,2
2021-05-15,1200252,202119,80206,80192,14
2021-05-15,1200427,202119,80209,80206,3
2021-05-15,1200708,202119,80213,80209,4
2021-05-15,1200609,202119,80214,80213,1
2021-05-15,1200450,202119,80216,80214,2
2021-05-15,1200500,202119,80217,80216,1
2021-05-15,1200435,202119,80224,80217,7
2021-05-15,1200401,202119,80281,80224,57
2021-05-15,1200393,202119,80281,80281,0
2021-05-15,1200807,202119,80293,80281,12
2021-05-15,1200336,202119,80311,80293,18
2021-05-15,1200385,202119,80314,80311,3
2021-05-15,1200344,202119,80314,80314,0
2021-05-15,1200328,202119,80314,80314,0
2021-05-15,1200302,202119,80314,80314,0
2021-05-15,1200203,202119,80314,80314,0
2021-05-15,1200179,202119,80316,80314,2
2021-05-15,1200138,202119,80318,80316,2
2021-05-15,1200104,202119,80330,80318,12
2021-05-15,1200054,202119,80331,80330,1
2021-05-15,1200013,202119,80333,80331,2
2021-05-15,1200351,202119,80353,80333,20
2021-05-16,1200252,202120,80353,80353,0
2021-05-16,1200344,202120,80353,80353,0
2021-05-16,1200328,202120,80353,80353,0
2021-05-16,1200302,202120,80354,80353,1
2021-05-16,1200203,202120,80354,80354,0
2021-05-16,1200385,202120,80354,80354,0
2021-05-16,1200138,202120,80354,80354,0
2021-05-16,1200104,202120,80368,80354,14
2021-05-16,1200013,202120,80371,80368,3
2021-05-16,1200351,202120,80371,80371,0
2021-05-16,1200179,202120,80372,80371,1
2021-05-16,1200336,202120,80372,80372,0
2021-05-16,1200054,202120,80373,80372,1
2021-05-16,1200393,202120,80373,80373,0
2021-05-16,1200401,202120,80398,80373,25
2021-05-16,1200427,202120,80398,80398,0
2021-05-16,1200435,202120,80398,80398,0
2021-05-16,1200500,202120,80402,80398,4
2021-05-16,1200450,202120,80404,80402,2
2021-05-16,1200609,202120,80413,80404,9
2021-05-16,1200708,202120,80414,80413,1
2021-05-16,1200807,202120,80414,80414,0
2021-05-17,1200708,202120,80415,80414,1
2021-05-17,1200013,202120,80416,80415,1
2021-05-17,1200054,202120,80416,80416,0
2021-05-17,1200104,202120,80422,80416,6
2021-05-17,1200138,202120,80422,80422,0
2021-05-17,1200179,202120,80423,80422,1
2021-05-17,1200203,202120,80437,80423,14
2021-05-17,1200302,202120,80484,80437,47
2021-05-17,1200450,202120,80486,80484,2
2021-05-17,1200500,202120,80491,80486,5
2021-05-17,1200435,202120,80491,80491,0
2021-05-17,1200427,202120,80491,80491,0
2021-05-17,1200401,202120,80546,80491,55
2021-05-17,1200252,202120,80551,80546,5
2021-05-17,1200393,202120,80551,80551,0
2021-05-17,1200385,202120,80554,80551,3
2021-05-17,1200336,202120,80569,80554,15
2021-05-17,1200351,202120,80575,80569,6
2021-05-17,1200344,202120,80575,80575,0
2021-05-17,1200328,202120,80575,80575,0
2021-05-17,1200807,202120,80575,80575,0
2021-05-17,1200609,202120,80576,80575,1
2021-05-18,1200013,202120,80576,80576,0
2021-05-18,1200054,202120,80576,80576,0
2021-05-18,1200104,202120,80576,80576,0
2021-05-18,1200179,202120,80576,80576,0
2021-05-18,1200252,202120,80576,80576,0
2021-05-18,1200302,202120,80576,80576,0
2021-05-18,1200328,202120,80576,80576,0
2021-05-18,1200344,202120,80576,80576,0
2021-05-18,1200351,202120,80576,80576,0
2021-05-18,1200336,202120,80576,80576,0
2021-05-18,1200385,202120,80577,80576,1
2021-05-18,1200807,202120,80577,80577,0
2021-05-18,1200393,202120,80577,80577,0
2021-05-18,1200401,202120,80606,80577,29
2021-05-18,1200427,202120,80606,80606,0
2021-05-18,1200435,202120,80606,80606,0
2021-05-18,1200500,202120,80606,80606,0
2021-05-18,1200203,202120,80606,80606,0
2021-05-18,1200450,202120,80605,80606,-1
2021-05-18,1200609,202120,80605,80605,0
2021-05-18,1200708,202120,80605,80605,0
2021-05-18,1200138,202120,80605,80605,0
2021-05-19,1200013,202120,80605,80605,0
2021-05-19,1200054,202120,80606,80605,1
2021-05-19,1200104,202120,80606,80606,0
2021-05-19,1200138,202120,80607,80606,1
2021-05-19,1200179,202120,80608,80607,1
2021-05-19,1200203,202120,80609,80608,1
2021-05-19,1200252,202120,80608,80609,-1
2021-05-19,1200302,202120,80608,80608,0
2021-05-19,1200328,202120,80608,80608,0
2021-05-19,1200344,202120,80608,80608,0
2021-05-19,1200351,202120,80608,80608,0
2021-05-19,1200385,202120,80610,80608,2
2021-05-19,1200393,202120,80610,80610,0
2021-05-19,1200807,202120,80616,80610,6
2021-05-19,1200401,202120,80686,80616,70
2021-05-19,1200427,202120,80686,80686,0
2021-05-19,1200435,202120,80686,80686,0
2021-05-19,1200500,202120,80689,80686,3
2021-05-19,1200450,202120,80689,80689,0
2021-05-19,1200609,202120,80703,80689,14
2021-05-19,1200708,202120,80703,80703,0
2021-05-19,1200336,202120,80703,80703,0
2021-05-20,1200013,202120,80703,80703,0
2021-05-20,1200054,202120,80703,80703,0
2021-05-20,1200104,202120,80719,80703,16
2021-05-20,1200138,202120,80721,80719,2
2021-05-20,1200179,202120,80723,80721,2
2021-05-20,1200203,202120,80724,80723,1
2021-05-20,1200708,202120,80724,80724,0
2021-05-20,1200328,202120,80724,80724,0
2021-05-20,1200344,202120,80724,80724,0
2021-05-20,1200351,202120,80724,80724,0
2021-05-20,1200336,202120,80724,80724,0
2021-05-20,1200385,202120,80725,80724,1
2021-05-20,1200807,202120,80732,80725,7
2021-05-20,1200393,202120,80732,80732,0
2021-05-20,1200401,202120,80776,80732,44
2021-05-20,1200427,202120,80776,80776,0
2021-05-20,1200435,202120,80776,80776,0
2021-05-20,1200500,202120,80776,80776,0
2021-05-20,1200450,202120,80780,80776,4
2021-05-20,1200609,202120,80790,80780,10
2021-05-20,1200302,202120,80807,80790,17
2021-05-20,1200252,202120,80812,80807,5
2021-05-21,1200435,202120,80816,80812,4
2021-05-21,1200393,202120,80819,80816,3
2021-05-21,1200708,202120,80848,80819,29
2021-05-21,1200609,202120,80855,80848,7
2021-05-21,1200450,202120,80856,80855,1
2021-05-21,1200500,202120,80877,80856,21
2021-05-21,1200427,202120,80886,80877,9
2021-05-21,1200401,202120,81009,80886,123
2021-05-21,1200807,202120,81013,81009,4
2021-05-21,1200385,202120,81042,81013,29
2021-05-21,1200351,202120,81058,81042,16
2021-05-21,1200336,202120,81127,81058,69
2021-05-21,1200328,202120,81127,81127,0
2021-05-21,1200302,202120,81140,81127,13
2021-05-21,1200252,202120,81147,81140,7
2021-05-21,1200203,202120,81177,81147,30
2021-05-21,1200179,202120,81183,81177,6
2021-05-21,1200138,202120,81183,81183,0
2021-05-21,1200104,202120,81210,81183,27
2021-05-21,1200054,202120,81250,81210,40
2021-05-21,1200013,202120,81250,81250,0
2021-05-21,1200344,202120,81250,81250,0
2021-05-22,1200203,202120,81251,81250,1
2021-05-22,1200302,202120,81252,81251,1
2021-05-22,1200252,202120,81254,81252,2
2021-05-22,1200179,202120,81257,81254,3
2021-05-22,1200351,202120,81260,81257,3
2021-05-22,1200104,202120,81262,81260,2
2021-05-22,1200054,202120,81270,81262,8
2021-05-22,1200013,202120,81272,81270,2
2021-05-22,1200328,202120,81272,81272,0
2021-05-22,1200138,202120,81272,81272,0
2021-05-22,1200336,202120,81289,81272,17
2021-05-22,1200344,202120,81289,81289,0
2021-05-22,1200385,202120,81289,81289,0
2021-05-22,1200807,202120,81293,81289,4
2021-05-22,1200393,202120,81293,81293,0
2021-05-22,1200401,202120,81352,81293,59
2021-05-22,1200427,202120,81352,81352,0
2021-05-22,1200435,202120,81353,81352,1
2021-05-22,1200500,202120,81353,81353,0
2021-05-22,1200450,202120,81360,81353,7
2021-05-22,1200609,202120,81363,81360,3
2021-05-22,1200708,202120,81363,81363,0
2021-05-23,1200013,202121,81364,81363,1
2021-05-23,1200054,202121,81364,81364,0
2021-05-23,1200104,202121,81364,81364,0
2021-05-23,1200138,202121,81366,81364,2
2021-05-23,1200179,202121,81365,81366,-1
2021-05-23,1200609,202121,81364,81365,-1
2021-05-23,1200252,202121,81364,81364,0
2021-05-23,1200302,202121,81363,81364,-1
2021-05-23,1200328,202121,81363,81363,0
2021-05-23,1200344,202121,81363,81363,0
2021-05-23,1200351,202121,81362,81363,-1
2021-05-23,1200336,202121,81362,81362,0
2021-05-23,1200385,202121,81363,81362,1
2021-05-23,1200807,202121,81369,81363,6
2021-05-23,1200393,202121,81369,81369,0
2021-05-23,1200401,202121,81404,81369,35
2021-05-23,1200427,202121,81404,81404,0
2021-05-23,1200435,202121,81404,81404,0
2021-05-23,1200500,202121,81419,81404,15
2021-05-23,1200450,202121,81421,81419,2
2021-05-23,1200708,202121,81428,81421,7
2021-05-23,1200203,202121,81428,81428,0
2021-05-24,1200336,202121,81428,81428,0
2021-05-24,1200427,202121,81428,81428,0
2021-05-24,1200708,202121,81429,81428,1
2021-05-24,1200609,202121,81436,81429,7
2021-05-24,1200450,202121,81438,81436,2
2021-05-24,1200500,202121,81441,81438,3
2021-05-24,1200435,202121,81441,81441,0
2021-05-24,1200401,202121,81468,81441,27
2021-05-24,1200393,202121,81468,81468,0
2021-05-24,1200807,202121,81469,81468,1
2021-05-24,1200351,202121,81469,81469,0
2021-05-24,1200385,202121,81469,81469,0
2021-05-24,1200328,202121,81469,81469,0
2021-05-24,1200302,202121,81496,81469,27
2021-05-24,1200252,202121,81500,81496,4
2021-05-24,1200203,202121,81500,81500,0
2021-05-24,1200179,202121,81500,81500,0
2021-05-24,1200138,202121,81500,81500,0
2021-05-24,1200104,202121,81514,81500,14
2021-05-24,1200054,202121,81521,81514,7
2021-05-24,1200013,202121,81520,81521,-1
2021-05-24,1200344,202121,81520,81520,0
2021-05-25,1200203,202121,81531,81520,11
2021-05-25,1200344,202121,81532,81531,1
2021-05-25,1200328,202121,81535,81532,3
2021-05-25,1200302,202121,81536,81535,1
2021-05-25,1200179,202121,81536,81536,0
2021-05-25,1200385,202121,81540,81536,4
2021-05-25,1200104,202121,81541,81540,1
2021-05-25,1200054,202121,81541,81541,0
2021-05-25,1200013,202121,81545,81541,4
2021-05-25,1200351,202121,81547,81545,2
2021-05-25,1200138,202121,81547,81547,0
2021-05-25,1200336,202121,81576,81547,29
2021-05-25,1200252,202121,81579,81576,3
2021-05-25,1200807,202121,81579,81579,0
2021-05-25,1200393,202121,81580,81579,1
2021-05-25,1200401,202121,81654,81580,74
2021-05-25,1200427,202121,81658,81654,4
2021-05-25,1200435,202121,81662,81658,4
2021-05-25,1200500,202121,81667,81662,5
2021-05-25,1200450,202121,81667,81667,0
2021-05-25,1200609,202121,81665,81667,-2
2021-05-25,1200708,202121,81666,81665,1
2021-05-26,1200708,202121,81667,81666,1
2021-05-26,1200013,202121,81669,81667,2
2021-05-26,1200054,202121,81670,81669,1
2021-05-26,1200104,202121,81685,81670,15
2021-05-26,1200138,202121,81686,81685,1
2021-05-26,1200179,202121,81688,81686,2
2021-05-26,1200203,202121,81713,81688,25
2021-05-26,1200807,202121,81722,81713,9
2021-05-26,1200450,202121,81725,81722,3
2021-05-26,1200500,202121,81734,81725,9
2021-05-26,1200435,202121,81736,81734,2
2021-05-26,1200427,202121,81737,81736,1
2021-05-26,1200401,202121,81802,81737,65
2021-05-26,1200393,202121,81802,81802,0
2021-05-26,1200252,202121,81808,81802,6
2021-05-26,1200609,202121,81814,81808,6
2021-05-26,1200336,202121,81841,81814,27
2021-05-26,1200351,202121,81842,81841,1
2021-05-26,1200344,202121,81842,81842,0
2021-05-26,1200328,202121,81842,81842,0
2021-05-26,1200302,202121,81845,81842,3
2021-05-26,1200385,202121,81865,81845,20
2021-05-27,1200054,202121,81865,81865,0
2021-05-27,1200013,202121,81865,81865,0
2021-05-27,1200104,202121,81866,81865,1
2021-05-27,1200708,202121,81873,81866,7
2021-05-27,1200450,202121,81878,81873,5
2021-05-27,1200500,202121,81880,81878,2
2021-05-27,1200435,202121,81880,81880,0
2021-05-27,1200427,202121,81887,81880,7
2021-05-27,1200401,202121,81922,81887,35
2021-05-27,1200393,202121,81922,81922,0
2021-05-27,1200807,202121,81929,81922,7
2021-05-27,1200385,202121,81934,81929,5
2021-05-27,1200336,202121,81940,81934,6
2021-05-27,1200351,202121,81942,81940,2
2021-05-27,1200344,202121,81942,81942,0
2021-05-27,1200328,202121,81951,81942,9
2021-05-27,1200302,202121,81977,81951,26
2021-05-27,1200252,202121,81978,81977,1
2021-05-27,1200203,202121,81989,81978,11
2021-05-27,1200179,202121,81994,81989,5
2021-05-27,1200138,202121,81994,81994,0
2021-05-27,1200609,202121,81995,81994,1
2021-05-28,1200807,202121,81996,81995,1
2021-05-28,1200393,202121,81997,81996,1
2021-05-28,1200054,202121,82014,81997,17
2021-05-28,1200401,202121,82081,82014,67
2021-05-28,1200427,202121,82081,82081,0
2021-05-28,1200385,202121,82090,82081,9
2021-05-28,1200500,202121,82095,82090,5
2021-05-28,1200450,202121,82098,82095,3
2021-05-28,1200609,202121,82105,82098,7
2021-05-28,1200708,202121,82106,82105,1
2021-05-28,1200336,202121,82115,82106,9
2021-05-28,1200351,202121,82115,82115,0
2021-05-28,1200344,202121,82119,82115,4
2021-05-28,1200328,202121,82129,82119,10
2021-05-28,1200302,202121,82131,82129,2
2021-05-28,1200252,202121,82137,82131,6
2021-05-28,1200203,202121,82140,82137,3
2021-05-28,1200179,202121,82142,82140,2
2021-05-28,1200138,202121,82145,82142,3
2021-05-28,1200104,202121,82160,82145,15
2021-05-28,1200013,202121,82163,82160,3
2021-05-28,1200435,202121,82164,82163,1
2021-05-29,1200435,202121,82164,82164,0
2021-05-29,1200708,202121,82166,82164,2
2021-05-29,1200500,202121,82167,82166,1
2021-05-29,1200427,202121,82168,82167,1
2021-05-29,1200401,202121,82194,82168,26
2021-05-29,1200393,202121,82194,82194,0
2021-05-29,1200807,202121,82206,82194,12
2021-05-29,1200385,202121,82208,82206,2
2021-05-29,1200336,202121,82208,82208,0
2021-05-29,1200351,202121,82208,82208,0
2021-05-29,1200344,202121,82208,82208,0
2021-05-29,1200328,202121,82208,82208,0
2021-05-29,1200302,202121,82211,82208,3
2021-05-29,1200252,202121,82211,82211,0
2021-05-29,1200203,202121,82211,82211,0
2021-05-29,1200179,202121,82215,82211,4
2021-05-29,1200138,202121,82217,82215,2
2021-05-29,1200104,202121,82219,82217,2
2021-05-29,1200054,202121,82220,82219,1
2021-05-29,1200450,202121,82222,82220,2
2021-05-29,1200609,202121,82222,82222,0
2021-05-29,1200013,202121,82222,82222,0
2021-05-30,1200336,202122,82264,82222,42
2021-05-30,1200807,202122,82263,82264,-1
2021-05-30,1200393,202122,82266,82263,3
2021-05-30,1200401,202122,82359,82266,93
2021-05-30,1200427,202122,82360,82359,1
2021-05-30,1200435,202122,82365,82360,5
2021-05-30,1200500,202122,82371,82365,6
2021-05-30,1200450,202122,82373,82371,2
2021-05-30,1200609,202122,82374,82373,1
2021-05-30,1200708,202122,82373,82374,-1
2021-05-30,1200351,202122,82380,82373,7
2021-05-30,1200344,202122,82382,82380,2
2021-05-30,1200328,202122,82436,82382,54
2021-05-30,1200302,202122,82436,82436,0
2021-05-30,1200252,202122,82440,82436,4
2021-05-30,1200203,202122,82451,82440,11
2021-05-30,1200179,202122,82451,82451,0
2021-05-30,1200138,202122,82452,82451,1
2021-05-30,1200104,202122,82460,82452,8
2021-05-30,1200054,202122,82469,82460,9
2021-05-30,1200013,202122,82482,82469,13
2021-05-30,1200385,202122,82493,82482,11
2021-05-31,1200336,202122,82493,82493,0
2021-05-31,1200427,202122,82493,82493,0
2021-05-31,1200708,202122,82493,82493,0
2021-05-31,1200609,202122,82494,82493,1
2021-05-31,1200450,202122,82495,82494,1
2021-05-31,1200500,202122,82495,82495,0
2021-05-31,1200435,202122,82495,82495,0
2021-05-31,1200401,202122,82520,82495,25
2021-05-31,1200393,202122,82520,82520,0
2021-05-31,1200807,202122,82520,82520,0
2021-05-31,1200351,202122,82520,82520,0
2021-05-31,1200385,202122,82520,82520,0
2021-05-31,1200328,202122,82520,82520,0
2021-05-31,1200302,202122,82537,82520,17
2021-05-31,1200252,202122,82539,82537,2
2021-05-31,1200203,202122,82539,82539,0
2021-05-31,1200179,202122,82539,82539,0
2021-05-31,1200138,202122,82540,82539,1
2021-05-31,1200104,202122,82540,82540,0
2021-05-31,1200054,202122,82540,82540,0
2021-05-31,1200013,202122,82539,82540,-1
2021-05-31,1200344,202122,82539,82539,0
2021-06-01,1200203,202122,82541,82539,2
2021-06-01,1200344,202122,82541,82541,0
2021-06-01,1200328,202122,82544,82541,3
2021-06-01,1200302,202122,82544,82544,0
2021-06-01,1200179,202122,82544,82544,0
2021-06-01,1200385,202122,82553,82544,9
2021-06-01,1200104,202122,82553,82553,0
2021-06-01,1200054,202122,82553,82553,0
2021-06-01,1200013,202122,82557,82553,4
2021-06-01,1200351,202122,82557,82557,0
2021-06-01,1200138,202122,82558,82557,1
2021-06-01,1200336,202122,82558,82558,0
2021-06-01,1200252,202122,82558,82558,0
2021-06-01,1200393,202122,82558,82558,0
2021-06-01,1200401,202122,82586,82558,28
2021-06-01,1200427,202122,82587,82586,1
2021-06-01,1200435,202122,82588,82587,1
2021-06-01,1200500,202122,82593,82588,5
2021-06-01,1200450,202122,82594,82593,1
2021-06-01,1200609,202122,82595,82594,1
2021-06-01,1200708,202122,82595,82595,0
2021-06-01,1200807,202122,82596,82595,1
2021-06-02,1200708,202122,82597,82596,1
2021-06-02,1200013,202122,82608,82597,11
2021-06-02,1200054,202122,82612,82608,4
2021-06-02,1200104,202122,82623,82612,11
2021-06-02,1200138,202122,82623,82623,0
2021-06-02,1200179,202122,82625,82623,2
2021-06-02,1200203,202122,82637,82625,12
2021-06-02,1200302,202122,82637,82637,0
2021-06-02,1200450,202122,82641,82637,4
2021-06-02,1200500,202122,82646,82641,5
2021-06-02,1200435,202122,82647,82646,1
2021-06-02,1200427,202122,82648,82647,1
2021-06-02,1200401,202122,82707,82648,59
2021-06-02,1200252,202122,82709,82707,2
2021-06-02,1200393,202122,82709,82709,0
2021-06-02,1200385,202122,82739,82709,30
2021-06-02,1200336,202122,82739,82739,0
2021-06-02,1200351,202122,82739,82739,0
2021-06-02,1200344,202122,82742,82739,3
2021-06-02,1200328,202122,82767,82742,25
2021-06-02,1200807,202122,82767,82767,0
2021-06-02,1200609,202122,82768,82767,1
2021-06-03,1200013,202122,82771,82768,3
2021-06-03,1200054,202122,82772,82771,1
2021-06-03,1200104,202122,82781,82772,9
2021-06-03,1200435,202122,82789,82781,8
2021-06-03,1200427,202122,82792,82789,3
2021-06-03,1200138,202122,82792,82792,0
2021-06-03,1200500,202122,82794,82792,2
2021-06-03,1200450,202122,82797,82794,3
2021-06-03,1200609,202122,82798,82797,1
2021-06-03,1200708,202122,82801,82798,3
2021-06-03,1200807,202122,82807,82801,6
2021-06-03,1200385,202122,82835,82807,28
2021-06-03,1200336,202122,82878,82835,43
2021-06-03,1200351,202122,82878,82878,0
2021-06-03,1200344,202122,82878,82878,0
2021-06-03,1200328,202122,82880,82878,2
2021-06-03,1200302,202122,82886,82880,6
2021-06-03,1200252,202122,82895,82886,9
2021-06-03,1200203,202122,82896,82895,1
2021-06-03,1200179,202122,82897,82896,1
2021-06-03,1200401,202122,82951,82897,54
2021-06-03,1200393,202122,82952,82951,1
2021-06-04,1200385,202122,82956,82952,4
2021-06-04,1200393,202122,82956,82956,0
2021-06-04,1200054,202122,82960,82956,4
2021-06-04,1200104,202122,82960,82960,0
2021-06-04,1200807,202122,82960,82960,0
2021-06-04,1200138,202122,82962,82960,2
2021-06-04,1200179,202122,82962,82962,0
2021-06-04,1200203,202122,82979,82962,17
2021-06-04,1200252,202122,82981,82979,2
2021-06-04,1200302,202122,82987,82981,6
2021-06-04,1200328,202122,82992,82987,5
2021-06-04,1200344,202122,82992,82992,0
2021-06-04,1200013,202122,83008,82992,16
2021-06-04,1200351,202122,83010,83008,2
2021-06-04,1200336,202122,83071,83010,61
2021-06-04,1200500,202122,83080,83071,9
2021-06-04,1200609,202122,83085,83080,5
2021-06-04,1200427,202122,83089,83085,4
2021-06-04,1200708,202122,83093,83089,4
2021-06-04,1200435,202122,83098,83093,5
2021-06-04,1200401,202122,83135,83098,37
2021-06-04,1200450,202122,83138,83135,3
2021-06-05,1200013,202122,83142,83138,4
2021-06-05,1200054,202122,83143,83142,1
2021-06-05,1200104,202122,83157,83143,14
2021-06-05,1200138,202122,83157,83157,0
2021-06-05,1200179,202122,83158,83157,1
2021-06-05,1200203,202122,83163,83158,5
2021-06-05,1200252,202122,83171,83163,8
2021-06-05,1200328,202122,83173,83171,2
2021-06-05,1200302,202122,83173,83173,0
2021-06-05,1200336,202122,83173,83173,0
2021-06-05,1200385,202122,83171,83173,-2
2021-06-05,1200807,202122,83174,83171,3
2021-06-05,1200393,202122,83174,83174,0
2021-06-05,1200401,202122,83238,83174,64
2021-06-05,1200427,202122,83238,83238,0
2021-06-05,1200435,202122,83238,83238,0
2021-06-05,1200500,202122,83244,83238,6
2021-06-05,1200450,202122,83243,83244,-1
2021-06-05,1200609,202122,83242,83243,-1
2021-06-05,1200708,202122,83246,83242,4
2021-06-05,1200351,202122,83255,83246,9
2021-06-05,1200344,202122,83255,83255,0
2021-06-06,1200179,202123,83256,83255,1
2021-06-06,1200138,202123,83256,83256,0
2021-06-06,1200104,202123,83256,83256,0
2021-06-06,1200013,202123,83254,83256,-2
2021-06-06,1200054,202123,83269,83254,15
2021-06-06,1200807,202123,83274,83269,5
2021-06-06,1200500,202123,83274,83274,0
2021-06-06,1200435,202123,83274,83274,0
2021-06-06,1200427,202123,83274,83274,0
2021-06-06,1200401,202123,83303,83274,29
2021-06-06,1200393,202123,83303,83303,0
2021-06-06,1200708,202123,83303,83303,0
2021-06-06,1200450,202123,83303,83303,0
2021-06-06,1200385,202123,83305,83303,2
2021-06-06,1200351,202123,83304,83305,-1
2021-06-06,1200344,202123,83304,83304,0
2021-06-06,1200328,202123,83313,83304,9
2021-06-06,1200302,202123,83312,83313,-1
2021-06-06,1200252,202123,83312,83312,0
2021-06-06,1200203,202123,83313,83312,1
2021-06-06,1200336,202123,83320,83313,7
2021-06-06,1200609,202123,83321,83320,1
2021-06-07,1200427,202123,83321,83321,0
2021-06-07,1200401,202123,83351,83321,30
2021-06-07,1200013,202123,83357,83351,6
2021-06-07,1200104,202123,83360,83357,3
2021-06-07,1200435,202123,83360,83360,0
2021-06-07,1200393,202123,83360,83360,0
2021-06-07,1200450,202123,83360,83360,0
2021-06-07,1200609,202123,83360,83360,0
2021-06-07,1200708,202123,83360,83360,0
2021-06-07,1200807,202123,83361,83360,1
2021-06-07,1200385,202123,83361,83361,0
2021-06-07,1200054,202123,83361,83361,0
2021-06-07,1200336,202123,83361,83361,0
2021-06-07,1200344,202123,83361,83361,0
2021-06-07,1200328,202123,83361,83361,0
2021-06-07,1200302,202123,83361,83361,0
2021-06-07,1200252,202123,83365,83361,4
2021-06-07,1200203,202123,83365,83365,0
2021-06-07,1200179,202123,83365,83365,0
2021-06-07,1200138,202123,83365,83365,0
2021-06-07,1200351,202123,83365,83365,0
2021-06-07,1200500,202123,83365,83365,0
2021-06-08,1200385,202123,83365,83365,0
2021-06-08,1200401,202123,83401,83365,36
2021-06-08,1200708,202123,83401,83401,0
2021-06-08,1200609,202123,83401,83401,0
2021-06-08,1200450,202123,83401,83401,0
2021-06-08,1200500,202123,83402,83401,1
2021-06-08,1200435,202123,83402,83402,0
2021-06-08,1200427,202123,83402,83402,0
2021-06-08,1200393,202123,83402,83402,0
2021-06-08,1200807,202123,83404,83402,2
2021-06-08,1200351,202123,83404,83404,0
2021-06-08,1200336,202123,83412,83404,8
2021-06-08,1200328,202123,83419,83412,7
2021-06-08,1200302,202123,83421,83419,2
2021-06-08,1200252,202123,83422,83421,1
2021-06-08,1200203,202123,83423,83422,1
2021-06-08,1200179,202123,83424,83423,1
2021-06-08,1200138,202123,83424,83424,0
2021-06-08,1200104,202123,83425,83424,1
2021-06-08,1200054,202123,83424,83425,-1
2021-06-08,1200013,202123,83424,83424,0
2021-06-08,1200344,202123,83424,83424,0
2021-06-09,1200203,202123,83424,83424,0
2021-06-09,1200328,202123,83424,83424,0
2021-06-09,1200252,202123,83433,83424,9
2021-06-09,1200179,202123,83434,83433,1
2021-06-09,1200385,202123,83434,83434,0
2021-06-09,1200104,202123,83462,83434,28
2021-06-09,1200054,202123,83462,83462,0
2021-06-09,1200013,202123,83465,83462,3
2021-06-09,1200344,202123,83465,83465,0
2021-06-09,1200138,202123,83467,83465,2
2021-06-09,1200336,202123,83467,83467,0
2021-06-09,1200351,202123,83467,83467,0
2021-06-09,1200302,202123,83467,83467,0
2021-06-09,1200807,202123,83468,83467,1
2021-06-09,1200393,202123,83468,83468,0
2021-06-09,1200401,202123,83487,83468,19
2021-06-09,1200427,202123,83487,83487,0
2021-06-09,1200435,202123,83487,83487,0
2021-06-09,1200500,202123,83487,83487,0
2021-06-09,1200450,202123,83487,83487,0
2021-06-09,1200609,202123,83487,83487,0
2021-06-09,1200708,202123,83488,83487,1
2021-06-10,1200013,202123,83479,83488,-9
2021-06-10,1200054,202123,83492,83479,13
2021-06-10,1200104,202123,83470,83492,-22
2021-06-10,1200138,202123,83472,83470,2
2021-06-10,1200179,202123,83472,83472,0
2021-06-10,1200609,202123,83437,83472,-35
2021-06-10,1200252,202123,83436,83437,-1
2021-06-10,1200302,202123,83473,83436,37
2021-06-10,1200328,202123,83529,83473,56
2021-06-10,1200344,202123,83526,83529,-3
2021-06-10,1200351,202123,83523,83526,-3
2021-06-10,1200336,202123,83552,83523,29
2021-06-10,1200385,202123,83578,83552,26
2021-06-10,1200807,202123,83582,83578,4
2021-06-10,1200393,202123,83584,83582,2
2021-06-10,1200401,202123,83621,83584,37
2021-06-10,1200427,202123,83633,83621,12
2021-06-10,1200435,202123,83649,83633,16
2021-06-10,1200500,202123,83662,83649,13
2021-06-10,1200450,202123,83658,83662,-4
2021-06-10,1200708,202123,83660,83658,2
2021-06-10,1200203,202123,83680,83660,20
2021-06-11,1200252,202123,83680,83680,0
2021-06-11,1200427,202123,83704,83680,24
2021-06-11,1200708,202123,83713,83704,9
2021-06-11,1200609,202123,83713,83713,0
2021-06-11,1200450,202123,83714,83713,1
2021-06-11,1200500,202123,83727,83714,13
2021-06-11,1200435,202123,83732,83727,5
2021-06-11,1200401,202123,83787,83732,55
2021-06-11,1200393,202123,83787,83787,0
2021-06-11,1200807,202123,83794,83787,7
2021-06-11,1200336,202123,83914,83794,120
2021-06-11,1200385,202123,83925,83914,11
2021-06-11,1200344,202123,83925,83925,0
2021-06-11,1200328,202123,83986,83925,61
2021-06-11,1200302,202123,83988,83986,2
2021-06-11,1200203,202123,84006,83988,18
2021-06-11,1200179,202123,84010,84006,4
2021-06-11,1200138,202123,84013,84010,3
2021-06-11,1200104,202123,84015,84013,2
2021-06-11,1200054,202123,84035,84015,20
2021-06-11,1200013,202123,84052,84035,17
2021-06-11,1200351,202123,84054,84052,2
2021-06-12,1200252,202123,84063,84054,9
2021-06-12,1200344,202123,84063,84063,0
2021-06-12,1200328,202123,84063,84063,0
2021-06-12,1200302,202123,84063,84063,0
2021-06-12,1200203,202123,84063,84063,0
2021-06-12,1200385,202123,84062,84063,-1
2021-06-12,1200138,202123,84064,84062,2
2021-06-12,1200104,202123,84083,84064,19
2021-06-12,1200013,202123,84083,84083,0
2021-06-12,1200351,202123,84083,84083,0
2021-06-12,1200179,202123,84082,84083,-1
2021-06-12,1200336,202123,84082,84082,0
2021-06-12,1200054,202123,84082,84082,0
2021-06-12,1200807,202123,84085,84082,3
2021-06-12,1200393,202123,84085,84085,0
2021-06-12,1200401,202123,84115,84085,30
2021-06-12,1200427,202123,84115,84115,0
2021-06-12,1200435,202123,84115,84115,0
2021-06-12,1200500,202123,84114,84115,-1
2021-06-12,1200450,202123,84115,84114,1
2021-06-12,1200609,202123,84119,84115,4
2021-06-12,1200708,202123,84119,84119,0
2021-06-13,1200708,202124,84123,84119,4
2021-06-13,1200013,202124,84125,84123,2
2021-06-13,1200054,202124,84125,84125,0
2021-06-13,1200104,202124,84129,84125,4
2021-06-13,1200138,202124,84129,84129,0
2021-06-13,1200179,202124,84130,84129,1
2021-06-13,1200203,202124,84130,84130,0
2021-06-13,1200807,202124,84135,84130,5
2021-06-13,1200450,202124,84135,84135,0
2021-06-13,1200500,202124,84137,84135,2
2021-06-13,1200435,202124,84137,84137,0
2021-06-13,1200427,202124,84137,84137,0
2021-06-13,1200401,202124,84172,84137,35
2021-06-13,1200393,202124,84172,84172,0
2021-06-13,1200252,202124,84173,84172,1
2021-06-13,1200609,202124,84175,84173,2
2021-06-13,1200336,202124,84175,84175,0
2021-06-13,1200351,202124,84175,84175,0
2021-06-13,1200344,202124,84175,84175,0
2021-06-13,1200328,202124,84175,84175,0
2021-06-13,1200302,202124,84188,84175,13
2021-06-13,1200385,202124,84189,84188,1
2021-06-14,1200054,202124,84200,84189,11
2021-06-14,1200013,202124,84209,84200,9
2021-06-14,1200104,202124,84219,84209,10
2021-06-14,1200708,202124,84219,84219,0
2021-06-14,1200450,202124,84220,84219,1
2021-06-14,1200500,202124,84227,84220,7
2021-06-14,1200435,202124,84236,84227,9
2021-06-14,1200427,202124,84241,84236,5
2021-06-14,1200401,202124,84264,84241,23
2021-06-14,1200393,202124,84264,84264,0
2021-06-14,1200807,202124,84265,84264,1
2021-06-14,1200385,202124,84269,84265,4
2021-06-14,1200336,202124,84284,84269,15
2021-06-14,1200351,202124,84288,84284,4
2021-06-14,1200344,202124,84288,84288,0
2021-06-14,1200328,202124,84326,84288,38
2021-06-14,1200302,202124,84325,84326,-1
2021-06-14,1200252,202124,84333,84325,8
2021-06-14,1200203,202124,84350,84333,17
2021-06-14,1200179,202124,84350,84350,0
2021-06-14,1200138,202124,84350,84350,0
2021-06-14,1200609,202124,84352,84350,2
2021-06-15,1200807,202124,84353,84352,1
2021-06-15,1200393,202124,84353,84353,0
2021-06-15,1200054,202124,84353,84353,0
2021-06-15,1200401,202124,84367,84353,14
2021-06-15,1200427,202124,84368,84367,1
2021-06-15,1200385,202124,84368,84368,0
2021-06-15,1200500,202124,84369,84368,1
2021-06-15,1200450,202124,84370,84369,1
2021-06-15,1200609,202124,84370,84370,0
2021-06-15,1200708,202124,84370,84370,0
2021-06-15,1200336,202124,84375,84370,5
2021-06-15,1200351,202124,84381,84375,6
2021-06-15,1200344,202124,84381,84381,0
2021-06-15,1200328,202124,84406,84381,25
2021-06-15,1200302,202124,84406,84406,0
2021-06-15,1200252,202124,84406,84406,0
2021-06-15,1200203,202124,84411,84406,5
2021-06-15,1200179,202124,84412,84411,1
2021-06-15,1200138,202124,84412,84412,0
2021-06-15,1200104,202124,84412,84412,0
2021-06-15,1200013,202124,84412,84412,0
2021-06-15,1200435,202124,84419,84412,7
2021-06-16,1200435,202124,84417,84419,-2
2021-06-16,1200708,202124,84414,84417,-3
2021-06-16,1200500,202124,84412,84414,-2
2021-06-16,1200427,202124,84412,84412,0
2021-06-16,1200401,202124,84436,84412,24
2021-06-16,1200393,202124,84436,84436,0
2021-06-16,1200807,202124,84448,84436,12
2021-06-16,1200385,202124,84448,84448,0
2021-06-16,1200336,202124,84448,84448,0
2021-06-16,1200351,202124,84449,84448,1
2021-06-16,1200344,202124,84449,84449,0
2021-06-16,1200328,202124,84452,84449,3
2021-06-16,1200302,202124,84451,84452,-1
2021-06-16,1200252,202124,84452,84451,1
2021-06-16,1200203,202124,84452,84452,0
2021-06-16,1200179,202124,84451,84452,-1
2021-06-16,1200138,202124,84453,84451,2
2021-06-16,1200104,202124,84456,84453,3
2021-06-16,1200054,202124,84460,84456,4
2021-06-16,1200450,202124,84461,84460,1
2021-06-16,1200609,202124,84461,84461,0
2021-06-16,1200013,202124,84465,84461,4
2021-06-17,1200336,202124,84464,84465,-1
2021-06-17,1200807,202124,84461,84464,-3
2021-06-17,1200393,202124,84461,84461,0
2021-06-17,1200401,202124,84488,84461,27
2021-06-17,1200427,202124,84487,84488,-1
2021-06-17,1200435,202124,84484,84487,-3
2021-06-17,1200500,202124,84482,84484,-2
2021-06-17,1200450,202124,84483,84482,1
2021-06-17,1200609,202124,84483,84483,0
2021-06-17,1200708,202124,84483,84483,0
2021-06-17,1200351,202124,84482,84483,-1
2021-06-17,1200344,202124,84482,84482,0
2021-06-17,1200328,202124,84483,84482,1
2021-06-17,1200302,202124,84482,84483,-1
2021-06-17,1200252,202124,84490,84482,8
2021-06-17,1200203,202124,84499,84490,9
2021-06-17,1200179,202124,84499,84499,0
2021-06-17,1200138,202124,84499,84499,0
2021-06-17,1200104,202124,84507,84499,8
2021-06-17,1200054,202124,84502,84507,-5
2021-06-17,1200013,202124,84502,84502,0
2021-06-17,1200385,202124,84502,84502,0
2021-06-18,1200336,202124,84544,84502,42
2021-06-18,1200427,202124,84546,84544,2
2021-06-18,1200708,202124,84546,84546,0
2021-06-18,1200609,202124,84549,84546,3
2021-06-18,1200450,202124,84554,84549,5
2021-06-18,1200500,202124,84558,84554,4
2021-06-18,1200435,202124,84563,84558,5
2021-06-18,1200401,202124,84601,84563,38
2021-06-18,1200393,202124,84601,84601,0
2021-06-18,1200807,202124,84611,84601,10
2021-06-18,1200351,202124,84612,84611,1
2021-06-18,1200385,202124,84623,84612,11
2021-06-18,1200328,202124,84624,84623,1
2021-06-18,1200302,202124,84644,84624,20
2021-06-18,1200252,202124,84649,84644,5
2021-06-18,1200203,202124,84666,84649,17
2021-06-18,1200179,202124,84671,84666,5
2021-06-18,1200138,202124,84671,84671,0
2021-06-18,1200104,202124,84684,84671,13
2021-06-18,1200054,202124,84696,84684,12
2021-06-18,1200013,202124,84702,84696,6
2021-06-18,1200344,202124,84702,84702,0
2021-06-19,1200203,202124,84712,84702,10
2021-06-19,1200344,202124,84712,84712,0
2021-06-19,1200328,202124,84712,84712,0
2021-06-19,1200302,202124,84719,84712,7
2021-06-19,1200179,202124,84719,84719,0
2021-06-19,1200385,202124,84720,84719,1
2021-06-19,1200104,202124,84723,84720,3
2021-06-19,1200054,202124,84736,84723,13
2021-06-19,1200013,202124,84740,84736,4
2021-06-19,1200351,202124,84741,84740,1
2021-06-19,1200138,202124,84741,84741,0
2021-06-19,1200336,202124,84755,84741,14
2021-06-19,1200252,202124,84759,84755,4
2021-06-19,1200393,202124,84759,84759,0
2021-06-19,1200401,202124,84799,84759,40
2021-06-19,1200427,202124,84801,84799,2
2021-06-19,1200435,202124,84807,84801,6
2021-06-19,1200500,202124,84814,84807,7
2021-06-19,1200450,202124,84815,84814,1
2021-06-19,1200609,202124,84816,84815,1
2021-06-19,1200708,202124,84815,84816,-1
2021-06-19,1200807,202124,84827,84815,12
2021-06-20,1200708,202125,84831,84827,4
2021-06-20,1200013,202125,84832,84831,1
2021-06-20,1200054,202125,84832,84832,0
2021-06-20,1200104,202125,84832,84832,0
2021-06-20,1200138,202125,84832,84832,0
2021-06-20,1200179,202125,84832,84832,0
2021-06-20,1200203,202125,84833,84832,1
2021-06-20,1200302,202125,84851,84833,18
2021-06-20,1200450,202125,84852,84851,1
2021-06-20,1200500,202125,84853,84852,1
2021-06-20,1200435,202125,84850,84853,-3
2021-06-20,1200427,202125,84850,84850,0
2021-06-20,1200401,202125,84866,84850,16
2021-06-20,1200252,202125,84866,84866,0
2021-06-20,1200393,202125,84866,84866,0
2021-06-20,1200385,202125,84866,84866,0
2021-06-20,1200336,202125,84865,84866,-1
2021-06-20,1200351,202125,84864,84865,-1
2021-06-20,1200344,202125,84864,84864,0
2021-06-20,1200328,202125,84863,84864,-1
2021-06-20,1200807,202125,84864,84863,1
2021-06-20,1200609,202125,84864,84864,0
2021-06-21,1200013,202125,84863,84864,-1
2021-06-21,1200054,202125,84863,84863,0
2021-06-21,1200104,202125,84870,84863,7
2021-06-21,1200179,202125,84870,84870,0
2021-06-21,1200252,202125,84876,84870,6
2021-06-21,1200302,202125,84876,84876,0
2021-06-21,1200328,202125,84876,84876,0
2021-06-21,1200344,202125,84876,84876,0
2021-06-21,1200351,202125,84876,84876,0
2021-06-21,1200336,202125,84880,84876,4
2021-06-21,1200385,202125,84885,84880,5
2021-06-21,1200807,202125,84885,84885,0
2021-06-21,1200393,202125,84886,84885,1
2021-06-21,1200401,202125,84921,84886,35
2021-06-21,1200427,202125,84921,84921,0
2021-06-21,1200435,202125,84923,84921,2
2021-06-21,1200500,202125,84925,84923,2
2021-06-21,1200203,202125,84926,84925,1
2021-06-21,1200450,202125,84926,84926,0
2021-06-21,1200609,202125,84931,84926,5
2021-06-21,1200708,202125,84932,84931,1
2021-06-21,1200138,202125,84933,84932,1
2021-06-22,1200013,202125,84931,84933,-2
2021-06-22,1200054,202125,84932,84931,1
2021-06-22,1200104,202125,84931,84932,-1
2021-06-22,1200138,202125,84931,84931,0
2021-06-22,1200179,202125,84931,84931,0
2021-06-22,1200203,202125,84931,84931,0
2021-06-22,1200252,202125,84934,84931,3
2021-06-22,1200302,202125,84934,84934,0
2021-06-22,1200328,202125,84932,84934,-2
2021-06-22,1200344,202125,84932,84932,0
2021-06-22,1200351,202125,84932,84932,0
2021-06-22,1200385,202125,84932,84932,0
2021-06-22,1200393,202125,84934,84932,2
2021-06-22,1200807,202125,84938,84934,4
2021-06-22,1200401,202125,84952,84938,14
2021-06-22,1200427,202125,84952,84952,0
2021-06-22,1200435,202125,84951,84952,-1
2021-06-22,1200500,202125,84957,84951,6
2021-06-22,1200450,202125,84956,84957,-1
2021-06-22,1200609,202125,84955,84956,-1
2021-06-22,1200708,202125,84953,84955,-2
2021-06-22,1200336,202125,84952,84953,-1
2021-06-23,1200013,202125,84963,84952,11
2021-06-23,1200054,202125,84970,84963,7
2021-06-23,1200104,202125,84995,84970,25
2021-06-23,1200138,202125,84995,84995,0
2021-06-23,1200179,202125,84995,84995,0
2021-06-23,1200203,202125,85001,84995,6
2021-06-23,1200708,202125,85003,85001,2
2021-06-23,1200328,202125,85003,85003,0
2021-06-23,1200344,202125,85003,85003,0
2021-06-23,1200351,202125,85003,85003,0
2021-06-23,1200336,202125,85011,85003,8
2021-06-23,1200385,202125,85016,85011,5
2021-06-23,1200807,202125,85018,85016,2
2021-06-23,1200393,202125,85018,85018,0
2021-06-23,1200401,202125,85034,85018,16
2021-06-23,1200427,202125,85034,85034,0
2021-06-23,1200435,202125,85039,85034,5
2021-06-23,1200500,202125,85039,85039,0
2021-06-23,1200450,202125,85042,85039,3
2021-06-23,1200609,202125,85045,85042,3
2021-06-23,1200302,202125,85045,85045,0
2021-06-23,1200252,202125,85058,85045,13
2021-06-24,1200435,202125,85059,85058,1
2021-06-24,1200393,202125,85059,85059,0
2021-06-24,1200708,202125,85057,85059,-2
2021-06-24,1200609,202125,85066,85057,9
2021-06-24,1200450,202125,85067,85066,1
2021-06-24,1200500,202125,85068,85067,1
2021-06-24,1200427,202125,85068,85068,0
2021-06-24,1200401,202125,85100,85068,32
2021-06-24,1200807,202125,85103,85100,3
2021-06-24,1200385,202125,85105,85103,2
2021-06-24,1200351,202125,85105,85105,0
2021-06-24,1200336,202125,85117,85105,12
2021-06-24,1200328,202125,85117,85117,0
2021-06-24,1200302,202125,85134,85117,17
2021-06-24,1200252,202125,85134,85134,0
2021-06-24,1200203,202125,85135,85134,1
2021-06-24,1200179,202125,85138,85135,3
2021-06-24,1200138,202125,85140,85138,2
2021-06-24,1200104,202125,85145,85140,5
2021-06-24,1200054,202125,85143,85145,-2
2021-06-24,1200013,202125,85143,85143,0
2021-06-24,1200344,202125,85143,85143,0
2021-06-25,1200203,202125,85143,85143,0
2021-06-25,1200302,202125,85149,85143,6
2021-06-25,1200252,202125,85160,85149,11
2021-06-25,1200179,202125,85160,85160,0
2021-06-25,1200351,202125,85167,85160,7
2021-06-25,1200104,202125,85176,85167,9
2021-06-25,1200054,202125,85186,85176,10
2021-06-25,1200013,202125,85187,85186,1
2021-06-25,1200328,202125,85187,85187,0
2021-06-25,1200138,202125,85188,85187,1
2021-06-25,1200336,202125,85188,85188,0
2021-06-25,1200344,202125,85188,85188,0
2021-06-25,1200385,202125,85189,85188,1
2021-06-25,1200807,202125,85194,85189,5
2021-06-25,1200393,202125,85194,85194,0
2021-06-25,1200401,202125,85252,85194,58
2021-06-25,1200427,202125,85252,85252,0
2021-06-25,1200435,202125,85252,85252,0
2021-06-25,1200500,202125,85265,85252,13
2021-06-25,1200450,202125,85267,85265,2
2021-06-25,1200609,202125,85284,85267,17
2021-06-25,1200708,202125,85288,85284,4
2021-06-26,1200013,202125,85290,85288,2
2021-06-26,1200054,202125,85302,85290,12
2021-06-26,1200104,202125,85305,85302,3
2021-06-26,1200138,202125,85305,85305,0
2021-06-26,1200179,202125,85305,85305,0
2021-06-26,1200609,202125,85307,85305,2
2021-06-26,1200252,202125,85308,85307,1
2021-06-26,1200302,202125,85307,85308,-1
2021-06-26,1200328,202125,85307,85307,0
2021-06-26,1200344,202125,85308,85307,1
2021-06-26,1200351,202125,85312,85308,4
2021-06-26,1200336,202125,85339,85312,27
2021-06-26,1200385,202125,85341,85339,2
2021-06-26,1200807,202125,85344,85341,3
2021-06-26,1200393,202125,85344,85344,0
2021-06-26,1200401,202125,85365,85344,21
2021-06-26,1200427,202125,85367,85365,2
2021-06-26,1200435,202125,85371,85367,4
2021-06-26,1200500,202125,85377,85371,6
2021-06-26,1200450,202125,85378,85377,1
2021-06-26,1200708,202125,85380,85378,2
2021-06-26,1200203,202125,85398,85380,18
2021-06-27,1200336,202126,85398,85398,0
2021-06-27,1200427,202126,85400,85398,2
2021-06-27,1200708,202126,85400,85400,0
2021-06-27,1200609,202126,85404,85400,4
2021-06-27,1200450,202126,85404,85404,0
2021-06-27,1200500,202126,85405,85404,1
2021-06-27,1200435,202126,85405,85405,0
2021-06-27,1200401,202126,85430,85405,25
2021-06-27,1200393,202126,85430,85430,0
2021-06-27,1200807,202126,85430,85430,0
2021-06-27,1200351,202126,85430,85430,0
2021-06-27,1200385,202126,85432,85430,2
2021-06-27,1200328,202126,85432,85432,0
2021-06-27,1200302,202126,85441,85432,9
2021-06-27,1200252,202126,85441,85441,0
2021-06-27,1200203,202126,85443,85441,2
2021-06-27,1200179,202126,85444,85443,1
2021-06-27,1200138,202126,85444,85444,0
2021-06-27,1200104,202126,85444,85444,0
2021-06-27,1200054,202126,85447,85444,3
2021-06-27,1200013,202126,85478,85447,31
2021-06-27,1200344,202126,85478,85478,0
2021-06-28,1200203,202126,85479,85478,1
2021-06-28,1200344,202126,85479,85479,0
2021-06-28,1200328,202126,85479,85479,0
2021-06-28,1200302,202126,85478,85479,-1
2021-06-28,1200179,202126,85477,85478,-1
2021-06-28,1200385,202126,85477,85477,0
2021-06-28,1200104,202126,85486,85477,9
2021-06-28,1200054,202126,85486,85486,0
2021-06-28,1200013,202126,85489,85486,3
2021-06-28,1200351,202126,85489,85489,0
2021-06-28,1200138,202126,85489,85489,0
2021-06-28,1200336,202126,85489,85489,0
2021-06-28,1200252,202126,85495,85489,6
2021-06-28,1200807,202126,85495,85495,0
2021-06-28,1200393,202126,85495,85495,0
2021-06-28,1200401,202126,85511,85495,16
2021-06-28,1200427,202126,85511,85511,0
2021-06-28,1200435,202126,85511,85511,0
2021-06-28,1200500,202126,85511,85511,0
2021-06-28,1200450,202126,85511,85511,0
2021-06-28,1200609,202126,85511,85511,0
2021-06-28,1200708,202126,85511,85511,0
2021-06-29,1200708,202126,85511,85511,0
2021-06-29,1200013,202126,85511,85511,0
2021-06-29,1200054,202126,85511,85511,0
2021-06-29,1200104,202126,85512,85511,1
2021-06-29,1200138,202126,85512,85512,0
2021-06-29,1200179,202126,85512,85512,0
2021-06-29,1200203,202126,85511,85512,-1
2021-06-29,1200807,202126,85513,85511,2
2021-06-29,1200450,202126,85513,85513,0
2021-06-29,1200500,202126,85515,85513,2
2021-06-29,1200435,202126,85515,85515,0
2021-06-29,1200427,202126,85515,85515,0
2021-06-29,1200401,202126,85540,85515,25
2021-06-29,1200393,202126,85540,85540,0
2021-06-29,1200252,202126,85541,85540,1
2021-06-29,1200609,202126,85541,85541,0
2021-06-29,1200336,202126,85541,85541,0
2021-06-29,1200351,202126,85541,85541,0
2021-06-29,1200344,202126,85541,85541,0
2021-06-29,1200328,202126,85541,85541,0
2021-06-29,1200302,202126,85541,85541,0
2021-06-29,1200385,202126,85541,85541,0
2021-06-30,1200054,202126,85541,85541,0
2021-06-30,1200013,202126,85541,85541,0
2021-06-30,1200104,202126,85541,85541,0
2021-06-30,1200708,202126,85541,85541,0
2021-06-30,1200450,202126,85541,85541,0
2021-06-30,1200500,202126,85541,85541,0
2021-06-30,1200435,202126,85541,85541,0
2021-06-30,1200427,202126,85541,85541,0
2021-06-30,1200401,202126,85562,85541,21
2021-06-30,1200393,202126,85562,85562,0
2021-06-30,1200807,202126,85565,85562,3
2021-06-30,1200385,202126,85565,85565,0
2021-06-30,1200336,202126,85565,85565,0
2021-06-30,1200351,202126,85565,85565,0
2021-06-30,1200344,202126,85565,85565,0
2021-06-30,1200328,202126,85565,85565,0
2021-06-30,1200302,202126,85565,85565,0
2021-06-30,1200252,202126,85569,85565,4
2021-06-30,1200203,202126,85569,85569,0
2021-06-30,1200179,202126,85569,85569,0
2021-06-30,1200138,202126,85569,85569,0
2021-06-30,1200609,202126,85571,85569,2
2021-07-01,1200807,202126,85574,85571,3
2021-07-01,1200393,202126,85575,85574,1
2021-07-01,1200054,202126,85563,85575,-12
2021-07-01,1200401,202126,85597,85563,34
2021-07-01,1200427,202126,85597,85597,0
2021-07-01,1200385,202126,85602,85597,5
2021-07-01,1200500,202126,85610,85602,8
2021-07-01,1200450,202126,85613,85610,3
2021-07-01,1200609,202126,85613,85613,0
2021-07-01,1200708,202126,85616,85613,3
2021-07-01,1200336,202126,85693,85616,77
2021-07-01,1200351,202126,85698,85693,5
2021-07-01,1200344,202126,85699,85698,1
2021-07-01,1200328,202126,85699,85699,0
2021-07-01,1200302,202126,85704,85699,5
2021-07-01,1200252,202126,85705,85704,1
2021-07-01,1200203,202126,85737,85705,32
2021-07-01,1200179,202126,85737,85737,0
2021-07-01,1200138,202126,85737,85737,0
2021-07-01,1200104,202126,85749,85737,12
2021-07-01,1200013,202126,85750,85749,1
2021-07-01,1200435,202126,85751,85750,1
2021-07-02,1200435,202126,85751,85751,0
2021-07-02,1200708,202126,85751,85751,0
2021-07-02,1200500,202126,85755,85751,4
2021-07-02,1200427,202126,85758,85755,3
2021-07-02,1200401,202126,85774,85758,16
2021-07-02,1200393,202126,85774,85774,0
2021-07-02,1200807,202126,85775,85774,1
2021-07-02,1200385,202126,85778,85775,3
2021-07-02,1200336,202126,85797,85778,19
2021-07-02,1200351,202126,85798,85797,1
2021-07-02,1200344,202126,85798,85798,0
2021-07-02,1200328,202126,85798,85798,0
2021-07-02,1200302,202126,85798,85798,0
2021-07-02,1200252,202126,85800,85798,2
2021-07-02,1200203,202126,85802,85800,2
2021-07-02,1200179,202126,85802,85802,0
2021-07-02,1200138,202126,85802,85802,0
2021-07-02,1200104,202126,85809,85802,7
2021-07-02,1200054,202126,85810,85809,1
2021-07-02,1200450,202126,85810,85810,0
2021-07-02,1200609,202126,85813,85810,3
2021-07-02,1200013,202126,85812,85813,-1
2021-07-03,1200336,202126,85838,85812,26
2021-07-03,1200807,202126,85841,85838,3
2021-07-03,1200393,202126,85841,85841,0
2021-07-03,1200401,202126,85859,85841,18
2021-07-03,1200427,202126,85859,85859,0
2021-07-03,1200435,202126,85859,85859,0
2021-07-03,1200500,202126,85859,85859,0
2021-07-03,1200450,202126,85859,85859,0
2021-07-03,1200609,202126,85856,85859,-3
2021-07-03,1200708,202126,85856,85856,0
2021-07-03,1200351,202126,85857,85856,1
2021-07-03,1200344,202126,85857,85857,0
2021-07-03,1200328,202126,85857,85857,0
2021-07-03,1200302,202126,85859,85857,2
2021-07-03,1200252,202126,85863,85859,4
2021-07-03,1200203,202126,85869,85863,6
2021-07-03,1200179,202126,85869,85869,0
2021-07-03,1200138,202126,85869,85869,0
2021-07-03,1200104,202126,85869,85869,0
2021-07-03,1200054,202126,85872,85869,3
2021-07-03,1200013,202126,85884,85872,12
2021-07-03,1200385,202126,85886,85884,2
2021-07-04,1200336,202127,85886,85886,0
2021-07-04,1200427,202127,85886,85886,0
2021-07-04,1200708,202127,85888,85886,2
2021-07-04,1200609,202127,85888,85888,0
2021-07-04,1200450,202127,85888,85888,0
2021-07-04,1200500,202127,85888,85888,0
2021-07-04,1200435,202127,85888,85888,0
2021-07-04,1200401,202127,85893,85888,5
2021-07-04,1200393,202127,85893,85893,0
2021-07-04,1200807,202127,85896,85893,3
2021-07-04,1200351,202127,85896,85896,0
2021-07-04,1200385,202127,85897,85896,1
2021-07-04,1200328,202127,85897,85897,0
2021-07-04,1200302,202127,85900,85897,3
2021-07-04,1200252,202127,85902,85900,2
2021-07-04,1200203,202127,85902,85902,0
2021-07-04,1200179,202127,85902,85902,0
2021-07-04,1200138,202127,85902,85902,0
2021-07-04,1200104,202127,85912,85902,10
2021-07-04,1200054,202127,85912,85912,0
2021-07-04,1200013,202127,85912,85912,0
2021-07-04,1200344,202127,85912,85912,0
2021-07-05,1200203,202127,85924,85912,12
2021-07-05,1200344,202127,85924,85924,0
2021-07-05,1200328,202127,85923,85924,-1
2021-07-05,1200302,202127,85930,85923,7
2021-07-05,1200179,202127,85930,85930,0
2021-07-05,1200385,202127,85931,85930,1
2021-07-05,1200104,202127,85931,85931,0
2021-07-05,1200054,202127,85933,85931,2
2021-07-05,1200013,202127,85937,85933,4
2021-07-05,1200351,202127,85938,85937,1
2021-07-05,1200138,202127,85938,85938,0
2021-07-05,1200336,202127,85971,85938,33
2021-07-05,1200252,202127,85973,85971,2
2021-07-05,1200393,202127,85973,85973,0
2021-07-05,1200401,202127,85992,85973,19
2021-07-05,1200427,202127,85995,85992,3
2021-07-05,1200435,202127,85995,85995,0
2021-07-05,1200500,202127,85998,85995,3
2021-07-05,1200450,202127,85998,85998,0
2021-07-05,1200609,202127,85995,85998,-3
2021-07-05,1200708,202127,85995,85995,0
2021-07-05,1200807,202127,85998,85995,3
2021-07-06,1200708,202127,85998,85998,0
2021-07-06,1200013,202127,85998,85998,0
2021-07-06,1200054,202127,85998,85998,0
2021-07-06,1200104,202127,85998,85998,0
2021-07-06,1200138,202127,85998,85998,0
2021-07-06,1200179,202127,85998,85998,0
2021-07-06,1200203,202127,85998,85998,0
2021-07-06,1200302,202127,85998,85998,0
2021-07-06,1200450,202127,85998,85998,0
2021-07-06,1200500,202127,85998,85998,0
2021-07-06,1200435,202127,85998,85998,0
2021-07-06,1200427,202127,85998,85998,0
2021-07-06,1200401,202127,86012,85998,14
2021-07-06,1200252,202127,86012,86012,0
2021-07-06,1200393,202127,86012,86012,0
2021-07-06,1200385,202127,86012,86012,0
2021-07-06,1200336,202127,86012,86012,0
2021-07-06,1200351,202127,86012,86012,0
2021-07-06,1200344,202127,86012,86012,0
2021-07-06,1200328,202127,86012,86012,0
2021-07-06,1200807,202127,86012,86012,0
2021-07-06,1200609,202127,86012,86012,0
2021-07-07,1200013,202127,86012,86012,0
2021-07-07,1200054,202127,86014,86012,2
2021-07-07,1200104,202127,86019,86014,5
2021-07-07,1200435,202127,86024,86019,5
2021-07-07,1200427,202127,86027,86024,3
2021-07-07,1200138,202127,86028,86027,1
2021-07-07,1200500,202127,86030,86028,2
2021-07-07,1200450,202127,86033,86030,3
2021-07-07,1200609,202127,86031,86033,-2
2021-07-07,1200708,202127,86032,86031,1
2021-07-07,1200807,202127,86033,86032,1
2021-07-07,1200385,202127,86035,86033,2
2021-07-07,1200336,202127,86079,86035,44
2021-07-07,1200351,202127,86082,86079,3
2021-07-07,1200344,202127,86082,86082,0
2021-07-07,1200328,202127,86082,86082,0
2021-07-07,1200302,202127,86090,86082,8
2021-07-07,1200252,202127,86096,86090,6
2021-07-07,1200203,202127,86103,86096,7
2021-07-07,1200179,202127,86103,86103,0
2021-07-07,1200401,202127,86135,86103,32
2021-07-07,1200393,202127,86135,86135,0
2021-07-08,1200385,202127,86139,86135,4
2021-07-08,1200393,202127,86139,86139,0
2021-07-08,1200054,202127,86143,86139,4
2021-07-08,1200104,202127,86143,86143,0
2021-07-08,1200807,202127,86147,86143,4
2021-07-08,1200138,202127,86147,86147,0
2021-07-08,1200179,202127,86149,86147,2
2021-07-08,1200203,202127,86158,86149,9
2021-07-08,1200252,202127,86159,86158,1
2021-07-08,1200302,202127,86202,86159,43
2021-07-08,1200328,202127,86202,86202,0
2021-07-08,1200344,202127,86205,86202,3
2021-07-08,1200013,202127,86207,86205,2
2021-07-08,1200351,202127,86211,86207,4
2021-07-08,1200336,202127,86265,86211,54
2021-07-08,1200427,202127,86288,86265,23
2021-07-08,1200500,202127,86291,86288,3
2021-07-08,1200450,202127,86291,86291,0
2021-07-08,1200609,202127,86291,86291,0
2021-07-08,1200708,202127,86291,86291,0
2021-07-08,1200401,202127,86308,86291,17
2021-07-08,1200435,202127,86311,86308,3
2021-07-09,1200013,202127,86323,86311,12
2021-07-09,1200054,202127,86323,86323,0
2021-07-09,1200104,202127,86323,86323,0
2021-07-09,1200138,202127,86323,86323,0
2021-07-09,1200179,202127,86325,86323,2
2021-07-09,1200203,202127,86340,86325,15
2021-07-09,1200252,202127,86348,86340,8
2021-07-09,1200328,202127,86348,86348,0
2021-07-09,1200302,202127,86346,86348,-2
2021-07-09,1200351,202127,86346,86346,0
2021-07-09,1200336,202127,86370,86346,24
2021-07-09,1200385,202127,86370,86370,0
2021-07-09,1200807,202127,86370,86370,0
2021-07-09,1200393,202127,86369,86370,-1
2021-07-09,1200401,202127,86387,86369,18
2021-07-09,1200427,202127,86392,86387,5
2021-07-09,1200435,202127,86408,86392,16
2021-07-09,1200500,202127,86412,86408,4
2021-07-09,1200450,202127,86414,86412,2
2021-07-09,1200609,202127,86414,86414,0
2021-07-09,1200708,202127,86415,86414,1
2021-07-09,1200344,202127,86415,86415,0
2021-07-10,1200104,202127,86424,86415,9
2021-07-10,1200179,202127,86425,86424,1
2021-07-10,1200138,202127,86425,86425,0
2021-07-10,1200013,202127,86427,86425,2
2021-07-10,1200054,202127,86427,86427,0
2021-07-10,1200609,202127,86427,86427,0
2021-07-10,1200450,202127,86427,86427,0
2021-07-10,1200500,202127,86427,86427,0
2021-07-10,1200435,202127,86427,86427,0
2021-07-10,1200427,202127,86427,86427,0
2021-07-10,1200401,202127,86447,86427,20
2021-07-10,1200393,202127,86447,86447,0
2021-07-10,1200708,202127,86449,86447,2
2021-07-10,1200807,202127,86450,86449,1
2021-07-10,1200336,202127,86452,86450,2
2021-07-10,1200351,202127,86455,86452,3
2021-07-10,1200344,202127,86455,86455,0
2021-07-10,1200328,202127,86455,86455,0
2021-07-10,1200302,202127,86457,86455,2
2021-07-10,1200252,202127,86467,86457,10
2021-07-10,1200385,202127,86468,86467,1
2021-07-10,1200203,202127,86469,86468,1
2021-07-11,1200427,202128,86469,86469,0
2021-07-11,1200393,202128,86469,86469,0
2021-07-11,1200054,202128,86469,86469,0
2021-07-11,1200104,202128,86470,86469,1
2021-07-11,1200138,202128,86471,86470,1
2021-07-11,1200179,202128,86471,86471,0
2021-07-11,1200203,202128,86470,86471,-1
2021-07-11,1200252,202128,86472,86470,2
2021-07-11,1200302,202128,86473,86472,1
2021-07-11,1200328,202128,86473,86473,0
2021-07-11,1200344,202128,86473,86473,0
2021-07-11,1200351,202128,86475,86473,2
2021-07-11,1200336,202128,86468,86475,-7
2021-07-11,1200385,202128,86468,86468,0
2021-07-11,1200013,202128,86468,86468,0
2021-07-11,1200807,202128,86469,86468,1
2021-07-11,1200401,202128,86476,86469,7
2021-07-11,1200500,202128,86480,86476,4
2021-07-11,1200450,202128,86480,86480,0
2021-07-11,1200609,202128,86480,86480,0
2021-07-11,1200708,202128,86482,86480,2
2021-07-11,1200435,202128,86482,86482,0
2021-07-12,1200344,202128,86482,86482,0
2021-07-12,1200104,202128,86483,86482,1
2021-07-12,1200138,202128,86483,86483,0
2021-07-12,1200179,202128,86483,86483,0
2021-07-12,1200203,202128,86485,86483,2
2021-07-12,1200252,202128,86488,86485,3
2021-07-12,1200302,202128,86491,86488,3
2021-07-12,1200328,202128,86491,86491,0
2021-07-12,1200351,202128,86491,86491,0
2021-07-12,1200385,202128,86491,86491,0
2021-07-12,1200054,202128,86491,86491,0
2021-07-12,1200807,202128,86491,86491,0
2021-07-12,1200393,202128,86491,86491,0
2021-07-12,1200401,202128,86495,86491,4
2021-07-12,1200427,202128,86495,86495,0
2021-07-12,1200435,202128,86495,86495,0
2021-07-12,1200500,202128,86496,86495,1
2021-07-12,1200450,202128,86496,86496,0
2021-07-12,1200609,202128,86496,86496,0
2021-07-12,1200708,202128,86496,86496,0
2021-07-12,1200336,202128,86496,86496,0
2021-07-12,1200013,202128,86496,86496,0
2021-07-13,1200252,202128,86497,86496,1
2021-07-13,1200013,202128,86497,86497,0
2021-07-13,1200054,202128,86497,86497,0
2021-07-13,1200203,202128,86497,86497,0
2021-07-13,1200179,202128,86497,86497,0
2021-07-13,1200104,202128,86497,86497,0
2021-07-13,1200138,202128,86497,86497,0
2021-07-13,1200393,202128,86497,86497,0
2021-07-13,1200302,202128,86498,86497,1
2021-07-13,1200328,202128,86498,86498,0
2021-07-13,1200344,202128,86498,86498,0
2021-07-13,1200351,202128,86498,86498,0
2021-07-13,1200336,202128,86498,86498,0
2021-07-13,1200385,202128,86498,86498,0
2021-07-13,1200807,202128,86498,86498,0
2021-07-13,1200708,202128,86498,86498,0
2021-07-13,1200401,202128,86507,86498,9
2021-07-13,1200427,202128,86507,86507,0
2021-07-13,1200435,202128,86507,86507,0
2021-07-13,1200500,202128,86507,86507,0
2021-07-13,1200450,202128,86507,86507,0
2021-07-13,1200609,202128,86507,86507,0
2021-07-14,1200500,202128,86510,86507,3
2021-07-14,1200013,202128,86511,86510,1
2021-07-14,1200435,202128,86513,86511,2
2021-07-14,1200054,202128,86521,86513,8
2021-07-14,1200138,202128,86522,86521,1
2021-07-14,1200427,202128,86523,86522,1
2021-07-14,1200609,202128,86524,86523,1
2021-07-14,1200708,202128,86524,86524,0
2021-07-14,1200401,202128,86536,86524,12
2021-07-14,1200393,202128,86536,86536,0
2021-07-14,1200807,202128,86538,86536,2
2021-07-14,1200385,202128,86542,86538,4
2021-07-14,1200336,202128,86542,86542,0
2021-07-14,1200351,202128,86542,86542,0
2021-07-14,1200344,202128,86542,86542,0
2021-07-14,1200328,202128,86542,86542,0
2021-07-14,1200302,202128,86543,86542,1
2021-07-14,1200252,202128,86546,86543,3
2021-07-14,1200203,202128,86551,86546,5
2021-07-14,1200179,202128,86551,86551,0
2021-07-14,1200104,202128,86558,86551,7
2021-07-14,1200450,202128,86559,86558,1
2021-07-15,1200807,202128,86558,86559,-1
2021-07-15,1200401,202128,86571,86558,13
2021-07-15,1200708,202128,86571,86571,0
2021-07-15,1200609,202128,86570,86571,-1
2021-07-15,1200450,202128,86571,86570,1
2021-07-15,1200500,202128,86571,86571,0
2021-07-15,1200435,202128,86571,86571,0
2021-07-15,1200427,202128,86576,86571,5
2021-07-15,1200393,202128,86576,86576,0
2021-07-15,1200385,202128,86579,86576,3
2021-07-15,1200351,202128,86580,86579,1
2021-07-15,1200336,202128,86589,86580,9
2021-07-15,1200328,202128,86589,86589,0
2021-07-15,1200302,202128,86596,86589,7
2021-07-15,1200252,202128,86603,86596,7
2021-07-15,1200203,202128,86606,86603,3
2021-07-15,1200179,202128,86607,86606,1
2021-07-15,1200138,202128,86607,86607,0
2021-07-15,1200104,202128,86607,86607,0
2021-07-15,1200054,202128,86610,86607,3
2021-07-15,1200013,202128,86610,86610,0
2021-07-15,1200344,202128,86610,86610,0
2021-07-16,1200203,202128,86617,86610,7
2021-07-16,1200302,202128,86617,86617,0
2021-07-16,1200252,202128,86618,86617,1
2021-07-16,1200179,202128,86621,86618,3
2021-07-16,1200385,202128,86628,86621,7
2021-07-16,1200104,202128,86631,86628,3
2021-07-16,1200054,202128,86638,86631,7
2021-07-16,1200013,202128,86638,86638,0
2021-07-16,1200344,202128,86638,86638,0
2021-07-16,1200138,202128,86638,86638,0
2021-07-16,1200336,202128,86638,86638,0
2021-07-16,1200351,202128,86639,86638,1
2021-07-16,1200328,202128,86639,86639,0
2021-07-16,1200807,202128,86640,86639,1
2021-07-16,1200393,202128,86640,86640,0
2021-07-16,1200401,202128,86651,86640,11
2021-07-16,1200427,202128,86655,86651,4
2021-07-16,1200435,202128,86656,86655,1
2021-07-16,1200500,202128,86658,86656,2
2021-07-16,1200450,202128,86659,86658,1
2021-07-16,1200609,202128,86657,86659,-2
2021-07-16,1200708,202128,86659,86657,2
2021-07-17,1200013,202128,86659,86659,0
2021-07-17,1200054,202128,86659,86659,0
2021-07-17,1200104,202128,86660,86659,1
2021-07-17,1200138,202128,86660,86660,0
2021-07-17,1200179,202128,86662,86660,2
2021-07-17,1200609,202128,86662,86662,0
2021-07-17,1200252,202128,86664,86662,2
2021-07-17,1200302,202128,86664,86664,0
2021-07-17,1200328,202128,86664,86664,0
2021-07-17,1200344,202128,86664,86664,0
2021-07-17,1200351,202128,86663,86664,-1
2021-07-17,1200336,202128,86663,86663,0
2021-07-17,1200385,202128,86663,86663,0
2021-07-17,1200807,202128,86664,86663,1
2021-07-17,1200393,202128,86664,86664,0
2021-07-17,1200401,202128,86677,86664,13
2021-07-17,1200427,202128,86677,86677,0
2021-07-17,1200435,202128,86677,86677,0
2021-07-17,1200500,202128,86677,86677,0
2021-07-17,1200450,202128,86678,86677,1
2021-07-17,1200708,202128,86678,86678,0
2021-07-17,1200203,202128,86679,86678,1
2021-07-18,1200500,202129,86680,86679,1
2021-07-18,1200401,202129,86690,86680,10
2021-07-18,1200708,202129,86691,86690,1
2021-07-18,1200609,202129,86691,86691,0
2021-07-18,1200450,202129,86692,86691,1
2021-07-18,1200435,202129,86692,86692,0
2021-07-18,1200427,202129,86692,86692,0
2021-07-18,1200393,202129,86692,86692,0
2021-07-18,1200807,202129,86692,86692,0
2021-07-18,1200385,202129,86692,86692,0
2021-07-18,1200351,202129,86692,86692,0
2021-07-18,1200336,202129,86692,86692,0
2021-07-18,1200328,202129,86692,86692,0
2021-07-18,1200302,202129,86695,86692,3
2021-07-18,1200252,202129,86696,86695,1
2021-07-18,1200203,202129,86695,86696,-1
2021-07-18,1200179,202129,86695,86695,0
2021-07-18,1200138,202129,86695,86695,0
2021-07-18,1200104,202129,86695,86695,0
2021-07-18,1200054,202129,86695,86695,0
2021-07-18,1200013,202129,86695,86695,0
2021-07-18,1200344,202129,86695,86695,0
2021-07-19,1200203,202129,86697,86695,2
2021-07-19,1200328,202129,86697,86697,0
2021-07-19,1200302,202129,86712,86697,15
2021-07-19,1200252,202129,86712,86712,0
2021-07-19,1200179,202129,86713,86712,1
2021-07-19,1200385,202129,86714,86713,1
2021-07-19,1200104,202129,86716,86714,2
2021-07-19,1200054,202129,86714,86716,-2
2021-07-19,1200013,202129,86714,86714,0
2021-07-19,1200344,202129,86714,86714,0
2021-07-19,1200138,202129,86714,86714,0
2021-07-19,1200336,202129,86725,86714,11
2021-07-19,1200807,202129,86725,86725,0
2021-07-19,1200393,202129,86725,86725,0
2021-07-19,1200401,202129,86735,86725,10
2021-07-19,1200427,202129,86736,86735,1
2021-07-19,1200435,202129,86736,86736,0
2021-07-19,1200500,202129,86738,86736,2
2021-07-19,1200450,202129,86738,86738,0
2021-07-19,1200609,202129,86737,86738,-1
2021-07-19,1200708,202129,86739,86737,2
2021-07-19,1200351,202129,86744,86739,5
2021-07-20,1200708,202129,86744,86744,0
2021-07-20,1200013,202129,86744,86744,0
2021-07-20,1200054,202129,86744,86744,0
2021-07-20,1200104,202129,86746,86744,2
2021-07-20,1200138,202129,86746,86746,0
2021-07-20,1200179,202129,86746,86746,0
2021-07-20,1200203,202129,86747,86746,1
2021-07-20,1200302,202129,86747,86747,0
2021-07-20,1200450,202129,86747,86747,0
2021-07-20,1200500,202129,86749,86747,2
2021-07-20,1200435,202129,86749,86749,0
2021-07-20,1200427,202129,86749,86749,0
2021-07-20,1200401,202129,86755,86749,6
2021-07-20,1200252,202129,86757,86755,2
2021-07-20,1200393,202129,86757,86757,0
2021-07-20,1200385,202129,86757,86757,0
2021-07-20,1200336,202129,86757,86757,0
2021-07-20,1200351,202129,86757,86757,0
2021-07-20,1200344,202129,86757,86757,0
2021-07-20,1200328,202129,86757,86757,0
2021-07-20,1200807,202129,86757,86757,0
2021-07-20,1200609,202129,86758,86757,1
2021-07-21,1200013,202129,86758,86758,0
2021-07-21,1200054,202129,86758,86758,0
2021-07-21,1200104,202129,86760,86758,2
2021-07-21,1200708,202129,86759,86760,-1
2021-07-21,1200450,202129,86759,86759,0
2021-07-21,1200500,202129,86760,86759,1
2021-07-21,1200435,202129,86760,86760,0
2021-07-21,1200427,202129,86770,86760,10
2021-07-21,1200401,202129,86776,86770,6
2021-07-21,1200393,202129,86776,86776,0
2021-07-21,1200807,202129,86776,86776,0
2021-07-21,1200385,202129,86775,86776,-1
2021-07-21,1200336,202129,86775,86775,0
2021-07-21,1200351,202129,86773,86775,-2
2021-07-21,1200344,202129,86773,86773,0
2021-07-21,1200328,202129,86773,86773,0
2021-07-21,1200302,202129,86771,86773,-2
2021-07-21,1200252,202129,86771,86771,0
2021-07-21,1200203,202129,86772,86771,1
2021-07-21,1200179,202129,86773,86772,1
2021-07-21,1200138,202129,86773,86773,0
2021-07-21,1200609,202129,86772,86773,-1
2021-07-22,1200807,202129,86774,86772,2
2021-07-22,1200393,202129,86774,86774,0
2021-07-22,1200054,202129,86774,86774,0
2021-07-22,1200401,202129,86789,86774,15
2021-07-22,1200427,202129,86794,86789,5
2021-07-22,1200385,202129,86796,86794,2
2021-07-22,1200500,202129,86797,86796,1
2021-07-22,1200450,202129,86799,86797,2
2021-07-22,1200609,202129,86797,86799,-2
2021-07-22,1200708,202129,86799,86797,2
2021-07-22,1200336,202129,86808,86799,9
2021-07-22,1200351,202129,86808,86808,0
2021-07-22,1200344,202129,86808,86808,0
2021-07-22,1200328,202129,86808,86808,0
2021-07-22,1200302,202129,86819,86808,11
2021-07-22,1200252,202129,86822,86819,3
2021-07-22,1200203,202129,86857,86822,35
2021-07-22,1200179,202129,86858,86857,1
2021-07-22,1200138,202129,86858,86858,0
2021-07-22,1200104,202129,86858,86858,0
2021-07-22,1200013,202129,86859,86858,1
2021-07-22,1200435,202129,86859,86859,0
2021-07-23,1200336,202129,86859,86859,0
2021-07-23,1200401,202129,86864,86859,5
2021-07-23,1200708,202129,86866,86864,2
2021-07-23,1200609,202129,86866,86866,0
2021-07-23,1200450,202129,86866,86866,0
2021-07-23,1200500,202129,86866,86866,0
2021-07-23,1200435,202129,86866,86866,0
2021-07-23,1200427,202129,86866,86866,0
2021-07-23,1200393,202129,86866,86866,0
2021-07-23,1200807,202129,86866,86866,0
2021-07-23,1200351,202129,86866,86866,0
2021-07-23,1200385,202129,86866,86866,0
2021-07-23,1200328,202129,86866,86866,0
2021-07-23,1200302,202129,86866,86866,0
2021-07-23,1200252,202129,86868,86866,2
2021-07-23,1200203,202129,86868,86868,0
2021-07-23,1200179,202129,86868,86868,0
2021-07-23,1200138,202129,86868,86868,0
2021-07-23,1200104,202129,86868,86868,0
2021-07-23,1200054,202129,86870,86868,2
2021-07-23,1200013,202129,86870,86870,0
2021-07-23,1200344,202129,86870,86870,0
2021-07-24,1200203,202129,86883,86870,13
2021-07-24,1200328,202129,86883,86883,0
2021-07-24,1200302,202129,86892,86883,9
2021-07-24,1200179,202129,86892,86892,0
2021-07-24,1200385,202129,86892,86892,0
2021-07-24,1200104,202129,86893,86892,1
2021-07-24,1200054,202129,86896,86893,3
2021-07-24,1200013,202129,86900,86896,4
2021-07-24,1200344,202129,86900,86900,0
2021-07-24,1200138,202129,86900,86900,0
2021-07-24,1200336,202129,86906,86900,6
2021-07-24,1200351,202129,86908,86906,2
2021-07-24,1200252,202129,86915,86908,7
2021-07-24,1200807,202129,86915,86915,0
2021-07-24,1200393,202129,86915,86915,0
2021-07-24,1200401,202129,86923,86915,8
2021-07-24,1200427,202129,86935,86923,12
2021-07-24,1200435,202129,86937,86935,2
2021-07-24,1200500,202129,86940,86937,3
2021-07-24,1200450,202129,86944,86940,4
2021-07-24,1200609,202129,86950,86944,6
2021-07-24,1200708,202129,86951,86950,1
2021-07-25,1200013,202130,86951,86951,0
2021-07-25,1200054,202130,86951,86951,0
2021-07-25,1200104,202130,86953,86951,2
2021-07-25,1200138,202130,86953,86953,0
2021-07-25,1200179,202130,86953,86953,0
2021-07-25,1200609,202130,86953,86953,0
2021-07-25,1200252,202130,86952,86953,-1
2021-07-25,1200302,202130,86951,86952,-1
2021-07-25,1200328,202130,86951,86951,0
2021-07-25,1200344,202130,86951,86951,0
2021-07-25,1200351,202130,86951,86951,0
2021-07-25,1200336,202130,86951,86951,0
2021-07-25,1200385,202130,86951,86951,0
2021-07-25,1200807,202130,86953,86951,2
2021-07-25,1200393,202130,86953,86953,0
2021-07-25,1200401,202130,86963,86953,10
2021-07-25,1200427,202130,86963,86963,0
2021-07-25,1200435,202130,86963,86963,0
2021-07-25,1200500,202130,86964,86963,1
2021-07-25,1200450,202130,86964,86964,0
2021-07-25,1200708,202130,86968,86964,4
2021-07-25,1200203,202130,86967,86968,-1
2021-07-26,1200500,202130,86968,86967,1
2021-07-26,1200054,202130,86968,86968,0
2021-07-26,1200708,202130,86965,86968,-3
2021-07-26,1200609,202130,86965,86965,0
2021-07-26,1200450,202130,86965,86965,0
2021-07-26,1200435,202130,86965,86965,0
2021-07-26,1200401,202130,86970,86965,5
2021-07-26,1200393,202130,86970,86970,0
2021-07-26,1200807,202130,86971,86970,1
2021-07-26,1200385,202130,86971,86971,0
2021-07-26,1200336,202130,86984,86971,13
2021-07-26,1200427,202130,86991,86984,7
2021-07-26,1200344,202130,86991,86991,0
2021-07-26,1200328,202130,86991,86991,0
2021-07-26,1200302,202130,86989,86991,-2
2021-07-26,1200252,202130,86990,86989,1
2021-07-26,1200203,202130,86990,86990,0
2021-07-26,1200179,202130,86990,86990,0
2021-07-26,1200138,202130,86990,86990,0
2021-07-26,1200104,202130,86990,86990,0
2021-07-26,1200013,202130,87002,86990,12
2021-07-26,1200351,202130,87002,87002,0
2021-07-27,1200344,202130,87002,87002,0
2021-07-27,1200328,202130,87002,87002,0
2021-07-27,1200302,202130,87002,87002,0
2021-07-27,1200252,202130,87004,87002,2
2021-07-27,1200203,202130,87004,87004,0
2021-07-27,1200013,202130,87006,87004,2
2021-07-27,1200138,202130,87006,87006,0
2021-07-27,1200104,202130,87006,87006,0
2021-07-27,1200054,202130,87006,87006,0
2021-07-27,1200351,202130,87006,87006,0
2021-07-27,1200179,202130,87007,87006,1
2021-07-27,1200336,202130,87007,87007,0
2021-07-27,1200385,202130,87007,87007,0
2021-07-27,1200393,202130,87007,87007,0
2021-07-27,1200401,202130,87012,87007,5
2021-07-27,1200427,202130,87012,87012,0
2021-07-27,1200435,202130,87012,87012,0
2021-07-27,1200500,202130,87013,87012,1
2021-07-27,1200450,202130,87014,87013,1
2021-07-27,1200609,202130,87014,87014,0
2021-07-27,1200708,202130,87014,87014,0
2021-07-27,1200807,202130,87014,87014,0
2021-07-28,1200708,202130,87014,87014,0
2021-07-28,1200013,202130,87017,87014,3
2021-07-28,1200054,202130,87017,87017,0
2021-07-28,1200104,202130,87017,87017,0
2021-07-28,1200138,202130,87017,87017,0
2021-07-28,1200179,202130,87017,87017,0
2021-07-28,1200203,202130,87028,87017,11
2021-07-28,1200302,202130,87028,87028,0
2021-07-28,1200450,202130,87029,87028,1
2021-07-28,1200500,202130,87029,87029,0
2021-07-28,1200435,202130,87029,87029,0
2021-07-28,1200427,202130,87042,87029,13
2021-07-28,1200401,202130,87052,87042,10
2021-07-28,1200252,202130,87058,87052,6
2021-07-28,1200393,202130,87058,87058,0
2021-07-28,1200385,202130,87063,87058,5
2021-07-28,1200336,202130,87062,87063,-1
2021-07-28,1200351,202130,87067,87062,5
2021-07-28,1200344,202130,87067,87067,0
2021-07-28,1200328,202130,87067,87067,0
2021-07-28,1200807,202130,87068,87067,1
2021-07-28,1200609,202130,87068,87068,0
2021-07-29,1200013,202130,87068,87068,0
2021-07-29,1200054,202130,87068,87068,0
2021-07-29,1200104,202130,87068,87068,0
2021-07-29,1200179,202130,87068,87068,0
2021-07-29,1200252,202130,87068,87068,0
2021-07-29,1200302,202130,87069,87068,1
2021-07-29,1200328,202130,87069,87069,0
2021-07-29,1200344,202130,87069,87069,0
2021-07-29,1200351,202130,87069,87069,0
2021-07-29,1200336,202130,87069,87069,0
2021-07-29,1200385,202130,87070,87069,1
2021-07-29,1200807,202130,87070,87070,0
2021-07-29,1200393,202130,87071,87070,1
2021-07-29,1200401,202130,87076,87071,5
2021-07-29,1200427,202130,87083,87076,7
2021-07-29,1200435,202130,87083,87083,0
2021-07-29,1200500,202130,87085,87083,2
2021-07-29,1200203,202130,87086,87085,1
2021-07-29,1200450,202130,87087,87086,1
2021-07-29,1200609,202130,87087,87087,0
2021-07-29,1200708,202130,87088,87087,1
2021-07-29,1200138,202130,87088,87088,0
2021-07-30,1200013,202130,87092,87088,4
2021-07-30,1200054,202130,87092,87092,0
2021-07-30,1200104,202130,87093,87092,1
2021-07-30,1200138,202130,87093,87093,0
2021-07-30,1200179,202130,87093,87093,0
2021-07-30,1200203,202130,87096,87093,3
2021-07-30,1200252,202130,87097,87096,1
2021-07-30,1200302,202130,87097,87097,0
2021-07-30,1200328,202130,87097,87097,0
2021-07-30,1200344,202130,87097,87097,0
2021-07-30,1200351,202130,87100,87097,3
2021-07-30,1200385,202130,87100,87100,0
2021-07-30,1200393,202130,87100,87100,0
2021-07-30,1200807,202130,87101,87100,1
2021-07-30,1200401,202130,87106,87101,5
2021-07-30,1200427,202130,87106,87106,0
2021-07-30,1200435,202130,87110,87106,4
2021-07-30,1200500,202130,87113,87110,3
2021-07-30,1200450,202130,87113,87113,0
2021-07-30,1200609,202130,87141,87113,28
2021-07-30,1200708,202130,87142,87141,1
2021-07-30,1200336,202130,87143,87142,1
2021-07-31,1200013,202130,87143,87143,0
2021-07-31,1200054,202130,87143,87143,0
2021-07-31,1200104,202130,87150,87143,7
2021-07-31,1200138,202130,87150,87150,0
2021-07-31,1200179,202130,87150,87150,0
2021-07-31,1200203,202130,87150,87150,0
2021-07-31,1200708,202130,87150,87150,0
2021-07-31,1200328,202130,87150,87150,0
2021-07-31,1200344,202130,87150,87150,0
2021-07-31,1200351,202130,87150,87150,0
2021-07-31,1200336,202130,87150,87150,0
2021-07-31,1200385,202130,87150,87150,0
2021-07-31,1200807,202130,87150,87150,0
2021-07-31,1200393,202130,87150,87150,0
2021-07-31,1200401,202130,87155,87150,5
2021-07-31,1200427,202130,87155,87155,0
2021-07-31,1200435,202130,87155,87155,0
2021-07-31,1200500,202130,87155,87155,0
2021-07-31,1200450,202130,87155,87155,0
2021-07-31,1200609,202130,87155,87155,0
2021-07-31,1200302,202130,87155,87155,0
2021-07-31,1200252,202130,87156,87155,1
2021-08-01,1200435,202131,87156,87156,0
2021-08-01,1200393,202131,87156,87156,0
2021-08-01,1200708,202131,87158,87156,2
2021-08-01,1200609,202131,87158,87158,0
2021-08-01,1200450,202131,87158,87158,0
2021-08-01,1200500,202131,87158,87158,0
2021-08-01,1200427,202131,87158,87158,0
2021-08-01,1200401,202131,87159,87158,1
2021-08-01,1200807,202131,87160,87159,1
2021-08-01,1200385,202131,87160,87160,0
2021-08-01,1200351,202131,87160,87160,0
2021-08-01,1200336,202131,87160,87160,0
2021-08-01,1200328,202131,87160,87160,0
2021-08-01,1200302,202131,87160,87160,0
2021-08-01,1200252,202131,87160,87160,0
2021-08-01,1200203,202131,87160,87160,0
2021-08-01,1200179,202131,87160,87160,0
2021-08-01,1200138,202131,87160,87160,0
2021-08-01,1200104,202131,87162,87160,2
2021-08-01,1200054,202131,87162,87162,0
2021-08-01,1200013,202131,87162,87162,0
2021-08-01,1200344,202131,87162,87162,0
2021-08-02,1200203,202131,87164,87162,2
2021-08-02,1200302,202131,87168,87164,4
2021-08-02,1200252,202131,87166,87168,-2
2021-08-02,1200179,202131,87167,87166,1
2021-08-02,1200351,202131,87165,87167,-2
2021-08-02,1200104,202131,87165,87165,0
2021-08-02,1200054,202131,87165,87165,0
2021-08-02,1200013,202131,87168,87165,3
2021-08-02,1200328,202131,87168,87168,0
2021-08-02,1200138,202131,87168,87168,0
2021-08-02,1200336,202131,87166,87168,-2
2021-08-02,1200344,202131,87166,87166,0
2021-08-02,1200385,202131,87167,87166,1
2021-08-02,1200807,202131,87167,87167,0
2021-08-02,1200393,202131,87167,87167,0
2021-08-02,1200401,202131,87169,87167,2
2021-08-02,1200427,202131,87168,87169,-1
2021-08-02,1200435,202131,87169,87168,1
2021-08-02,1200500,202131,87169,87169,0
2021-08-02,1200450,202131,87169,87169,0
2021-08-02,1200609,202131,87202,87169,33
2021-08-02,1200708,202131,87201,87202,-1
2021-08-03,1200013,202131,87201,87201,0
2021-08-03,1200054,202131,87201,87201,0
2021-08-03,1200104,202131,87201,87201,0
2021-08-03,1200138,202131,87201,87201,0
2021-08-03,1200179,202131,87201,87201,0
2021-08-03,1200609,202131,87201,87201,0
2021-08-03,1200252,202131,87201,87201,0
2021-08-03,1200302,202131,87201,87201,0
2021-08-03,1200328,202131,87201,87201,0
2021-08-03,1200344,202131,87201,87201,0
2021-08-03,1200351,202131,87201,87201,0
2021-08-03,1200336,202131,87201,87201,0
2021-08-03,1200385,202131,87201,87201,0
2021-08-03,1200807,202131,87201,87201,0
2021-08-03,1200393,202131,87201,87201,0
2021-08-03,1200401,202131,87202,87201,1
2021-08-03,1200427,202131,87202,87202,0
2021-08-03,1200435,202131,87202,87202,0
2021-08-03,1200500,202131,87202,87202,0
2021-08-03,1200450,202131,87202,87202,0
2021-08-03,1200708,202131,87202,87202,0
2021-08-03,1200203,202131,87203,87202,1
2021-08-04,1200336,202131,87203,87203,0
2021-08-04,1200427,202131,87216,87203,13
2021-08-04,1200708,202131,87216,87216,0
2021-08-04,1200609,202131,87221,87216,5
2021-08-04,1200450,202131,87221,87221,0
2021-08-04,1200500,202131,87221,87221,0
2021-08-04,1200435,202131,87221,87221,0
2021-08-04,1200401,202131,87227,87221,6
2021-08-04,1200393,202131,87227,87227,0
2021-08-04,1200807,202131,87227,87227,0
2021-08-04,1200351,202131,87227,87227,0
2021-08-04,1200385,202131,87227,87227,0
2021-08-04,1200328,202131,87227,87227,0
2021-08-04,1200302,202131,87227,87227,0
2021-08-04,1200252,202131,87227,87227,0
2021-08-04,1200203,202131,87229,87227,2
2021-08-04,1200179,202131,87232,87229,3
2021-08-04,1200138,202131,87232,87232,0
2021-08-04,1200104,202131,87232,87232,0
2021-08-04,1200054,202131,87232,87232,0
2021-08-04,1200013,202131,87247,87232,15
2021-08-04,1200344,202131,87247,87247,0
2021-08-05,1200203,202131,87251,87247,4
2021-08-05,1200344,202131,87251,87251,0
2021-08-05,1200328,202131,87251,87251,0
2021-08-05,1200302,202131,87253,87251,2
2021-08-05,1200179,202131,87253,87253,0
2021-08-05,1200385,202131,87253,87253,0
2021-08-05,1200104,202131,87255,87253,2
2021-08-05,1200054,202131,87255,87255,0
2021-08-05,1200013,202131,87257,87255,2
2021-08-05,1200351,202131,87260,87257,3
2021-08-05,1200138,202131,87260,87260,0
2021-08-05,1200336,202131,87277,87260,17
2021-08-05,1200252,202131,87278,87277,1
2021-08-05,1200807,202131,87278,87278,0
2021-08-05,1200393,202131,87278,87278,0
2021-08-05,1200401,202131,87284,87278,6
2021-08-05,1200427,202131,87288,87284,4
2021-08-05,1200435,202131,87288,87288,0
2021-08-05,1200500,202131,87289,87288,1
2021-08-05,1200450,202131,87289,87289,0
2021-08-05,1200609,202131,87306,87289,17
2021-08-05,1200708,202131,87306,87306,0
2021-08-06,1200708,202131,87311,87306,5
2021-08-06,1200013,202131,87319,87311,8
2021-08-06,1200054,202131,87326,87319,7
2021-08-06,1200104,202131,87326,87326,0
2021-08-06,1200138,202131,87326,87326,0
2021-08-06,1200179,202131,87326,87326,0
2021-08-06,1200203,202131,87328,87326,2
2021-08-06,1200807,202131,87328,87328,0
2021-08-06,1200450,202131,87328,87328,0
2021-08-06,1200500,202131,87331,87328,3
2021-08-06,1200435,202131,87331,87331,0
2021-08-06,1200427,202131,87332,87331,1
2021-08-06,1200401,202131,87336,87332,4
2021-08-06,1200393,202131,87337,87336,1
2021-08-06,1200252,202131,87338,87337,1
2021-08-06,1200609,202131,87390,87338,52
2021-08-06,1200336,202131,87391,87390,1
2021-08-06,1200351,202131,87391,87391,0
2021-08-06,1200344,202131,87391,87391,0
2021-08-06,1200328,202131,87391,87391,0
2021-08-06,1200302,202131,87393,87391,2
2021-08-06,1200385,202131,87394,87393,1
2021-08-07,1200054,202131,87396,87394,2
2021-08-07,1200013,202131,87396,87396,0
2021-08-07,1200104,202131,87396,87396,0
2021-08-07,1200708,202131,87401,87396,5
2021-08-07,1200450,202131,87401,87401,0
2021-08-07,1200500,202131,87401,87401,0
2021-08-07,1200435,202131,87401,87401,0
2021-08-07,1200427,202131,87401,87401,0
2021-08-07,1200401,202131,87404,87401,3
2021-08-07,1200393,202131,87404,87404,0
2021-08-07,1200807,202131,87404,87404,0
2021-08-07,1200385,202131,87404,87404,0
2021-08-07,1200336,202131,87404,87404,0
2021-08-07,1200351,202131,87404,87404,0
2021-08-07,1200344,202131,87404,87404,0
2021-08-07,1200328,202131,87404,87404,0
2021-08-07,1200302,202131,87404,87404,0
2021-08-07,1200252,202131,87404,87404,0
2021-08-07,1200203,202131,87404,87404,0
2021-08-07,1200179,202131,87404,87404,0
2021-08-07,1200138,202131,87404,87404,0
2021-08-07,1200609,202131,87404,87404,0
2021-08-08,1200807,202132,87404,87404,0
2021-08-08,1200393,202132,87404,87404,0
2021-08-08,1200054,202132,87404,87404,0
2021-08-08,1200401,202132,87404,87404,0
2021-08-08,1200427,202132,87404,87404,0
2021-08-08,1200385,202132,87404,87404,0
2021-08-08,1200500,202132,87404,87404,0
2021-08-08,1200450,202132,87404,87404,0
2021-08-08,1200609,202132,87404,87404,0
2021-08-08,1200708,202132,87404,87404,0
2021-08-08,1200336,202132,87404,87404,0
2021-08-08,1200351,202132,87404,87404,0
2021-08-08,1200344,202132,87404,87404,0
2021-08-08,1200328,202132,87404,87404,0
2021-08-08,1200302,202132,87404,87404,0
2021-08-08,1200252,202132,87404,87404,0
2021-08-08,1200203,202132,87404,87404,0
2021-08-08,1200179,202132,87404,87404,0
2021-08-08,1200138,202132,87404,87404,0
2021-08-08,1200104,202132,87404,87404,0
2021-08-08,1200013,202132,87404,87404,0
2021-08-08,1200435,202132,87404,87404,0
2021-08-09,1200435,202132,87404,87404,0
2021-08-09,1200708,202132,87404,87404,0
2021-08-09,1200500,202132,87410,87404,6
2021-08-09,1200427,202132,87410,87410,0
2021-08-09,1200401,202132,87418,87410,8
2021-08-09,1200393,202132,87418,87418,0
2021-08-09,1200807,202132,87418,87418,0
2021-08-09,1200385,202132,87418,87418,0
2021-08-09,1200336,202132,87421,87418,3
2021-08-09,1200351,202132,87424,87421,3
2021-08-09,1200344,202132,87424,87424,0
2021-08-09,1200328,202132,87424,87424,0
2021-08-09,1200302,202132,87424,87424,0
2021-08-09,1200252,202132,87424,87424,0
2021-08-09,1200203,202132,87428,87424,4
2021-08-09,1200179,202132,87428,87428,0
2021-08-09,1200138,202132,87428,87428,0
2021-08-09,1200104,202132,87428,87428,0
2021-08-09,1200054,202132,87435,87428,7
2021-08-09,1200450,202132,87435,87435,0
2021-08-09,1200609,202132,87435,87435,0
2021-08-09,1200013,202132,87437,87435,2
2021-08-10,1200336,202132,87437,87437,0
2021-08-10,1200807,202132,87437,87437,0
2021-08-10,1200393,202132,87437,87437,0
2021-08-10,1200401,202132,87438,87437,1
2021-08-10,1200427,202132,87438,87438,0
2021-08-10,1200435,202132,87438,87438,0
2021-08-10,1200500,202132,87438,87438,0
2021-08-10,1200450,202132,87438,87438,0
2021-08-10,1200609,202132,87438,87438,0
2021-08-10,1200708,202132,87438,87438,0
2021-08-10,1200351,202132,87438,87438,0
2021-08-10,1200344,202132,87438,87438,0
2021-08-10,1200328,202132,87438,87438,0
2021-08-10,1200302,202132,87438,87438,0
2021-08-10,1200252,202132,87438,87438,0
2021-08-10,1200203,202132,87438,87438,0
2021-08-10,1200179,202132,87438,87438,0
2021-08-10,1200138,202132,87438,87438,0
2021-08-10,1200104,202132,87438,87438,0
2021-08-10,1200054,202132,87438,87438,0
2021-08-10,1200013,202132,87438,87438,0
2021-08-10,1200385,202132,87438,87438,0
2021-08-11,1200252,202132,87438,87438,0
2021-08-11,1200427,202132,87455,87438,17
2021-08-11,1200708,202132,87455,87455,0
2021-08-11,1200609,202132,87454,87455,-1
2021-08-11,1200450,202132,87454,87454,0
2021-08-11,1200500,202132,87456,87454,2
2021-08-11,1200435,202132,87456,87456,0
2021-08-11,1200401,202132,87461,87456,5
2021-08-11,1200393,202132,87461,87461,0
2021-08-11,1200807,202132,87462,87461,1
2021-08-11,1200336,202132,87464,87462,2
2021-08-11,1200385,202132,87464,87464,0
2021-08-11,1200344,202132,87464,87464,0
2021-08-11,1200328,202132,87464,87464,0
2021-08-11,1200302,202132,87465,87464,1
2021-08-11,1200203,202132,87466,87465,1
2021-08-11,1200179,202132,87466,87466,0
2021-08-11,1200138,202132,87466,87466,0
2021-08-11,1200104,202132,87466,87466,0
2021-08-11,1200054,202132,87467,87466,1
2021-08-11,1200013,202132,87479,87467,12
2021-08-11,1200351,202132,87483,87479,4
2021-08-12,1200252,202132,87486,87483,3
2021-08-12,1200344,202132,87486,87486,0
2021-08-12,1200328,202132,87486,87486,0
2021-08-12,1200302,202132,87486,87486,0
2021-08-12,1200203,202132,87486,87486,0
2021-08-12,1200385,202132,87486,87486,0
2021-08-12,1200138,202132,87486,87486,0
2021-08-12,1200104,202132,87486,87486,0
2021-08-12,1200013,202132,87486,87486,0
2021-08-12,1200351,202132,87487,87486,1
2021-08-12,1200179,202132,87487,87487,0
2021-08-12,1200336,202132,87488,87487,1
2021-08-12,1200054,202132,87488,87488,0
2021-08-12,1200393,202132,87488,87488,0
2021-08-12,1200401,202132,87491,87488,3
2021-08-12,1200427,202132,87491,87491,0
2021-08-12,1200435,202132,87491,87491,0
2021-08-12,1200500,202132,87491,87491,0
2021-08-12,1200450,202132,87491,87491,0
2021-08-12,1200609,202132,87491,87491,0
2021-08-12,1200708,202132,87491,87491,0
2021-08-12,1200807,202132,87491,87491,0
2021-08-13,1200708,202132,87495,87491,4
2021-08-13,1200013,202132,87495,87495,0
2021-08-13,1200054,202132,87495,87495,0
2021-08-13,1200104,202132,87495,87495,0
2021-08-13,1200138,202132,87495,87495,0
2021-08-13,1200179,202132,87495,87495,0
2021-08-13,1200203,202132,87496,87495,1
2021-08-13,1200302,202132,87496,87496,0
2021-08-13,1200450,202132,87496,87496,0
2021-08-13,1200500,202132,87498,87496,2
2021-08-13,1200435,202132,87498,87498,0
2021-08-13,1200427,202132,87498,87498,0
2021-08-13,1200401,202132,87500,87498,2
2021-08-13,1200252,202132,87500,87500,0
2021-08-13,1200393,202132,87500,87500,0
2021-08-13,1200385,202132,87500,87500,0
2021-08-13,1200336,202132,87500,87500,0
2021-08-13,1200351,202132,87500,87500,0
2021-08-13,1200344,202132,87500,87500,0
2021-08-13,1200328,202132,87500,87500,0
2021-08-13,1200807,202132,87500,87500,0
2021-08-13,1200609,202132,87500,87500,0
2021-08-14,1200013,202132,87500,87500,0
2021-08-14,1200054,202132,87500,87500,0
2021-08-14,1200104,202132,87500,87500,0
2021-08-14,1200435,202132,87500,87500,0
2021-08-14,1200427,202132,87500,87500,0
2021-08-14,1200138,202132,87500,87500,0
2021-08-14,1200500,202132,87500,87500,0
2021-08-14,1200450,202132,87500,87500,0
2021-08-14,1200609,202132,87500,87500,0
2021-08-14,1200708,202132,87500,87500,0
2021-08-14,1200807,202132,87500,87500,0
2021-08-14,1200385,202132,87500,87500,0
2021-08-14,1200336,202132,87500,87500,0
2021-08-14,1200351,202132,87500,87500,0
2021-08-14,1200344,202132,87500,87500,0
2021-08-14,1200328,202132,87500,87500,0
2021-08-14,1200302,202132,87500,87500,0
2021-08-14,1200252,202132,87500,87500,0
2021-08-14,1200203,202132,87500,87500,0
2021-08-14,1200179,202132,87500,87500,0
2021-08-14,1200401,202132,87502,87500,2
2021-08-14,1200393,202132,87502,87502,0
2021-08-15,1200385,202133,87502,87502,0
2021-08-15,1200393,202133,87502,87502,0
2021-08-15,1200054,202133,87502,87502,0
2021-08-15,1200104,202133,87502,87502,0
2021-08-15,1200807,202133,87502,87502,0
2021-08-15,1200138,202133,87502,87502,0
2021-08-15,1200179,202133,87502,87502,0
2021-08-15,1200203,202133,87503,87502,1
2021-08-15,1200252,202133,87503,87503,0
2021-08-15,1200302,202133,87503,87503,0
2021-08-15,1200328,202133,87503,87503,0
2021-08-15,1200344,202133,87503,87503,0
2021-08-15,1200013,202133,87503,87503,0
2021-08-15,1200351,202133,87503,87503,0
2021-08-15,1200336,202133,87503,87503,0
2021-08-15,1200500,202133,87503,87503,0
2021-08-15,1200609,202133,87503,87503,0
2021-08-15,1200427,202133,87503,87503,0
2021-08-15,1200708,202133,87503,87503,0
2021-08-15,1200435,202133,87503,87503,0
2021-08-15,1200401,202133,87504,87503,1
2021-08-15,1200450,202133,87504,87504,0
2021-08-16,1200013,202133,87504,87504,0
2021-08-16,1200054,202133,87504,87504,0
2021-08-16,1200104,202133,87504,87504,0
2021-08-16,1200138,202133,87504,87504,0
2021-08-16,1200179,202133,87504,87504,0
2021-08-16,1200203,202133,87505,87504,1
2021-08-16,1200252,202133,87505,87505,0
2021-08-16,1200328,202133,87505,87505,0
2021-08-16,1200302,202133,87505,87505,0
2021-08-16,1200336,202133,87505,87505,0
2021-08-16,1200385,202133,87505,87505,0
2021-08-16,1200807,202133,87505,87505,0
2021-08-16,1200393,202133,87505,87505,0
2021-08-16,1200401,202133,87507,87505,2
2021-08-16,1200427,202133,87507,87507,0
2021-08-16,1200435,202133,87507,87507,0
2021-08-16,1200500,202133,87507,87507,0
2021-08-16,1200450,202133,87507,87507,0
2021-08-16,1200609,202133,87507,87507,0
2021-08-16,1200708,202133,87507,87507,0
2021-08-16,1200351,202133,87507,87507,0
2021-08-16,1200344,202133,87507,87507,0
2021-08-17,1200179,202133,87507,87507,0
2021-08-17,1200138,202133,87507,87507,0
2021-08-17,1200104,202133,87509,87507,2
2021-08-17,1200013,202133,87517,87509,8
2021-08-17,1200054,202133,87531,87517,14
2021-08-17,1200807,202133,87531,87531,0
2021-08-17,1200500,202133,87536,87531,5
2021-08-17,1200435,202133,87536,87536,0
2021-08-17,1200427,202133,87544,87536,8
2021-08-17,1200401,202133,87555,87544,11
2021-08-17,1200393,202133,87555,87555,0
2021-08-17,1200708,202133,87555,87555,0
2021-08-17,1200450,202133,87556,87555,1
2021-08-17,1200385,202133,87557,87556,1
2021-08-17,1200351,202133,87587,87557,30
2021-08-17,1200344,202133,87587,87587,0
2021-08-17,1200328,202133,87587,87587,0
2021-08-17,1200302,202133,87589,87587,2
2021-08-17,1200252,202133,87595,87589,6
2021-08-17,1200203,202133,87604,87595,9
2021-08-17,1200336,202133,87609,87604,5
2021-08-17,1200609,202133,87617,87609,8
2021-08-18,1200427,202133,87617,87617,0
2021-08-18,1200401,202133,87618,87617,1
2021-08-18,1200013,202133,87618,87618,0
2021-08-18,1200104,202133,87618,87618,0
2021-08-18,1200435,202133,87618,87618,0
2021-08-18,1200393,202133,87618,87618,0
2021-08-18,1200450,202133,87618,87618,0
2021-08-18,1200609,202133,87618,87618,0
2021-08-18,1200708,202133,87618,87618,0
2021-08-18,1200807,202133,87618,87618,0
2021-08-18,1200385,202133,87618,87618,0
2021-08-18,1200054,202133,87618,87618,0
2021-08-18,1200336,202133,87619,87618,1
2021-08-18,1200344,202133,87619,87619,0
2021-08-18,1200328,202133,87619,87619,0
2021-08-18,1200302,202133,87620,87619,1
2021-08-18,1200252,202133,87621,87620,1
2021-08-18,1200203,202133,87622,87621,1
2021-08-18,1200179,202133,87622,87622,0
2021-08-18,1200138,202133,87622,87622,0
2021-08-18,1200351,202133,87622,87622,0
2021-08-18,1200500,202133,87622,87622,0
2021-08-19,1200385,202133,87622,87622,0
2021-08-19,1200401,202133,87629,87622,7
2021-08-19,1200708,202133,87632,87629,3
2021-08-19,1200609,202133,87633,87632,1
2021-08-19,1200450,202133,87633,87633,0
2021-08-19,1200500,202133,87635,87633,2
2021-08-19,1200435,202133,87635,87635,0
2021-08-19,1200427,202133,87639,87635,4
2021-08-19,1200393,202133,87641,87639,2
2021-08-19,1200807,202133,87641,87641,0
2021-08-19,1200351,202133,87641,87641,0
2021-08-19,1200336,202133,87644,87641,3
2021-08-19,1200328,202133,87644,87644,0
2021-08-19,1200302,202133,87646,87644,2
2021-08-19,1200252,202133,87647,87646,1
2021-08-19,1200203,202133,87655,87647,8
2021-08-19,1200179,202133,87655,87655,0
2021-08-19,1200138,202133,87655,87655,0
2021-08-19,1200104,202133,87655,87655,0
2021-08-19,1200054,202133,87655,87655,0
2021-08-19,1200013,202133,87653,87655,-2
2021-08-19,1200344,202133,87653,87653,0
2021-08-20,1200203,202133,87658,87653,5
2021-08-20,1200328,202133,87658,87658,0
2021-08-20,1200252,202133,87659,87658,1
2021-08-20,1200179,202133,87659,87659,0
2021-08-20,1200385,202133,87659,87659,0
2021-08-20,1200104,202133,87661,87659,2
2021-08-20,1200054,202133,87661,87661,0
2021-08-20,1200013,202133,87661,87661,0
2021-08-20,1200344,202133,87661,87661,0
2021-08-20,1200138,202133,87661,87661,0
2021-08-20,1200336,202133,87661,87661,0
2021-08-20,1200351,202133,87670,87661,9
2021-08-20,1200302,202133,87670,87670,0
2021-08-20,1200807,202133,87670,87670,0
2021-08-20,1200393,202133,87669,87670,-1
2021-08-20,1200401,202133,87671,87669,2
2021-08-20,1200427,202133,87682,87671,11
2021-08-20,1200435,202133,87682,87682,0
2021-08-20,1200500,202133,87688,87682,6
2021-08-20,1200450,202133,87688,87688,0
2021-08-20,1200609,202133,87686,87688,-2
2021-08-20,1200708,202133,87686,87686,0
2021-08-21,1200013,202133,87686,87686,0
2021-08-21,1200054,202133,87686,87686,0
2021-08-21,1200104,202133,87687,87686,1
2021-08-21,1200138,202133,87687,87687,0
2021-08-21,1200179,202133,87687,87687,0
2021-08-21,1200609,202133,87687,87687,0
2021-08-21,1200252,202133,87687,87687,0
2021-08-21,1200302,202133,87687,87687,0
2021-08-21,1200328,202133,87687,87687,0
2021-08-21,1200344,202133,87687,87687,0
2021-08-21,1200351,202133,87687,87687,0
2021-08-21,1200336,202133,87687,87687,0
2021-08-21,1200385,202133,87687,87687,0
2021-08-21,1200807,202133,87687,87687,0
2021-08-21,1200393,202133,87687,87687,0
2021-08-21,1200401,202133,87692,87687,5
2021-08-21,1200427,202133,87693,87692,1
2021-08-21,1200435,202133,87693,87693,0
2021-08-21,1200500,202133,87693,87693,0
2021-08-21,1200450,202133,87693,87693,0
2021-08-21,1200708,202133,87693,87693,0
2021-08-21,1200203,202133,87693,87693,0
2021-08-22,1200252,202134,87693,87693,0
2021-08-22,1200427,202134,87693,87693,0
2021-08-22,1200708,202134,87693,87693,0
2021-08-22,1200609,202134,87694,87693,1
2021-08-22,1200450,202134,87694,87694,0
2021-08-22,1200500,202134,87694,87694,0
2021-08-22,1200435,202134,87694,87694,0
2021-08-22,1200401,202134,87695,87694,1
2021-08-22,1200393,202134,87695,87695,0
2021-08-22,1200807,202134,87695,87695,0
2021-08-22,1200336,202134,87695,87695,0
2021-08-22,1200385,202134,87695,87695,0
2021-08-22,1200344,202134,87695,87695,0
2021-08-22,1200328,202134,87695,87695,0
2021-08-22,1200302,202134,87695,87695,0
2021-08-22,1200203,202134,87695,87695,0
2021-08-22,1200179,202134,87695,87695,0
2021-08-22,1200138,202134,87695,87695,0
2021-08-22,1200104,202134,87695,87695,0
2021-08-22,1200054,202134,87695,87695,0
2021-08-22,1200013,202134,87695,87695,0
2021-08-22,1200351,202134,87695,87695,0
2021-08-23,1200252,202134,87695,87695,0
2021-08-23,1200344,202134,87695,87695,0
2021-08-23,1200328,202134,87695,87695,0
2021-08-23,1200302,202134,87695,87695,0
2021-08-23,1200203,202134,87696,87695,1
2021-08-23,1200385,202134,87696,87696,0
2021-08-23,1200138,202134,87696,87696,0
2021-08-23,1200104,202134,87697,87696,1
2021-08-23,1200013,202134,87697,87697,0
2021-08-23,1200351,202134,87697,87697,0
2021-08-23,1200179,202134,87697,87697,0
2021-08-23,1200336,202134,87697,87697,0
2021-08-23,1200054,202134,87697,87697,0
2021-08-23,1200807,202134,87697,87697,0
2021-08-23,1200393,202134,87697,87697,0
2021-08-23,1200401,202134,87697,87697,0
2021-08-23,1200427,202134,87697,87697,0
2021-08-23,1200435,202134,87697,87697,0
2021-08-23,1200500,202134,87697,87697,0
2021-08-23,1200450,202134,87697,87697,0
2021-08-23,1200609,202134,87697,87697,0
2021-08-23,1200708,202134,87697,87697,0
2021-08-24,1200708,202134,87698,87697,1
2021-08-24,1200013,202134,87699,87698,1
2021-08-24,1200054,202134,87699,87699,0
2021-08-24,1200104,202134,87699,87699,0
2021-08-24,1200138,202134,87699,87699,0
2021-08-24,1200179,202134,87699,87699,0
2021-08-24,1200203,202134,87707,87699,8
2021-08-24,1200807,202134,87707,87707,0
2021-08-24,1200450,202134,87709,87707,2
2021-08-24,1200500,202134,87710,87709,1
2021-08-24,1200435,202134,87710,87710,0
2021-08-24,1200427,202134,87714,87710,4
2021-08-24,1200401,202134,87716,87714,2
2021-08-24,1200393,202134,87717,87716,1
2021-08-24,1200252,202134,87721,87717,4
2021-08-24,1200609,202134,87721,87721,0
2021-08-24,1200336,202134,87729,87721,8
2021-08-24,1200351,202134,87738,87729,9
2021-08-24,1200344,202134,87738,87738,0
2021-08-24,1200328,202134,87738,87738,0
2021-08-24,1200302,202134,87738,87738,0
2021-08-24,1200385,202134,87739,87738,1
2021-08-25,1200054,202134,87734,87739,-5
2021-08-25,1200013,202134,87737,87734,3
2021-08-25,1200104,202134,87739,87737,2
2021-08-25,1200708,202134,87739,87739,0
2021-08-25,1200450,202134,87740,87739,1
2021-08-25,1200500,202134,87740,87740,0
2021-08-25,1200435,202134,87740,87740,0
2021-08-25,1200427,202134,87740,87740,0
2021-08-25,1200401,202134,87743,87740,3
2021-08-25,1200393,202134,87743,87743,0
2021-08-25,1200807,202134,87743,87743,0
2021-08-25,1200385,202134,87742,87743,-1
2021-08-25,1200336,202134,87742,87742,0
2021-08-25,1200351,202134,87739,87742,-3
2021-08-25,1200344,202134,87739,87739,0
2021-08-25,1200328,202134,87738,87739,-1
2021-08-25,1200302,202134,87738,87738,0
2021-08-25,1200252,202134,87735,87738,-3
2021-08-25,1200203,202134,87733,87735,-2
2021-08-25,1200179,202134,87733,87733,0
2021-08-25,1200138,202134,87733,87733,0
2021-08-25,1200609,202134,87744,87733,11
2021-08-26,1200807,202134,87744,87744,0
2021-08-26,1200393,202134,87745,87744,1
2021-08-26,1200054,202134,87749,87745,4
2021-08-26,1200401,202134,87750,87749,1
2021-08-26,1200427,202134,87750,87750,0
2021-08-26,1200385,202134,87750,87750,0
2021-08-26,1200500,202134,87750,87750,0
2021-08-26,1200450,202134,87750,87750,0
2021-08-26,1200609,202134,87767,87750,17
2021-08-26,1200708,202134,87769,87767,2
2021-08-26,1200336,202134,87772,87769,3
2021-08-26,1200351,202134,87772,87772,0
2021-08-26,1200344,202134,87772,87772,0
2021-08-26,1200328,202134,87772,87772,0
2021-08-26,1200302,202134,87773,87772,1
2021-08-26,1200252,202134,87773,87773,0
2021-08-26,1200203,202134,87776,87773,3
2021-08-26,1200179,202134,87776,87776,0
2021-08-26,1200138,202134,87776,87776,0
2021-08-26,1200104,202134,87776,87776,0
2021-08-26,1200013,202134,87776,87776,0
2021-08-26,1200435,202134,87776,87776,0
2021-08-27,1200435,202134,87776,87776,0
2021-08-27,1200708,202134,87776,87776,0
2021-08-27,1200500,202134,87777,87776,1
2021-08-27,1200427,202134,87777,87777,0
2021-08-27,1200401,202134,87780,87777,3
2021-08-27,1200393,202134,87783,87780,3
2021-08-27,1200807,202134,87783,87783,0
2021-08-27,1200385,202134,87783,87783,0
2021-08-27,1200336,202134,87784,87783,1
2021-08-27,1200351,202134,87789,87784,5
2021-08-27,1200344,202134,87789,87789,0
2021-08-27,1200328,202134,87789,87789,0
2021-08-27,1200302,202134,87789,87789,0
2021-08-27,1200252,202134,87789,87789,0
2021-08-27,1200203,202134,87795,87789,6
2021-08-27,1200179,202134,87795,87795,0
2021-08-27,1200138,202134,87795,87795,0
2021-08-27,1200104,202134,87806,87795,11
2021-08-27,1200054,202134,87806,87806,0
2021-08-27,1200450,202134,87808,87806,2
2021-08-27,1200609,202134,87810,87808,2
2021-08-27,1200013,202134,87813,87810,3
2021-08-28,1200336,202134,87813,87813,0
2021-08-28,1200807,202134,87813,87813,0
2021-08-28,1200393,202134,87813,87813,0
2021-08-28,1200401,202134,87814,87813,1
2021-08-28,1200427,202134,87814,87814,0
2021-08-28,1200435,202134,87814,87814,0
2021-08-28,1200500,202134,87814,87814,0
2021-08-28,1200450,202134,87814,87814,0
2021-08-28,1200609,202134,87814,87814,0
2021-08-28,1200708,202134,87814,87814,0
2021-08-28,1200351,202134,87814,87814,0
2021-08-28,1200344,202134,87814,87814,0
2021-08-28,1200328,202134,87814,87814,0
2021-08-28,1200302,202134,87814,87814,0
2021-08-28,1200252,202134,87814,87814,0
2021-08-28,1200203,202134,87817,87814,3
2021-08-28,1200179,202134,87817,87817,0
2021-08-28,1200138,202134,87817,87817,0
2021-08-28,1200104,202134,87817,87817,0
2021-08-28,1200054,202134,87817,87817,0
2021-08-28,1200013,202134,87817,87817,0
2021-08-28,1200385,202134,87817,87817,0
2021-08-29,1200336,202135,87817,87817,0
2021-08-29,1200427,202135,87817,87817,0
2021-08-29,1200708,202135,87817,87817,0
2021-08-29,1200609,202135,87817,87817,0
2021-08-29,1200450,202135,87817,87817,0
2021-08-29,1200500,202135,87817,87817,0
2021-08-29,1200435,202135,87817,87817,0
2021-08-29,1200401,202135,87818,87817,1
2021-08-29,1200393,202135,87818,87818,0
2021-08-29,1200807,202135,87818,87818,0
2021-08-29,1200351,202135,87818,87818,0
2021-08-29,1200385,202135,87818,87818,0
2021-08-29,1200328,202135,87818,87818,0
2021-08-29,1200302,202135,87818,87818,0
2021-08-29,1200252,202135,87818,87818,0
2021-08-29,1200203,202135,87818,87818,0
2021-08-29,1200179,202135,87818,87818,0
2021-08-29,1200138,202135,87818,87818,0
2021-08-29,1200104,202135,87818,87818,0
2021-08-29,1200054,202135,87818,87818,0
2021-08-29,1200013,202135,87818,87818,0
2021-08-29,1200344,202135,87818,87818,0
2021-08-30,1200203,202135,87818,87818,0
2021-08-30,1200344,202135,87818,87818,0
2021-08-30,1200328,202135,87818,87818,0
2021-08-30,1200302,202135,87818,87818,0
2021-08-30,1200179,202135,87818,87818,0
2021-08-30,1200385,202135,87818,87818,0
2021-08-30,1200104,202135,87818,87818,0
2021-08-30,1200054,202135,87818,87818,0
2021-08-30,1200013,202135,87818,87818,0
2021-08-30,1200351,202135,87818,87818,0
2021-08-30,1200138,202135,87818,87818,0
2021-08-30,1200336,202135,87818,87818,0
2021-08-30,1200252,202135,87818,87818,0
2021-08-30,1200393,202135,87818,87818,0
2021-08-30,1200401,202135,87819,87818,1
2021-08-30,1200427,202135,87819,87819,0
2021-08-30,1200435,202135,87819,87819,0
2021-08-30,1200500,202135,87819,87819,0
2021-08-30,1200450,202135,87819,87819,0
2021-08-30,1200609,202135,87819,87819,0
2021-08-30,1200708,202135,87819,87819,0
2021-08-30,1200807,202135,87819,87819,0
2021-08-31,1200708,202135,87819,87819,0
2021-08-31,1200013,202135,87816,87819,-3
2021-08-31,1200054,202135,87825,87816,9
2021-08-31,1200104,202135,87823,87825,-2
2021-08-31,1200138,202135,87823,87823,0
2021-08-31,1200179,202135,87823,87823,0
2021-08-31,1200203,202135,87829,87823,6
2021-08-31,1200302,202135,87829,87829,0
2021-08-31,1200450,202135,87829,87829,0
2021-08-31,1200500,202135,87829,87829,0
2021-08-31,1200435,202135,87830,87829,1
2021-08-31,1200427,202135,87834,87830,4
2021-08-31,1200401,202135,87836,87834,2
2021-08-31,1200252,202135,87836,87836,0
2021-08-31,1200393,202135,87836,87836,0
2021-08-31,1200385,202135,87836,87836,0
2021-08-31,1200336,202135,87840,87836,4
2021-08-31,1200351,202135,87841,87840,1
2021-08-31,1200344,202135,87841,87841,0
2021-08-31,1200328,202135,87841,87841,0
2021-08-31,1200807,202135,87841,87841,0
2021-08-31,1200609,202135,87838,87841,-3
2021-09-01,1200013,202135,87838,87838,0
2021-09-01,1200054,202135,87838,87838,0
2021-09-01,1200104,202135,87838,87838,0
2021-09-01,1200179,202135,87838,87838,0
2021-09-01,1200252,202135,87839,87838,1
2021-09-01,1200302,202135,87839,87839,0
2021-09-01,1200328,202135,87839,87839,0
2021-09-01,1200344,202135,87839,87839,0
2021-09-01,1200351,202135,87841,87839,2
2021-09-01,1200336,202135,87841,87841,0
2021-09-01,1200385,202135,87841,87841,0
2021-09-01,1200807,202135,87841,87841,0
2021-09-01,1200393,202135,87841,87841,0
2021-09-01,1200401,202135,87843,87841,2
2021-09-01,1200427,202135,87843,87843,0
2021-09-01,1200435,202135,87843,87843,0
2021-09-01,1200500,202135,87843,87843,0
2021-09-01,1200203,202135,87846,87843,3
2021-09-01,1200450,202135,87846,87846,0
2021-09-01,1200609,202135,87846,87846,0
2021-09-01,1200708,202135,87846,87846,0
2021-09-01,1200138,202135,87846,87846,0
2021-09-02,1200013,202135,87846,87846,0
2021-09-02,1200054,202135,87846,87846,0
2021-09-02,1200104,202135,87846,87846,0
2021-09-02,1200138,202135,87846,87846,0
2021-09-02,1200179,202135,87846,87846,0
2021-09-02,1200203,202135,87846,87846,0
2021-09-02,1200252,202135,87846,87846,0
2021-09-02,1200302,202135,87846,87846,0
2021-09-02,1200328,202135,87846,87846,0
2021-09-02,1200344,202135,87846,87846,0
2021-09-02,1200351,202135,87846,87846,0
2021-09-02,1200385,202135,87846,87846,0
2021-09-02,1200393,202135,87846,87846,0
2021-09-02,1200807,202135,87846,87846,0
2021-09-02,1200401,202135,87850,87846,4
2021-09-02,1200427,202135,87850,87850,0
2021-09-02,1200435,202135,87850,87850,0
2021-09-02,1200500,202135,87850,87850,0
2021-09-02,1200450,202135,87850,87850,0
2021-09-02,1200609,202135,87849,87850,-1
2021-09-02,1200708,202135,87849,87849,0
2021-09-02,1200336,202135,87850,87849,1
2021-09-03,1200013,202135,87850,87850,0
2021-09-03,1200054,202135,87852,87850,2
2021-09-03,1200104,202135,87853,87852,1
2021-09-03,1200138,202135,87853,87853,0
2021-09-03,1200179,202135,87853,87853,0
2021-09-03,1200203,202135,87858,87853,5
2021-09-03,1200708,202135,87858,87858,0
2021-09-03,1200328,202135,87858,87858,0
2021-09-03,1200344,202135,87858,87858,0
2021-09-03,1200351,202135,87860,87858,2
2021-09-03,1200336,202135,87860,87860,0
2021-09-03,1200385,202135,87861,87860,1
2021-09-03,1200807,202135,87861,87861,0
2021-09-03,1200393,202135,87861,87861,0
2021-09-03,1200401,202135,87863,87861,2
2021-09-03,1200427,202135,87863,87863,0
2021-09-03,1200435,202135,87863,87863,0
2021-09-03,1200500,202135,87863,87863,0
2021-09-03,1200450,202135,87863,87863,0
2021-09-03,1200609,202135,87863,87863,0
2021-09-03,1200302,202135,87863,87863,0
2021-09-03,1200252,202135,87870,87863,7
2021-09-04,1200435,202135,87870,87870,0
2021-09-04,1200393,202135,87870,87870,0
2021-09-04,1200708,202135,87870,87870,0
2021-09-04,1200609,202135,87871,87870,1
2021-09-04,1200450,202135,87871,87871,0
2021-09-04,1200500,202135,87871,87871,0
2021-09-04,1200427,202135,87871,87871,0
2021-09-04,1200401,202135,87872,87871,1
2021-09-04,1200807,202135,87872,87872,0
2021-09-04,1200385,202135,87872,87872,0
2021-09-04,1200351,202135,87873,87872,1
2021-09-04,1200336,202135,87873,87873,0
2021-09-04,1200328,202135,87873,87873,0
2021-09-04,1200302,202135,87873,87873,0
2021-09-04,1200252,202135,87881,87873,8
2021-09-04,1200203,202135,87882,87881,1
2021-09-04,1200179,202135,87882,87882,0
2021-09-04,1200138,202135,87882,87882,0
2021-09-04,1200104,202135,87886,87882,4
2021-09-04,1200054,202135,87890,87886,4
2021-09-04,1200013,202135,87890,87890,0
2021-09-04,1200344,202135,87890,87890,0
2021-09-05,1200203,202136,87890,87890,0
2021-09-05,1200302,202136,87890,87890,0
2021-09-05,1200252,202136,87890,87890,0
2021-09-05,1200179,202136,87890,87890,0
2021-09-05,1200351,202136,87890,87890,0
2021-09-05,1200104,202136,87890,87890,0
2021-09-05,1200054,202136,87890,87890,0
2021-09-05,1200013,202136,87890,87890,0
2021-09-05,1200328,202136,87890,87890,0
2021-09-05,1200138,202136,87890,87890,0
2021-09-05,1200336,202136,87890,87890,0
2021-09-05,1200344,202136,87890,87890,0
2021-09-05,1200385,202136,87890,87890,0
2021-09-05,1200807,202136,87890,87890,0
2021-09-05,1200393,202136,87890,87890,0
2021-09-05,1200401,202136,87890,87890,0
2021-09-05,1200427,202136,87890,87890,0
2021-09-05,1200435,202136,87890,87890,0
2021-09-05,1200500,202136,87890,87890,0
2021-09-05,1200450,202136,87890,87890,0
2021-09-05,1200609,202136,87890,87890,0
2021-09-05,1200708,202136,87890,87890,0
2021-09-06,1200013,202136,87890,87890,0
2021-09-06,1200054,202136,87890,87890,0
2021-09-06,1200104,202136,87890,87890,0
2021-09-06,1200138,202136,87890,87890,0
2021-09-06,1200179,202136,87890,87890,0
2021-09-06,1200609,202136,87890,87890,0
2021-09-06,1200252,202136,87890,87890,0
2021-09-06,1200302,202136,87890,87890,0
2021-09-06,1200328,202136,87890,87890,0
2021-09-06,1200344,202136,87890,87890,0
2021-09-06,1200351,202136,87890,87890,0
2021-09-06,1200336,202136,87890,87890,0
2021-09-06,1200385,202136,87890,87890,0
2021-09-06,1200807,202136,87890,87890,0
2021-09-06,1200393,202136,87890,87890,0
2021-09-06,1200401,202136,87892,87890,2
2021-09-06,1200427,202136,87892,87892,0
2021-09-06,1200435,202136,87892,87892,0
2021-09-06,1200500,202136,87892,87892,0
2021-09-06,1200450,202136,87892,87892,0
2021-09-06,1200708,202136,87892,87892,0
2021-09-06,1200203,202136,87892,87892,0
2021-09-07,1200336,202136,87897,87892,5
2021-09-07,1200427,202136,87897,87897,0
2021-09-07,1200708,202136,87897,87897,0
2021-09-07,1200609,202136,87897,87897,0
2021-09-07,1200450,202136,87897,87897,0
2021-09-07,1200500,202136,87898,87897,1
2021-09-07,1200435,202136,87898,87898,0
2021-09-07,1200401,202136,87899,87898,1
2021-09-07,1200393,202136,87899,87899,0
2021-09-07,1200807,202136,87899,87899,0
2021-09-07,1200351,202136,87899,87899,0
2021-09-07,1200385,202136,87899,87899,0
2021-09-07,1200328,202136,87899,87899,0
2021-09-07,1200302,202136,87899,87899,0
2021-09-07,1200252,202136,87899,87899,0
2021-09-07,1200203,202136,87914,87899,15
2021-09-07,1200179,202136,87914,87914,0
2021-09-07,1200138,202136,87914,87914,0
2021-09-07,1200104,202136,87914,87914,0
2021-09-07,1200054,202136,87914,87914,0
2021-09-07,1200013,202136,87914,87914,0
2021-09-07,1200344,202136,87914,87914,0
2021-09-08,1200203,202136,87914,87914,0
2021-09-08,1200344,202136,87914,87914,0
2021-09-08,1200328,202136,87914,87914,0
2021-09-08,1200302,202136,87914,87914,0
2021-09-08,1200179,202136,87914,87914,0
2021-09-08,1200385,202136,87914,87914,0
2021-09-08,1200104,202136,87914,87914,0
2021-09-08,1200054,202136,87914,87914,0
2021-09-08,1200013,202136,87914,87914,0
2021-09-08,1200351,202136,87914,87914,0
2021-09-08,1200138,202136,87914,87914,0
2021-09-08,1200336,202136,87915,87914,1
2021-09-08,1200252,202136,87915,87915,0
2021-09-08,1200807,202136,87915,87915,0
2021-09-08,1200393,202136,87915,87915,0
2021-09-08,1200401,202136,87915,87915,0
2021-09-08,1200427,202136,87915,87915,0
2021-09-08,1200435,202136,87915,87915,0
2021-09-08,1200500,202136,87915,87915,0
2021-09-08,1200450,202136,87915,87915,0
2021-09-08,1200609,202136,87915,87915,0
2021-09-08,1200708,202136,87915,87915,0
2021-09-09,1200708,202136,87915,87915,0
2021-09-09,1200013,202136,87915,87915,0
2021-09-09,1200054,202136,87915,87915,0
2021-09-09,1200104,202136,87915,87915,0
2021-09-09,1200138,202136,87915,87915,0
2021-09-09,1200179,202136,87915,87915,0
2021-09-09,1200203,202136,87918,87915,3
2021-09-09,1200807,202136,87918,87918,0
2021-09-09,1200450,202136,87918,87918,0
2021-09-09,1200500,202136,87918,87918,0
2021-09-09,1200435,202136,87918,87918,0
2021-09-09,1200427,202136,87918,87918,0
2021-09-09,1200401,202136,87918,87918,0
2021-09-09,1200393,202136,87918,87918,0
2021-09-09,1200252,202136,87918,87918,0
2021-09-09,1200609,202136,87918,87918,0
2021-09-09,1200336,202136,87918,87918,0
2021-09-09,1200351,202136,87918,87918,0
2021-09-09,1200344,202136,87918,87918,0
2021-09-09,1200328,202136,87918,87918,0
2021-09-09,1200302,202136,87918,87918,0
2021-09-09,1200385,202136,87918,87918,0
2021-09-10,1200054,202136,87918,87918,0
2021-09-10,1200013,202136,87918,87918,0
2021-09-10,1200104,202136,87918,87918,0
2021-09-10,1200708,202136,87918,87918,0
2021-09-10,1200450,202136,87918,87918,0
2021-09-10,1200500,202136,87918,87918,0
2021-09-10,1200435,202136,87918,87918,0
2021-09-10,1200427,202136,87918,87918,0
2021-09-10,1200401,202136,87919,87918,1
2021-09-10,1200393,202136,87919,87919,0
2021-09-10,1200807,202136,87919,87919,0
2021-09-10,1200385,202136,87919,87919,0
2021-09-10,1200336,202136,87919,87919,0
2021-09-10,1200351,202136,87919,87919,0
2021-09-10,1200344,202136,87919,87919,0
2021-09-10,1200328,202136,87919,87919,0
2021-09-10,1200302,202136,87919,87919,0
2021-09-10,1200252,202136,87919,87919,0
2021-09-10,1200203,202136,87920,87919,1
2021-09-10,1200179,202136,87922,87920,2
2021-09-10,1200138,202136,87922,87922,0
2021-09-10,1200609,202136,87922,87922,0
2021-09-11,1200807,202136,87922,87922,0
2021-09-11,1200393,202136,87922,87922,0
2021-09-11,1200054,202136,87922,87922,0
2021-09-11,1200401,202136,87922,87922,0
2021-09-11,1200427,202136,87922,87922,0
2021-09-11,1200385,202136,87922,87922,0
2021-09-11,1200500,202136,87922,87922,0
2021-09-11,1200450,202136,87922,87922,0
2021-09-11,1200609,202136,87922,87922,0
2021-09-11,1200708,202136,87922,87922,0
2021-09-11,1200336,202136,87922,87922,0
2021-09-11,1200351,202136,87922,87922,0
2021-09-11,1200344,202136,87922,87922,0
2021-09-11,1200328,202136,87922,87922,0
2021-09-11,1200302,202136,87922,87922,0
2021-09-11,1200252,202136,87922,87922,0
2021-09-11,1200203,202136,87922,87922,0
2021-09-11,1200179,202136,87922,87922,0
2021-09-11,1200138,202136,87922,87922,0
2021-09-11,1200104,202136,87922,87922,0
2021-09-11,1200013,202136,87922,87922,0
2021-09-11,1200435,202136,87922,87922,0
2021-09-12,1200435,202137,87922,87922,0
2021-09-12,1200708,202137,87922,87922,0
2021-09-12,1200500,202137,87922,87922,0
2021-09-12,1200427,202137,87922,87922,0
2021-09-12,1200401,202137,87926,87922,4
2021-09-12,1200393,202137,87926,87926,0
2021-09-12,1200807,202137,87926,87926,0
2021-09-12,1200385,202137,87926,87926,0
2021-09-12,1200336,202137,87926,87926,0
2021-09-12,1200351,202137,87926,87926,0
2021-09-12,1200344,202137,87926,87926,0
2021-09-12,1200328,202137,87926,87926,0
2021-09-12,1200302,202137,87926,87926,0
2021-09-12,1200252,202137,87926,87926,0
2021-09-12,1200203,202137,87926,87926,0
2021-09-12,1200179,202137,87926,87926,0
2021-09-12,1200138,202137,87926,87926,0
2021-09-12,1200104,202137,87926,87926,0
2021-09-12,1200054,202137,87926,87926,0
2021-09-12,1200450,202137,87926,87926,0
2021-09-12,1200609,202137,87926,87926,0
2021-09-12,1200013,202137,87926,87926,0
2021-09-13,1200336,202137,87926,87926,0
2021-09-13,1200807,202137,87926,87926,0
2021-09-13,1200393,202137,87926,87926,0
2021-09-13,1200401,202137,87928,87926,2
2021-09-13,1200427,202137,87928,87928,0
2021-09-13,1200435,202137,87928,87928,0
2021-09-13,1200500,202137,87928,87928,0
2021-09-13,1200450,202137,87928,87928,0
2021-09-13,1200609,202137,87928,87928,0
2021-09-13,1200708,202137,87928,87928,0
2021-09-13,1200351,202137,87928,87928,0
2021-09-13,1200344,202137,87928,87928,0
2021-09-13,1200328,202137,87928,87928,0
2021-09-13,1200302,202137,87928,87928,0
2021-09-13,1200252,202137,87928,87928,0
2021-09-13,1200203,202137,87929,87928,1
2021-09-13,1200179,202137,87929,87929,0
2021-09-13,1200138,202137,87929,87929,0
2021-09-13,1200104,202137,87929,87929,0
2021-09-13,1200054,202137,87929,87929,0
2021-09-13,1200013,202137,87929,87929,0
2021-09-13,1200385,202137,87929,87929,0
2021-09-14,1200336,202137,87929,87929,0
2021-09-14,1200427,202137,87929,87929,0
2021-09-14,1200708,202137,87929,87929,0
2021-09-14,1200609,202137,87929,87929,0
2021-09-14,1200450,202137,87929,87929,0
2021-09-14,1200500,202137,87929,87929,0
2021-09-14,1200435,202137,87929,87929,0
2021-09-14,1200401,202137,87929,87929,0
2021-09-14,1200393,202137,87929,87929,0
2021-09-14,1200807,202137,87929,87929,0
2021-09-14,1200351,202137,87929,87929,0
2021-09-14,1200385,202137,87929,87929,0
2021-09-14,1200328,202137,87929,87929,0
2021-09-14,1200302,202137,87929,87929,0
2021-09-14,1200252,202137,87929,87929,0
2021-09-14,1200203,202137,87929,87929,0
2021-09-14,1200179,202137,87929,87929,0
2021-09-14,1200138,202137,87929,87929,0
2021-09-14,1200104,202137,87929,87929,0
2021-09-14,1200054,202137,87929,87929,0
2021-09-14,1200013,202137,87929,87929,0
2021-09-14,1200344,202137,87929,87929,0
2021-09-15,1200203,202137,87930,87929,1
2021-09-15,1200344,202137,87930,87930,0
2021-09-15,1200328,202137,87930,87930,0
2021-09-15,1200302,202137,87930,87930,0
2021-09-15,1200179,202137,87930,87930,0
2021-09-15,1200385,202137,87930,87930,0
2021-09-15,1200104,202137,87930,87930,0
2021-09-15,1200054,202137,87930,87930,0
2021-09-15,1200013,202137,87930,87930,0
2021-09-15,1200351,202137,87930,87930,0
2021-09-15,1200138,202137,87930,87930,0
2021-09-15,1200336,202137,87930,87930,0
2021-09-15,1200252,202137,87930,87930,0
2021-09-15,1200393,202137,87930,87930,0
2021-09-15,1200401,202137,87931,87930,1
2021-09-15,1200427,202137,87931,87931,0
2021-09-15,1200435,202137,87931,87931,0
2021-09-15,1200500,202137,87931,87931,0
2021-09-15,1200450,202137,87931,87931,0
2021-09-15,1200609,202137,87931,87931,0
2021-09-15,1200708,202137,87931,87931,0
2021-09-15,1200807,202137,87931,87931,0
2021-09-16,1200708,202137,87933,87931,2
2021-09-16,1200013,202137,87933,87933,0
2021-09-16,1200054,202137,87933,87933,0
2021-09-16,1200104,202137,87933,87933,0
2021-09-16,1200138,202137,87933,87933,0
2021-09-16,1200179,202137,87932,87933,-1
2021-09-16,1200203,202137,87937,87932,5
2021-09-16,1200302,202137,87938,87937,1
2021-09-16,1200450,202137,87937,87938,-1
2021-09-16,1200500,202137,87937,87937,0
2021-09-16,1200435,202137,87937,87937,0
2021-09-16,1200427,202137,87937,87937,0
2021-09-16,1200401,202137,87940,87937,3
2021-09-16,1200252,202137,87939,87940,-1
2021-09-16,1200393,202137,87939,87939,0
2021-09-16,1200385,202137,87940,87939,1
2021-09-16,1200336,202137,87939,87940,-1
2021-09-16,1200351,202137,87939,87939,0
2021-09-16,1200344,202137,87939,87939,0
2021-09-16,1200328,202137,87939,87939,0
2021-09-16,1200807,202137,87939,87939,0
2021-09-16,1200609,202137,87939,87939,0
2021-09-17,1200013,202137,87939,87939,0
2021-09-17,1200054,202137,87939,87939,0
2021-09-17,1200104,202137,87939,87939,0
2021-09-17,1200435,202137,87939,87939,0
2021-09-17,1200427,202137,87939,87939,0
2021-09-17,1200138,202137,87939,87939,0
2021-09-17,1200500,202137,87939,87939,0
2021-09-17,1200450,202137,87939,87939,0
2021-09-17,1200609,202137,87939,87939,0
2021-09-17,1200708,202137,87939,87939,0
2021-09-17,1200807,202137,87939,87939,0
2021-09-17,1200385,202137,87939,87939,0
2021-09-17,1200336,202137,87939,87939,0
2021-09-17,1200351,202137,87939,87939,0
2021-09-17,1200344,202137,87939,87939,0
2021-09-17,1200328,202137,87939,87939,0
2021-09-17,1200302,202137,87939,87939,0
2021-09-17,1200252,202137,87939,87939,0
2021-09-17,1200203,202137,87939,87939,0
2021-09-17,1200179,202137,87939,87939,0
2021-09-17,1200401,202137,87940,87939,1
2021-09-17,1200393,202137,87940,87940,0
2021-09-18,1200385,202137,87940,87940,0
2021-09-18,1200393,202137,87940,87940,0
2021-09-18,1200054,202137,87940,87940,0
2021-09-18,1200104,202137,87940,87940,0
2021-09-18,1200807,202137,87940,87940,0
2021-09-18,1200138,202137,87940,87940,0
2021-09-18,1200179,202137,87941,87940,1
2021-09-18,1200203,202137,87941,87941,0
2021-09-18,1200252,202137,87941,87941,0
2021-09-18,1200302,202137,87941,87941,0
2021-09-18,1200328,202137,87941,87941,0
2021-09-18,1200344,202137,87941,87941,0
2021-09-18,1200013,202137,87941,87941,0
2021-09-18,1200351,202137,87941,87941,0
2021-09-18,1200336,202137,87941,87941,0
2021-09-18,1200427,202137,87941,87941,0
2021-09-18,1200500,202137,87941,87941,0
2021-09-18,1200450,202137,87941,87941,0
2021-09-18,1200609,202137,87941,87941,0
2021-09-18,1200708,202137,87941,87941,0
2021-09-18,1200401,202137,87945,87941,4
2021-09-18,1200435,202137,87945,87945,0
2021-09-19,1200013,202138,87945,87945,0
2021-09-19,1200054,202138,87945,87945,0
2021-09-19,1200104,202138,87945,87945,0
2021-09-19,1200138,202138,87945,87945,0
2021-09-19,1200179,202138,87945,87945,0
2021-09-19,1200203,202138,87945,87945,0
2021-09-19,1200252,202138,87945,87945,0
2021-09-19,1200328,202138,87945,87945,0
2021-09-19,1200302,202138,87945,87945,0
2021-09-19,1200351,202138,87945,87945,0
2021-09-19,1200336,202138,87945,87945,0
2021-09-19,1200385,202138,87945,87945,0
2021-09-19,1200807,202138,87945,87945,0
2021-09-19,1200393,202138,87945,87945,0
2021-09-19,1200401,202138,87947,87945,2
2021-09-19,1200427,202138,87947,87947,0
2021-09-19,1200435,202138,87947,87947,0
2021-09-19,1200500,202138,87947,87947,0
2021-09-19,1200450,202138,87947,87947,0
2021-09-19,1200609,202138,87947,87947,0
2021-09-19,1200708,202138,87947,87947,0
2021-09-19,1200344,202138,87947,87947,0
2021-09-20,1200104,202138,87947,87947,0
2021-09-20,1200179,202138,87947,87947,0
2021-09-20,1200138,202138,87947,87947,0
2021-09-20,1200013,202138,87947,87947,0
2021-09-20,1200054,202138,87947,87947,0
2021-09-20,1200450,202138,87947,87947,0
2021-09-20,1200609,202138,87947,87947,0
2021-09-20,1200708,202138,87947,87947,0
2021-09-20,1200435,202138,87947,87947,0
2021-09-20,1200427,202138,87947,87947,0
2021-09-20,1200401,202138,87947,87947,0
2021-09-20,1200393,202138,87947,87947,0
2021-09-20,1200807,202138,87947,87947,0
2021-09-20,1200385,202138,87947,87947,0
2021-09-20,1200336,202138,87947,87947,0
2021-09-20,1200351,202138,87947,87947,0
2021-09-20,1200344,202138,87947,87947,0
2021-09-20,1200328,202138,87947,87947,0
2021-09-20,1200302,202138,87947,87947,0
2021-09-20,1200252,202138,87947,87947,0
2021-09-20,1200203,202138,87947,87947,0
2021-09-20,1200500,202138,87947,87947,0
2021-09-21,1200393,202138,87947,87947,0
2021-09-21,1200427,202138,87947,87947,0
2021-09-21,1200054,202138,87947,87947,0
2021-09-21,1200104,202138,87947,87947,0
2021-09-21,1200138,202138,87947,87947,0
2021-09-21,1200179,202138,87947,87947,0
2021-09-21,1200203,202138,87947,87947,0
2021-09-21,1200401,202138,87947,87947,0
2021-09-21,1200252,202138,87947,87947,0
2021-09-21,1200302,202138,87947,87947,0
2021-09-21,1200328,202138,87947,87947,0
2021-09-21,1200344,202138,87947,87947,0
2021-09-21,1200351,202138,87947,87947,0
2021-09-21,1200336,202138,87947,87947,0
2021-09-21,1200013,202138,87947,87947,0
2021-09-21,1200385,202138,87947,87947,0
2021-09-21,1200807,202138,87947,87947,0
2021-09-21,1200435,202138,87947,87947,0
2021-09-21,1200500,202138,87947,87947,0
2021-09-21,1200450,202138,87947,87947,0
2021-09-21,1200609,202138,87947,87947,0
2021-09-21,1200708,202138,87947,87947,0
2021-09-22,1200435,202138,87947,87947,0
2021-09-22,1200393,202138,87947,87947,0
2021-09-22,1200500,202138,87947,87947,0
2021-09-22,1200450,202138,87947,87947,0
2021-09-22,1200609,202138,87947,87947,0
2021-09-22,1200708,202138,87947,87947,0
2021-09-22,1200807,202138,87947,87947,0
2021-09-22,1200385,202138,87947,87947,0
2021-09-22,1200336,202138,87947,87947,0
2021-09-22,1200351,202138,87947,87947,0
2021-09-22,1200302,202138,87947,87947,0
2021-09-22,1200328,202138,87947,87947,0
2021-09-22,1200427,202138,87947,87947,0
2021-09-22,1200252,202138,87947,87947,0
2021-09-22,1200203,202138,87947,87947,0
2021-09-22,1200179,202138,87947,87947,0
2021-09-22,1200138,202138,87947,87947,0
2021-09-22,1200104,202138,87947,87947,0
2021-09-22,1200054,202138,87947,87947,0
2021-09-22,1200013,202138,87947,87947,0
2021-09-22,1200344,202138,87947,87947,0
2021-09-22,1200401,202138,87947,87947,0
2021-09-23,1200252,202138,87947,87947,0
2021-09-23,1200013,202138,87947,87947,0
2021-09-23,1200302,202138,87947,87947,0
2021-09-23,1200328,202138,87947,87947,0
2021-09-23,1200344,202138,87947,87947,0
2021-09-23,1200351,202138,87947,87947,0
2021-09-23,1200336,202138,87947,87947,0
2021-09-23,1200385,202138,87947,87947,0
2021-09-23,1200179,202138,87947,87947,0
2021-09-23,1200393,202138,87947,87947,0
2021-09-23,1200203,202138,87947,87947,0
2021-09-23,1200401,202138,87949,87947,2
2021-09-23,1200435,202138,87949,87949,0
2021-09-23,1200500,202138,87949,87949,0
2021-09-23,1200450,202138,87949,87949,0
2021-09-23,1200609,202138,87949,87949,0
2021-09-23,1200708,202138,87949,87949,0
2021-09-23,1200138,202138,87949,87949,0
2021-09-23,1200104,202138,87949,87949,0
2021-09-23,1200054,202138,87949,87949,0
2021-09-23,1200427,202138,87949,87949,0
2021-09-23,1200807,202138,87949,87949,0
2021-09-24,1200302,202138,87949,87949,0
2021-09-24,1200401,202138,87951,87949,2
2021-09-24,1200708,202138,87951,87951,0
2021-09-24,1200609,202138,87951,87951,0
2021-09-24,1200450,202138,87951,87951,0
2021-09-24,1200500,202138,87951,87951,0
2021-09-24,1200435,202138,87951,87951,0
2021-09-24,1200427,202138,87951,87951,0
2021-09-24,1200393,202138,87951,87951,0
2021-09-24,1200807,202138,87951,87951,0
2021-09-24,1200336,202138,87951,87951,0
2021-09-24,1200385,202138,87951,87951,0
2021-09-24,1200344,202138,87951,87951,0
2021-09-24,1200328,202138,87951,87951,0
2021-09-24,1200252,202138,87951,87951,0
2021-09-24,1200203,202138,87951,87951,0
2021-09-24,1200179,202138,87951,87951,0
2021-09-24,1200138,202138,87951,87951,0
2021-09-24,1200104,202138,87952,87951,1
2021-09-24,1200054,202138,87952,87952,0
2021-09-24,1200013,202138,87952,87952,0
2021-09-24,1200351,202138,87952,87952,0
2021-09-25,1200252,202138,87952,87952,0
2021-09-25,1200328,202138,87952,87952,0
2021-09-25,1200302,202138,87952,87952,0
2021-09-25,1200203,202138,87952,87952,0
2021-09-25,1200385,202138,87952,87952,0
2021-09-25,1200138,202138,87952,87952,0
2021-09-25,1200054,202138,87952,87952,0
2021-09-25,1200013,202138,87952,87952,0
2021-09-25,1200344,202138,87952,87952,0
2021-09-25,1200179,202138,87952,87952,0
2021-09-25,1200336,202138,87952,87952,0
2021-09-25,1200351,202138,87952,87952,0
2021-09-25,1200104,202138,87952,87952,0
2021-09-25,1200807,202138,87952,87952,0
2021-09-25,1200393,202138,87952,87952,0
2021-09-25,1200401,202138,87953,87952,1
2021-09-25,1200427,202138,87953,87953,0
2021-09-25,1200435,202138,87953,87953,0
2021-09-25,1200500,202138,87953,87953,0
2021-09-25,1200450,202138,87953,87953,0
2021-09-25,1200609,202138,87953,87953,0
2021-09-25,1200708,202138,87953,87953,0
2021-09-26,1200013,202139,87953,87953,0
2021-09-26,1200054,202139,87953,87953,0
2021-09-26,1200104,202139,87953,87953,0
2021-09-26,1200138,202139,87953,87953,0
2021-09-26,1200179,202139,87953,87953,0
2021-09-26,1200609,202139,87953,87953,0
2021-09-26,1200252,202139,87953,87953,0
2021-09-26,1200302,202139,87953,87953,0
2021-09-26,1200328,202139,87953,87953,0
2021-09-26,1200344,202139,87953,87953,0
2021-09-26,1200351,202139,87953,87953,0
2021-09-26,1200336,202139,87953,87953,0
2021-09-26,1200385,202139,87953,87953,0
2021-09-26,1200807,202139,87953,87953,0
2021-09-26,1200393,202139,87953,87953,0
2021-09-26,1200401,202139,87953,87953,0
2021-09-26,1200427,202139,87953,87953,0
2021-09-26,1200435,202139,87953,87953,0
2021-09-26,1200500,202139,87953,87953,0
2021-09-26,1200450,202139,87953,87953,0
2021-09-26,1200708,202139,87953,87953,0
2021-09-26,1200203,202139,87953,87953,0
2021-09-27,1200500,202139,87953,87953,0
2021-09-27,1200054,202139,87953,87953,0
2021-09-27,1200708,202139,87953,87953,0
2021-09-27,1200609,202139,87953,87953,0
2021-09-27,1200450,202139,87953,87953,0
2021-09-27,1200435,202139,87953,87953,0
2021-09-27,1200401,202139,87954,87953,1
2021-09-27,1200393,202139,87954,87954,0
2021-09-27,1200807,202139,87954,87954,0
2021-09-27,1200385,202139,87954,87954,0
2021-09-27,1200336,202139,87954,87954,0
2021-09-27,1200427,202139,87954,87954,0
2021-09-27,1200344,202139,87954,87954,0
2021-09-27,1200328,202139,87954,87954,0
2021-09-27,1200302,202139,87954,87954,0
2021-09-27,1200252,202139,87954,87954,0
2021-09-27,1200203,202139,87954,87954,0
2021-09-27,1200179,202139,87954,87954,0
2021-09-27,1200138,202139,87954,87954,0
2021-09-27,1200104,202139,87954,87954,0
2021-09-27,1200013,202139,87954,87954,0
2021-09-27,1200351,202139,87954,87954,0
2021-09-28,1200344,202139,87954,87954,0
2021-09-28,1200328,202139,87954,87954,0
2021-09-28,1200302,202139,87954,87954,0
2021-09-28,1200252,202139,87954,87954,0
2021-09-28,1200203,202139,87954,87954,0
2021-09-28,1200013,202139,87954,87954,0
2021-09-28,1200138,202139,87954,87954,0
2021-09-28,1200104,202139,87955,87954,1
2021-09-28,1200054,202139,87955,87955,0
2021-09-28,1200351,202139,87955,87955,0
2021-09-28,1200179,202139,87955,87955,0
2021-09-28,1200336,202139,87955,87955,0
2021-09-28,1200385,202139,87955,87955,0
2021-09-28,1200807,202139,87955,87955,0
2021-09-28,1200393,202139,87955,87955,0
2021-09-28,1200401,202139,87955,87955,0
2021-09-28,1200427,202139,87955,87955,0
2021-09-28,1200435,202139,87955,87955,0
2021-09-28,1200500,202139,87955,87955,0
2021-09-28,1200450,202139,87955,87955,0
2021-09-28,1200609,202139,87955,87955,0
2021-09-28,1200708,202139,87955,87955,0
2021-09-29,1200708,202139,87954,87955,-1
2021-09-29,1200013,202139,87954,87954,0
2021-09-29,1200054,202139,87952,87954,-2
2021-09-29,1200104,202139,87952,87952,0
2021-09-29,1200138,202139,87952,87952,0
2021-09-29,1200179,202139,87951,87952,-1
2021-09-29,1200203,202139,87947,87951,-4
2021-09-29,1200807,202139,87947,87947,0
2021-09-29,1200450,202139,87947,87947,0
2021-09-29,1200500,202139,87947,87947,0
2021-09-29,1200435,202139,87947,87947,0
2021-09-29,1200427,202139,87946,87947,-1
2021-09-29,1200401,202139,87944,87946,-2
2021-09-29,1200393,202139,87944,87944,0
2021-09-29,1200252,202139,87943,87944,-1
2021-09-29,1200609,202139,87941,87943,-2
2021-09-29,1200336,202139,87939,87941,-2
2021-09-29,1200351,202139,87938,87939,-1
2021-09-29,1200344,202139,87938,87938,0
2021-09-29,1200328,202139,87938,87938,0
2021-09-29,1200302,202139,87938,87938,0
2021-09-29,1200385,202139,87938,87938,0
2021-09-30,1200054,202139,87938,87938,0
2021-09-30,1200013,202139,87938,87938,0
2021-09-30,1200104,202139,87938,87938,0
2021-09-30,1200708,202139,87938,87938,0
2021-09-30,1200450,202139,87938,87938,0
2021-09-30,1200500,202139,87939,87938,1
2021-09-30,1200435,202139,87939,87939,0
2021-09-30,1200427,202139,87939,87939,0
2021-09-30,1200401,202139,87939,87939,0
2021-09-30,1200393,202139,87939,87939,0
2021-09-30,1200807,202139,87939,87939,0
2021-09-30,1200385,202139,87939,87939,0
2021-09-30,1200336,202139,87939,87939,0
2021-09-30,1200351,202139,87939,87939,0
2021-09-30,1200344,202139,87939,87939,0
2021-09-30,1200328,202139,87939,87939,0
2021-09-30,1200302,202139,87939,87939,0
2021-09-30,1200252,202139,87939,87939,0
2021-09-30,1200203,202139,87939,87939,0
2021-09-30,1200179,202139,87939,87939,0
2021-09-30,1200138,202139,87939,87939,0
2021-09-30,1200609,202139,87939,87939,0
2021-10-01,1200807,202139,87939,87939,0
2021-10-01,1200393,202139,87939,87939,0
2021-10-01,1200054,202139,87939,87939,0
2021-10-01,1200401,202139,87940,87939,1
2021-10-01,1200427,202139,87940,87940,0
2021-10-01,1200385,202139,87940,87940,0
2021-10-01,1200500,202139,87940,87940,0
2021-10-01,1200450,202139,87940,87940,0
2021-10-01,1200609,202139,87940,87940,0
2021-10-01,1200708,202139,87940,87940,0
2021-10-01,1200336,202139,87940,87940,0
2021-10-01,1200351,202139,87940,87940,0
2021-10-01,1200344,202139,87940,87940,0
2021-10-01,1200328,202139,87940,87940,0
2021-10-01,1200302,202139,87940,87940,0
2021-10-01,1200252,202139,87940,87940,0
2021-10-01,1200203,202139,87940,87940,0
2021-10-01,1200179,202139,87940,87940,0
2021-10-01,1200138,202139,87940,87940,0
2021-10-01,1200104,202139,87940,87940,0
2021-10-01,1200013,202139,87940,87940,0
2021-10-01,1200435,202139,87940,87940,0
2021-10-02,1200435,202139,87940,87940,0
2021-10-02,1200708,202139,87940,87940,0
2021-10-02,1200500,202139,87940,87940,0
2021-10-02,1200427,202139,87940,87940,0
2021-10-02,1200401,202139,87941,87940,1
2021-10-02,1200393,202139,87941,87941,0
2021-10-02,1200807,202139,87941,87941,0
2021-10-02,1200385,202139,87941,87941,0
2021-10-02,1200336,202139,87941,87941,0
2021-10-02,1200351,202139,87941,87941,0
2021-10-02,1200344,202139,87941,87941,0
2021-10-02,1200328,202139,87941,87941,0
2021-10-02,1200302,202139,87941,87941,0
2021-10-02,1200252,202139,87941,87941,0
2021-10-02,1200203,202139,87941,87941,0
2021-10-02,1200179,202139,87941,87941,0
2021-10-02,1200138,202139,87941,87941,0
2021-10-02,1200104,202139,87941,87941,0
2021-10-02,1200054,202139,87941,87941,0
2021-10-02,1200450,202139,87941,87941,0
2021-10-02,1200609,202139,87941,87941,0
2021-10-02,1200013,202139,87941,87941,0
2021-10-03,1200336,202140,87941,87941,0
2021-10-03,1200807,202140,87941,87941,0
2021-10-03,1200393,202140,87941,87941,0
2021-10-03,1200401,202140,87941,87941,0
2021-10-03,1200427,202140,87941,87941,0
2021-10-03,1200435,202140,87941,87941,0
2021-10-03,1200500,202140,87941,87941,0
2021-10-03,1200450,202140,87941,87941,0
2021-10-03,1200609,202140,87941,87941,0
2021-10-03,1200708,202140,87941,87941,0
2021-10-03,1200351,202140,87941,87941,0
2021-10-03,1200344,202140,87941,87941,0
2021-10-03,1200328,202140,87941,87941,0
2021-10-03,1200302,202140,87941,87941,0
2021-10-03,1200252,202140,87941,87941,0
2021-10-03,1200203,202140,87941,87941,0
2021-10-03,1200179,202140,87941,87941,0
2021-10-03,1200138,202140,87941,87941,0
2021-10-03,1200104,202140,87941,87941,0
2021-10-03,1200054,202140,87941,87941,0
2021-10-03,1200013,202140,87941,87941,0
2021-10-03,1200385,202140,87941,87941,0
2021-10-04,1200252,202140,87941,87941,0
2021-10-04,1200427,202140,87941,87941,0
2021-10-04,1200708,202140,87941,87941,0
2021-10-04,1200609,202140,87941,87941,0
2021-10-04,1200450,202140,87941,87941,0
2021-10-04,1200500,202140,87941,87941,0
2021-10-04,1200435,202140,87941,87941,0
2021-10-04,1200401,202140,87945,87941,4
2021-10-04,1200393,202140,87945,87945,0
2021-10-04,1200807,202140,87945,87945,0
2021-10-04,1200336,202140,87945,87945,0
2021-10-04,1200385,202140,87945,87945,0
2021-10-04,1200344,202140,87945,87945,0
2021-10-04,1200328,202140,87945,87945,0
2021-10-04,1200302,202140,87945,87945,0
2021-10-04,1200203,202140,87945,87945,0
2021-10-04,1200179,202140,87945,87945,0
2021-10-04,1200138,202140,87945,87945,0
2021-10-04,1200104,202140,87945,87945,0
2021-10-04,1200054,202140,87945,87945,0
2021-10-04,1200013,202140,87945,87945,0
2021-10-04,1200351,202140,87945,87945,0
2021-10-05,1200252,202140,87945,87945,0
2021-10-05,1200344,202140,87945,87945,0
2021-10-05,1200328,202140,87945,87945,0
2021-10-05,1200302,202140,87945,87945,0
2021-10-05,1200203,202140,87945,87945,0
2021-10-05,1200385,202140,87945,87945,0
2021-10-05,1200138,202140,87945,87945,0
2021-10-05,1200104,202140,87945,87945,0
2021-10-05,1200013,202140,87945,87945,0
2021-10-05,1200351,202140,87946,87945,1
2021-10-05,1200179,202140,87946,87946,0
2021-10-05,1200336,202140,87946,87946,0
2021-10-05,1200054,202140,87946,87946,0
2021-10-05,1200393,202140,87946,87946,0
2021-10-05,1200401,202140,87946,87946,0
2021-10-05,1200427,202140,87946,87946,0
2021-10-05,1200435,202140,87946,87946,0
2021-10-05,1200500,202140,87946,87946,0
2021-10-05,1200450,202140,87946,87946,0
2021-10-05,1200609,202140,87946,87946,0
2021-10-05,1200708,202140,87946,87946,0
2021-10-05,1200807,202140,87946,87946,0
2021-10-06,1200708,202140,87946,87946,0
2021-10-06,1200013,202140,87946,87946,0
2021-10-06,1200054,202140,87946,87946,0
2021-10-06,1200104,202140,87946,87946,0
2021-10-06,1200138,202140,87946,87946,0
2021-10-06,1200179,202140,87946,87946,0
2021-10-06,1200203,202140,87946,87946,0
2021-10-06,1200302,202140,87946,87946,0
2021-10-06,1200450,202140,87946,87946,0
2021-10-06,1200500,202140,87946,87946,0
2021-10-06,1200435,202140,87946,87946,0
2021-10-06,1200427,202140,87946,87946,0
2021-10-06,1200401,202140,87946,87946,0
2021-10-06,1200252,202140,87946,87946,0
2021-10-06,1200393,202140,87946,87946,0
2021-10-06,1200385,202140,87946,87946,0
2021-10-06,1200336,202140,87946,87946,0
2021-10-06,1200351,202140,87946,87946,0
2021-10-06,1200344,202140,87946,87946,0
2021-10-06,1200328,202140,87946,87946,0
2021-10-06,1200807,202140,87946,87946,0
2021-10-06,1200609,202140,87946,87946,0
2021-10-07,1200013,202140,87946,87946,0
2021-10-07,1200054,202140,87946,87946,0
2021-10-07,1200104,202140,87946,87946,0
2021-10-07,1200179,202140,87946,87946,0
2021-10-07,1200252,202140,87946,87946,0
2021-10-07,1200302,202140,87946,87946,0
2021-10-07,1200328,202140,87946,87946,0
2021-10-07,1200344,202140,87946,87946,0
2021-10-07,1200351,202140,87946,87946,0
2021-10-07,1200336,202140,87946,87946,0
2021-10-07,1200385,202140,87946,87946,0
2021-10-07,1200807,202140,87946,87946,0
2021-10-07,1200393,202140,87946,87946,0
2021-10-07,1200401,202140,87952,87946,6
2021-10-07,1200427,202140,87952,87952,0
2021-10-07,1200435,202140,87952,87952,0
2021-10-07,1200500,202140,87952,87952,0
2021-10-07,1200203,202140,87952,87952,0
2021-10-07,1200450,202140,87952,87952,0
2021-10-07,1200609,202140,87952,87952,0
2021-10-07,1200708,202140,87952,87952,0
2021-10-07,1200138,202140,87953,87952,1
2021-10-08,1200013,202140,87953,87953,0
2021-10-08,1200054,202140,87953,87953,0
2021-10-08,1200104,202140,87953,87953,0
2021-10-08,1200138,202140,87953,87953,0
2021-10-08,1200179,202140,87953,87953,0
2021-10-08,1200203,202140,87953,87953,0
2021-10-08,1200252,202140,87953,87953,0
2021-10-08,1200302,202140,87953,87953,0
2021-10-08,1200328,202140,87953,87953,0
2021-10-08,1200344,202140,87953,87953,0
2021-10-08,1200351,202140,87953,87953,0
2021-10-08,1200385,202140,87953,87953,0
2021-10-08,1200393,202140,87953,87953,0
2021-10-08,1200807,202140,87953,87953,0
2021-10-08,1200401,202140,87953,87953,0
2021-10-08,1200427,202140,87953,87953,0
2021-10-08,1200435,202140,87953,87953,0
2021-10-08,1200500,202140,87955,87953,2
2021-10-08,1200450,202140,87955,87955,0
2021-10-08,1200609,202140,87955,87955,0
2021-10-08,1200708,202140,87955,87955,0
2021-10-08,1200336,202140,87955,87955,0
2021-10-09,1200013,202140,87955,87955,0
2021-10-09,1200054,202140,87955,87955,0
2021-10-09,1200104,202140,87955,87955,0
2021-10-09,1200138,202140,87955,87955,0
2021-10-09,1200179,202140,87955,87955,0
2021-10-09,1200203,202140,87956,87955,1
2021-10-09,1200708,202140,87956,87956,0
2021-10-09,1200328,202140,87956,87956,0
2021-10-09,1200344,202140,87956,87956,0
2021-10-09,1200351,202140,87956,87956,0
2021-10-09,1200336,202140,87956,87956,0
2021-10-09,1200385,202140,87956,87956,0
2021-10-09,1200807,202140,87956,87956,0
2021-10-09,1200393,202140,87956,87956,0
2021-10-09,1200401,202140,87959,87956,3
2021-10-09,1200427,202140,87959,87959,0
2021-10-09,1200435,202140,87959,87959,0
2021-10-09,1200500,202140,87959,87959,0
2021-10-09,1200450,202140,87959,87959,0
2021-10-09,1200609,202140,87959,87959,0
2021-10-09,1200302,202140,87959,87959,0
2021-10-09,1200252,202140,87959,87959,0
2021-10-10,1200435,202141,87959,87959,0
2021-10-10,1200393,202141,87959,87959,0
2021-10-10,1200708,202141,87959,87959,0
2021-10-10,1200609,202141,87959,87959,0
2021-10-10,1200450,202141,87959,87959,0
2021-10-10,1200500,202141,87959,87959,0
2021-10-10,1200427,202141,87959,87959,0
2021-10-10,1200401,202141,87959,87959,0
2021-10-10,1200807,202141,87959,87959,0
2021-10-10,1200385,202141,87959,87959,0
2021-10-10,1200351,202141,87959,87959,0
2021-10-10,1200336,202141,87959,87959,0
2021-10-10,1200328,202141,87959,87959,0
2021-10-10,1200302,202141,87959,87959,0
2021-10-10,1200252,202141,87959,87959,0
2021-10-10,1200203,202141,87959,87959,0
2021-10-10,1200179,202141,87959,87959,0
2021-10-10,1200138,202141,87959,87959,0
2021-10-10,1200104,202141,87959,87959,0
2021-10-10,1200054,202141,87959,87959,0
2021-10-10,1200013,202141,87959,87959,0
2021-10-10,1200344,202141,87959,87959,0
2021-10-11,1200203,202141,87959,87959,0
2021-10-11,1200302,202141,87959,87959,0
2021-10-11,1200252,202141,87959,87959,0
2021-10-11,1200179,202141,87959,87959,0
2021-10-11,1200351,202141,87959,87959,0
2021-10-11,1200104,202141,87959,87959,0
2021-10-11,1200054,202141,87959,87959,0
2021-10-11,1200013,202141,87959,87959,0
2021-10-11,1200328,202141,87959,87959,0
2021-10-11,1200138,202141,87959,87959,0
2021-10-11,1200336,202141,87959,87959,0
2021-10-11,1200344,202141,87959,87959,0
2021-10-11,1200385,202141,87959,87959,0
2021-10-11,1200807,202141,87959,87959,0
2021-10-11,1200393,202141,87959,87959,0
2021-10-11,1200401,202141,87959,87959,0
2021-10-11,1200427,202141,87959,87959,0
2021-10-11,1200435,202141,87959,87959,0
2021-10-11,1200500,202141,87959,87959,0
2021-10-11,1200450,202141,87959,87959,0
2021-10-11,1200609,202141,87959,87959,0
2021-10-11,1200708,202141,87959,87959,0
2021-10-12,1200013,202141,87959,87959,0
2021-10-12,1200054,202141,87959,87959,0
2021-10-12,1200104,202141,87959,87959,0
2021-10-12,1200138,202141,87959,87959,0
2021-10-12,1200179,202141,87959,87959,0
2021-10-12,1200609,202141,87959,87959,0
2021-10-12,1200252,202141,87959,87959,0
2021-10-12,1200302,202141,87959,87959,0
2021-10-12,1200328,202141,87959,87959,0
2021-10-12,1200344,202141,87959,87959,0
2021-10-12,1200351,202141,87959,87959,0
2021-10-12,1200336,202141,87959,87959,0
2021-10-12,1200385,202141,87959,87959,0
2021-10-12,1200807,202141,87959,87959,0
2021-10-12,1200393,202141,87959,87959,0
2021-10-12,1200401,202141,87959,87959,0
2021-10-12,1200427,202141,87959,87959,0
2021-10-12,1200435,202141,87959,87959,0
2021-10-12,1200500,202141,87959,87959,0
2021-10-12,1200450,202141,87959,87959,0
2021-10-12,1200708,202141,87959,87959,0
2021-10-12,1200203,202141,87959,87959,0
2021-10-13,1200336,202141,87959,87959,0
2021-10-13,1200427,202141,87959,87959,0
2021-10-13,1200708,202141,87959,87959,0
2021-10-13,1200609,202141,87959,87959,0
2021-10-13,1200450,202141,87959,87959,0
2021-10-13,1200500,202141,87959,87959,0
2021-10-13,1200435,202141,87959,87959,0
2021-10-13,1200401,202141,87959,87959,0
2021-10-13,1200393,202141,87959,87959,0
2021-10-13,1200807,202141,87959,87959,0
2021-10-13,1200351,202141,87959,87959,0
2021-10-13,1200385,202141,87959,87959,0
2021-10-13,1200328,202141,87959,87959,0
2021-10-13,1200302,202141,87959,87959,0
2021-10-13,1200252,202141,87959,87959,0
2021-10-13,1200203,202141,87959,87959,0
2021-10-13,1200179,202141,87959,87959,0
2021-10-13,1200138,202141,87959,87959,0
2021-10-13,1200104,202141,87959,87959,0
2021-10-13,1200054,202141,87959,87959,0
2021-10-13,1200013,202141,87959,87959,0
2021-10-13,1200344,202141,87959,87959,0
2021-10-14,1200203,202141,87959,87959,0
2021-10-14,1200344,202141,87959,87959,0
2021-10-14,1200328,202141,87959,87959,0
2021-10-14,1200302,202141,87959,87959,0
2021-10-14,1200179,202141,87959,87959,0
2021-10-14,1200385,202141,87959,87959,0
2021-10-14,1200104,202141,87959,87959,0
2021-10-14,1200054,202141,87959,87959,0
2021-10-14,1200013,202141,87959,87959,0
2021-10-14,1200351,202141,87959,87959,0
2021-10-14,1200138,202141,87959,87959,0
2021-10-14,1200336,202141,87959,87959,0
2021-10-14,1200252,202141,87959,87959,0
2021-10-14,1200807,202141,87959,87959,0
2021-10-14,1200393,202141,87959,87959,0
2021-10-14,1200401,202141,87959,87959,0
2021-10-14,1200427,202141,87959,87959,0
2021-10-14,1200435,202141,87959,87959,0
2021-10-14,1200500,202141,87959,87959,0
2021-10-14,1200450,202141,87959,87959,0
2021-10-14,1200609,202141,87959,87959,0
2021-10-14,1200708,202141,87959,87959,0
2021-10-15,1200708,202141,87959,87959,0
2021-10-15,1200013,202141,87959,87959,0
2021-10-15,1200054,202141,87959,87959,0
2021-10-15,1200104,202141,87959,87959,0
2021-10-15,1200138,202141,87963,87959,4
2021-10-15,1200179,202141,87964,87963,1
2021-10-15,1200203,202141,87965,87964,1
2021-10-15,1200807,202141,87967,87965,2
2021-10-15,1200450,202141,87969,87967,2
2021-10-15,1200500,202141,87969,87969,0
2021-10-15,1200435,202141,87969,87969,0
2021-10-15,1200427,202141,87970,87969,1
2021-10-15,1200401,202141,88012,87970,42
2021-10-15,1200393,202141,88012,88012,0
2021-10-15,1200252,202141,88012,88012,0
2021-10-15,1200609,202141,88014,88012,2
2021-10-15,1200336,202141,88014,88014,0
2021-10-15,1200351,202141,88014,88014,0
2021-10-15,1200344,202141,88014,88014,0
2021-10-15,1200328,202141,88014,88014,0
2021-10-15,1200302,202141,88014,88014,0
2021-10-15,1200385,202141,88016,88014,2
2021-10-16,1200054,202141,88016,88016,0
2021-10-16,1200013,202141,88016,88016,0
2021-10-16,1200104,202141,88016,88016,0
2021-10-16,1200708,202141,88016,88016,0
2021-10-16,1200450,202141,88016,88016,0
2021-10-16,1200500,202141,88016,88016,0
2021-10-16,1200435,202141,88016,88016,0
2021-10-16,1200427,202141,88016,88016,0
2021-10-16,1200401,202141,88016,88016,0
2021-10-16,1200393,202141,88016,88016,0
2021-10-16,1200807,202141,88016,88016,0
2021-10-16,1200385,202141,88016,88016,0
2021-10-16,1200336,202141,88016,88016,0
2021-10-16,1200351,202141,88016,88016,0
2021-10-16,1200344,202141,88016,88016,0
2021-10-16,1200328,202141,88016,88016,0
2021-10-16,1200302,202141,88016,88016,0
2021-10-16,1200252,202141,88016,88016,0
2021-10-16,1200203,202141,88016,88016,0
2021-10-16,1200179,202141,88016,88016,0
2021-10-16,1200138,202141,88016,88016,0
2021-10-16,1200609,202141,88016,88016,0
2021-10-17,1200807,202142,88016,88016,0
2021-10-17,1200393,202142,88016,88016,0
2021-10-17,1200054,202142,88016,88016,0
2021-10-17,1200401,202142,88016,88016,0
2021-10-17,1200427,202142,88016,88016,0
2021-10-17,1200385,202142,88016,88016,0
2021-10-17,1200500,202142,88016,88016,0
2021-10-17,1200450,202142,88016,88016,0
2021-10-17,1200609,202142,88016,88016,0
2021-10-17,1200708,202142,88016,88016,0
2021-10-17,1200336,202142,88016,88016,0
2021-10-17,1200351,202142,88016,88016,0
2021-10-17,1200344,202142,88016,88016,0
2021-10-17,1200328,202142,88016,88016,0
2021-10-17,1200302,202142,88016,88016,0
2021-10-17,1200252,202142,88016,88016,0
2021-10-17,1200203,202142,88016,88016,0
2021-10-17,1200179,202142,88016,88016,0
2021-10-17,1200138,202142,88016,88016,0
2021-10-17,1200104,202142,88016,88016,0
2021-10-17,1200013,202142,88016,88016,0
2021-10-17,1200435,202142,88016,88016,0
2021-10-18,1200435,202142,88016,88016,0
2021-10-18,1200708,202142,88016,88016,0
2021-10-18,1200500,202142,88016,88016,0
2021-10-18,1200427,202142,88016,88016,0
2021-10-18,1200401,202142,88016,88016,0
2021-10-18,1200393,202142,88016,88016,0
2021-10-18,1200807,202142,88016,88016,0
2021-10-18,1200385,202142,88016,88016,0
2021-10-18,1200336,202142,88016,88016,0
2021-10-18,1200351,202142,88016,88016,0
2021-10-18,1200344,202142,88016,88016,0
2021-10-18,1200328,202142,88016,88016,0
2021-10-18,1200302,202142,88016,88016,0
2021-10-18,1200252,202142,88016,88016,0
2021-10-18,1200203,202142,88016,88016,0
2021-10-18,1200179,202142,88016,88016,0
2021-10-18,1200138,202142,88016,88016,0
2021-10-18,1200104,202142,88016,88016,0
2021-10-18,1200054,202142,88016,88016,0
2021-10-18,1200450,202142,88016,88016,0
2021-10-18,1200609,202142,88016,88016,0
2021-10-18,1200013,202142,88016,88016,0
2021-10-19,1200336,202142,88016,88016,0
2021-10-19,1200807,202142,88016,88016,0
2021-10-19,1200393,202142,88016,88016,0
2021-10-19,1200401,202142,88016,88016,0
2021-10-19,1200427,202142,88016,88016,0
2021-10-19,1200435,202142,88016,88016,0
2021-10-19,1200500,202142,88016,88016,0
2021-10-19,1200450,202142,88016,88016,0
2021-10-19,1200609,202142,88016,88016,0
2021-10-19,1200708,202142,88016,88016,0
2021-10-19,1200351,202142,88016,88016,0
2021-10-19,1200344,202142,88016,88016,0
2021-10-19,1200328,202142,88016,88016,0
2021-10-19,1200302,202142,88016,88016,0
2021-10-19,1200252,202142,88016,88016,0
2021-10-19,1200203,202142,88016,88016,0
2021-10-19,1200179,202142,88016,88016,0
2021-10-19,1200138,202142,88016,88016,0
2021-10-19,1200104,202142,88016,88016,0
2021-10-19,1200054,202142,88016,88016,0
2021-10-19,1200013,202142,88016,88016,0
2021-10-19,1200385,202142,88016,88016,0
2021-10-20,1200336,202142,88016,88016,0
2021-10-20,1200427,202142,88016,88016,0
2021-10-20,1200708,202142,88016,88016,0
2021-10-20,1200609,202142,88016,88016,0
2021-10-20,1200450,202142,88016,88016,0
2021-10-20,1200500,202142,88016,88016,0
2021-10-20,1200435,202142,88016,88016,0
2021-10-20,1200401,202142,88016,88016,0
2021-10-20,1200393,202142,88016,88016,0
2021-10-20,1200807,202142,88016,88016,0
2021-10-20,1200351,202142,88016,88016,0
2021-10-20,1200385,202142,88016,88016,0
2021-10-20,1200328,202142,88016,88016,0
2021-10-20,1200302,202142,88016,88016,0
2021-10-20,1200252,202142,88016,88016,0
2021-10-20,1200203,202142,88016,88016,0
2021-10-20,1200179,202142,88016,88016,0
2021-10-20,1200138,202142,88016,88016,0
2021-10-20,1200104,202142,88016,88016,0
2021-10-20,1200054,202142,88016,88016,0
2021-10-20,1200013,202142,88016,88016,0
2021-10-20,1200344,202142,88016,88016,0
2021-10-21,1200203,202142,88016,88016,0
2021-10-21,1200344,202142,88016,88016,0
2021-10-21,1200328,202142,88016,88016,0
2021-10-21,1200302,202142,88016,88016,0
2021-10-21,1200179,202142,88016,88016,0
2021-10-21,1200385,202142,88016,88016,0
2021-10-21,1200104,202142,88016,88016,0
2021-10-21,1200054,202142,88016,88016,0
2021-10-21,1200013,202142,88016,88016,0
2021-10-21,1200351,202142,88016,88016,0
2021-10-21,1200138,202142,88016,88016,0
2021-10-21,1200336,202142,88016,88016,0
2021-10-21,1200252,202142,88016,88016,0
2021-10-21,1200393,202142,88016,88016,0
2021-10-21,1200401,202142,88016,88016,0
2021-10-21,1200427,202142,88016,88016,0
2021-10-21,1200435,202142,88016,88016,0
2021-10-21,1200500,202142,88016,88016,0
2021-10-21,1200450,202142,88016,88016,0
2021-10-21,1200609,202142,88016,88016,0
2021-10-21,1200708,202142,88016,88016,0
2021-10-21,1200807,202142,88016,88016,0
2021-10-22,1200708,202142,88017,88016,1
2021-10-22,1200013,202142,88017,88017,0
2021-10-22,1200054,202142,88017,88017,0
2021-10-22,1200104,202142,88017,88017,0
2021-10-22,1200138,202142,88017,88017,0
2021-10-22,1200179,202142,88017,88017,0
2021-10-22,1200203,202142,88021,88017,4
2021-10-22,1200302,202142,88021,88021,0
2021-10-22,1200450,202142,88022,88021,1
2021-10-22,1200500,202142,88022,88022,0
2021-10-22,1200435,202142,88022,88022,0
2021-10-22,1200427,202142,88022,88022,0
2021-10-22,1200401,202142,88038,88022,16
2021-10-22,1200252,202142,88038,88038,0
2021-10-22,1200393,202142,88038,88038,0
2021-10-22,1200385,202142,88037,88038,-1
2021-10-22,1200336,202142,88037,88037,0
2021-10-22,1200351,202142,88037,88037,0
2021-10-22,1200344,202142,88037,88037,0
2021-10-22,1200328,202142,88037,88037,0
2021-10-22,1200807,202142,88038,88037,1
2021-10-22,1200609,202142,88038,88038,0
2021-10-23,1200013,202142,88038,88038,0
2021-10-23,1200054,202142,88038,88038,0
2021-10-23,1200104,202142,88038,88038,0
2021-10-23,1200435,202142,88038,88038,0
2021-10-23,1200427,202142,88038,88038,0
2021-10-23,1200138,202142,88038,88038,0
2021-10-23,1200500,202142,88038,88038,0
2021-10-23,1200450,202142,88038,88038,0
2021-10-23,1200609,202142,88038,88038,0
2021-10-23,1200708,202142,88038,88038,0
2021-10-23,1200807,202142,88038,88038,0
2021-10-23,1200385,202142,88038,88038,0
2021-10-23,1200336,202142,88038,88038,0
2021-10-23,1200351,202142,88038,88038,0
2021-10-23,1200344,202142,88038,88038,0
2021-10-23,1200328,202142,88038,88038,0
2021-10-23,1200302,202142,88038,88038,0
2021-10-23,1200252,202142,88038,88038,0
2021-10-23,1200203,202142,88038,88038,0
2021-10-23,1200179,202142,88038,88038,0
2021-10-23,1200401,202142,88038,88038,0
2021-10-23,1200393,202142,88038,88038,0
2021-10-24,1200385,202143,88038,88038,0
2021-10-24,1200393,202143,88038,88038,0
2021-10-24,1200054,202143,88038,88038,0
2021-10-24,1200104,202143,88038,88038,0
2021-10-24,1200807,202143,88038,88038,0
2021-10-24,1200138,202143,88038,88038,0
2021-10-24,1200179,202143,88038,88038,0
2021-10-24,1200203,202143,88038,88038,0
2021-10-24,1200252,202143,88038,88038,0
2021-10-24,1200302,202143,88038,88038,0
2021-10-24,1200328,202143,88038,88038,0
2021-10-24,1200344,202143,88038,88038,0
2021-10-24,1200013,202143,88038,88038,0
2021-10-24,1200351,202143,88038,88038,0
2021-10-24,1200336,202143,88038,88038,0
2021-10-24,1200500,202143,88038,88038,0
2021-10-24,1200609,202143,88038,88038,0
2021-10-24,1200427,202143,88038,88038,0
2021-10-24,1200708,202143,88038,88038,0
2021-10-24,1200435,202143,88038,88038,0
2021-10-24,1200401,202143,88038,88038,0
2021-10-24,1200450,202143,88038,88038,0
2021-10-25,1200013,202143,88038,88038,0
2021-10-25,1200054,202143,88038,88038,0
2021-10-25,1200104,202143,88038,88038,0
2021-10-25,1200138,202143,88038,88038,0
2021-10-25,1200179,202143,88038,88038,0
2021-10-25,1200203,202143,88038,88038,0
2021-10-25,1200252,202143,88038,88038,0
2021-10-25,1200328,202143,88038,88038,0
2021-10-25,1200302,202143,88038,88038,0
2021-10-25,1200336,202143,88038,88038,0
2021-10-25,1200385,202143,88038,88038,0
2021-10-25,1200807,202143,88038,88038,0
2021-10-25,1200393,202143,88038,88038,0
2021-10-25,1200401,202143,88038,88038,0
2021-10-25,1200427,202143,88038,88038,0
2021-10-25,1200435,202143,88038,88038,0
2021-10-25,1200500,202143,88038,88038,0
2021-10-25,1200450,202143,88038,88038,0
2021-10-25,1200609,202143,88038,88038,0
2021-10-25,1200708,202143,88038,88038,0
2021-10-25,1200351,202143,88038,88038,0
2021-10-25,1200344,202143,88038,88038,0
2021-10-26,1200179,202143,88038,88038,0
2021-10-26,1200138,202143,88038,88038,0
2021-10-26,1200104,202143,88038,88038,0
2021-10-26,1200013,202143,88038,88038,0
2021-10-26,1200054,202143,88038,88038,0
2021-10-26,1200807,202143,88038,88038,0
2021-10-26,1200500,202143,88038,88038,0
2021-10-26,1200435,202143,88038,88038,0
2021-10-26,1200427,202143,88038,88038,0
2021-10-26,1200401,202143,88038,88038,0
2021-10-26,1200393,202143,88038,88038,0
2021-10-26,1200708,202143,88038,88038,0
2021-10-26,1200450,202143,88038,88038,0
2021-10-26,1200385,202143,88038,88038,0
2021-10-26,1200351,202143,88038,88038,0
2021-10-26,1200344,202143,88038,88038,0
2021-10-26,1200328,202143,88038,88038,0
2021-10-26,1200302,202143,88038,88038,0
2021-10-26,1200252,202143,88038,88038,0
2021-10-26,1200203,202143,88038,88038,0
2021-10-26,1200336,202143,88038,88038,0
2021-10-26,1200609,202143,88038,88038,0
2021-10-27,1200427,202143,88038,88038,0
2021-10-27,1200401,202143,88038,88038,0
2021-10-27,1200013,202143,88038,88038,0
2021-10-27,1200104,202143,88038,88038,0
2021-10-27,1200435,202143,88038,88038,0
2021-10-27,1200393,202143,88038,88038,0
2021-10-27,1200450,202143,88038,88038,0
2021-10-27,1200609,202143,88038,88038,0
2021-10-27,1200708,202143,88038,88038,0
2021-10-27,1200807,202143,88038,88038,0
2021-10-27,1200385,202143,88038,88038,0
2021-10-27,1200054,202143,88038,88038,0
2021-10-27,1200336,202143,88038,88038,0
2021-10-27,1200344,202143,88038,88038,0
2021-10-27,1200328,202143,88038,88038,0
2021-10-27,1200302,202143,88038,88038,0
2021-10-27,1200252,202143,88038,88038,0
2021-10-27,1200203,202143,88038,88038,0
2021-10-27,1200179,202143,88038,88038,0
2021-10-27,1200138,202143,88038,88038,0
2021-10-27,1200351,202143,88038,88038,0
2021-10-27,1200500,202143,88038,88038,0
2021-10-28,1200385,202143,88038,88038,0
2021-10-28,1200401,202143,88038,88038,0
2021-10-28,1200708,202143,88038,88038,0
2021-10-28,1200609,202143,88038,88038,0
2021-10-28,1200450,202143,88038,88038,0
2021-10-28,1200500,202143,88038,88038,0
2021-10-28,1200435,202143,88038,88038,0
2021-10-28,1200427,202143,88038,88038,0
2021-10-28,1200393,202143,88038,88038,0
2021-10-28,1200807,202143,88038,88038,0
2021-10-28,1200351,202143,88038,88038,0
2021-10-28,1200336,202143,88038,88038,0
2021-10-28,1200328,202143,88038,88038,0
2021-10-28,1200302,202143,88038,88038,0
2021-10-28,1200252,202143,88038,88038,0
2021-10-28,1200203,202143,88038,88038,0
2021-10-28,1200179,202143,88038,88038,0
2021-10-28,1200138,202143,88038,88038,0
2021-10-28,1200104,202143,88038,88038,0
2021-10-28,1200054,202143,88038,88038,0
2021-10-28,1200013,202143,88038,88038,0
2021-10-28,1200344,202143,88038,88038,0
2021-10-29,1200203,202143,88038,88038,0
2021-10-29,1200328,202143,88038,88038,0
2021-10-29,1200252,202143,88038,88038,0
2021-10-29,1200179,202143,88038,88038,0
2021-10-29,1200385,202143,88038,88038,0
2021-10-29,1200104,202143,88038,88038,0
2021-10-29,1200054,202143,88038,88038,0
2021-10-29,1200013,202143,88038,88038,0
2021-10-29,1200344,202143,88038,88038,0
2021-10-29,1200138,202143,88038,88038,0
2021-10-29,1200336,202143,88038,88038,0
2021-10-29,1200351,202143,88038,88038,0
2021-10-29,1200302,202143,88038,88038,0
2021-10-29,1200807,202143,88038,88038,0
2021-10-29,1200393,202143,88038,88038,0
2021-10-29,1200401,202143,88063,88038,25
2021-10-29,1200427,202143,88064,88063,1
2021-10-29,1200435,202143,88064,88064,0
2021-10-29,1200500,202143,88064,88064,0
2021-10-29,1200450,202143,88065,88064,1
2021-10-29,1200609,202143,88065,88065,0
2021-10-29,1200708,202143,88065,88065,0
2021-10-30,1200013,202143,88065,88065,0
2021-10-30,1200054,202143,88065,88065,0
2021-10-30,1200104,202143,88065,88065,0
2021-10-30,1200138,202143,88065,88065,0
2021-10-30,1200179,202143,88065,88065,0
2021-10-30,1200609,202143,88065,88065,0
2021-10-30,1200252,202143,88065,88065,0
2021-10-30,1200302,202143,88065,88065,0
2021-10-30,1200328,202143,88065,88065,0
2021-10-30,1200344,202143,88065,88065,0
2021-10-30,1200351,202143,88065,88065,0
2021-10-30,1200336,202143,88065,88065,0
2021-10-30,1200385,202143,88065,88065,0
2021-10-30,1200807,202143,88065,88065,0
2021-10-30,1200393,202143,88065,88065,0
2021-10-30,1200401,202143,88065,88065,0
2021-10-30,1200427,202143,88065,88065,0
2021-10-30,1200435,202143,88065,88065,0
2021-10-30,1200500,202143,88065,88065,0
2021-10-30,1200450,202143,88065,88065,0
2021-10-30,1200708,202143,88065,88065,0
2021-10-30,1200203,202143,88065,88065,0
2021-10-31,1200252,202144,88065,88065,0
2021-10-31,1200427,202144,88065,88065,0
2021-10-31,1200708,202144,88065,88065,0
2021-10-31,1200609,202144,88065,88065,0
2021-10-31,1200450,202144,88065,88065,0
2021-10-31,1200500,202144,88065,88065,0
2021-10-31,1200435,202144,88065,88065,0
2021-10-31,1200401,202144,88065,88065,0
2021-10-31,1200393,202144,88065,88065,0
2021-10-31,1200807,202144,88065,88065,0
2021-10-31,1200336,202144,88065,88065,0
2021-10-31,1200385,202144,88065,88065,0
2021-10-31,1200344,202144,88065,88065,0
2021-10-31,1200328,202144,88065,88065,0
2021-10-31,1200302,202144,88065,88065,0
2021-10-31,1200203,202144,88065,88065,0
2021-10-31,1200179,202144,88065,88065,0
2021-10-31,1200138,202144,88065,88065,0
2021-10-31,1200104,202144,88065,88065,0
2021-10-31,1200054,202144,88065,88065,0
2021-10-31,1200013,202144,88065,88065,0
2021-10-31,1200351,202144,88065,88065,0
2021-11-01,1200252,202144,88065,88065,0
2021-11-01,1200344,202144,88065,88065,0
2021-11-01,1200328,202144,88065,88065,0
2021-11-01,1200302,202144,88065,88065,0
2021-11-01,1200203,202144,88065,88065,0
2021-11-01,1200385,202144,88065,88065,0
2021-11-01,1200138,202144,88065,88065,0
2021-11-01,1200104,202144,88065,88065,0
2021-11-01,1200013,202144,88065,88065,0
2021-11-01,1200351,202144,88065,88065,0
2021-11-01,1200179,202144,88065,88065,0
2021-11-01,1200336,202144,88065,88065,0
2021-11-01,1200054,202144,88065,88065,0
2021-11-01,1200807,202144,88065,88065,0
2021-11-01,1200393,202144,88065,88065,0
2021-11-01,1200401,202144,88065,88065,0
2021-11-01,1200427,202144,88065,88065,0
2021-11-01,1200435,202144,88065,88065,0
2021-11-01,1200500,202144,88065,88065,0
2021-11-01,1200450,202144,88065,88065,0
2021-11-01,1200609,202144,88065,88065,0
2021-11-01,1200708,202144,88065,88065,0
2021-11-02,1200708,202144,88065,88065,0
2021-11-02,1200013,202144,88065,88065,0
2021-11-02,1200054,202144,88065,88065,0
2021-11-02,1200104,202144,88065,88065,0
2021-11-02,1200138,202144,88065,88065,0
2021-11-02,1200179,202144,88065,88065,0
2021-11-02,1200203,202144,88065,88065,0
2021-11-02,1200807,202144,88065,88065,0
2021-11-02,1200450,202144,88065,88065,0
2021-11-02,1200500,202144,88065,88065,0
2021-11-02,1200435,202144,88065,88065,0
2021-11-02,1200427,202144,88065,88065,0
2021-11-02,1200401,202144,88065,88065,0
2021-11-02,1200393,202144,88065,88065,0
2021-11-02,1200252,202144,88065,88065,0
2021-11-02,1200609,202144,88065,88065,0
2021-11-02,1200336,202144,88065,88065,0
2021-11-02,1200351,202144,88065,88065,0
2021-11-02,1200344,202144,88065,88065,0
2021-11-02,1200328,202144,88065,88065,0
2021-11-02,1200302,202144,88065,88065,0
2021-11-02,1200385,202144,88065,88065,0
2021-11-03,1200054,202144,88065,88065,0
2021-11-03,1200013,202144,88065,88065,0
2021-11-03,1200104,202144,88065,88065,0
2021-11-03,1200708,202144,88065,88065,0
2021-11-03,1200450,202144,88065,88065,0
2021-11-03,1200500,202144,88065,88065,0
2021-11-03,1200435,202144,88065,88065,0
2021-11-03,1200427,202144,88065,88065,0
2021-11-03,1200401,202144,88065,88065,0
2021-11-03,1200393,202144,88065,88065,0
2021-11-03,1200807,202144,88065,88065,0
2021-11-03,1200385,202144,88065,88065,0
2021-11-03,1200336,202144,88065,88065,0
2021-11-03,1200351,202144,88065,88065,0
2021-11-03,1200344,202144,88065,88065,0
2021-11-03,1200328,202144,88065,88065,0
2021-11-03,1200302,202144,88065,88065,0
2021-11-03,1200252,202144,88065,88065,0
2021-11-03,1200203,202144,88065,88065,0
2021-11-03,1200179,202144,88065,88065,0
2021-11-03,1200138,202144,88065,88065,0
2021-11-03,1200609,202144,88065,88065,0
2021-11-04,1200807,202144,88065,88065,0
2021-11-04,1200393,202144,88065,88065,0
2021-11-04,1200054,202144,88065,88065,0
2021-11-04,1200401,202144,88065,88065,0
2021-11-04,1200427,202144,88065,88065,0
2021-11-04,1200385,202144,88065,88065,0
2021-11-04,1200500,202144,88065,88065,0
2021-11-04,1200450,202144,88065,88065,0
2021-11-04,1200609,202144,88065,88065,0
2021-11-04,1200708,202144,88065,88065,0
2021-11-04,1200336,202144,88065,88065,0
2021-11-04,1200351,202144,88065,88065,0
2021-11-04,1200344,202144,88065,88065,0
2021-11-04,1200328,202144,88065,88065,0
2021-11-04,1200302,202144,88065,88065,0
2021-11-04,1200252,202144,88065,88065,0
2021-11-04,1200203,202144,88065,88065,0
2021-11-04,1200179,202144,88065,88065,0
2021-11-04,1200138,202144,88065,88065,0
2021-11-04,1200104,202144,88065,88065,0
2021-11-04,1200013,202144,88065,88065,0
2021-11-04,1200435,202144,88065,88065,0
2021-11-05,1200435,202144,88065,88065,0
2021-11-05,1200708,202144,88065,88065,0
2021-11-05,1200500,202144,88067,88065,2
2021-11-05,1200427,202144,88067,88067,0
2021-11-05,1200401,202144,88070,88067,3
2021-11-05,1200393,202144,88070,88070,0
2021-11-05,1200807,202144,88070,88070,0
2021-11-05,1200385,202144,88072,88070,2
2021-11-05,1200336,202144,88072,88072,0
2021-11-05,1200351,202144,88073,88072,1
2021-11-05,1200344,202144,88073,88073,0
2021-11-05,1200328,202144,88073,88073,0
2021-11-05,1200302,202144,88073,88073,0
2021-11-05,1200252,202144,88073,88073,0
2021-11-05,1200203,202144,88074,88073,1
2021-11-05,1200179,202144,88074,88074,0
2021-11-05,1200138,202144,88074,88074,0
2021-11-05,1200104,202144,88075,88074,1
2021-11-05,1200054,202144,88075,88075,0
2021-11-05,1200450,202144,88075,88075,0
2021-11-05,1200609,202144,88075,88075,0
2021-11-05,1200013,202144,88075,88075,0
2021-11-06,1200336,202144,88075,88075,0
2021-11-06,1200807,202144,88075,88075,0
2021-11-06,1200393,202144,88075,88075,0
2021-11-06,1200401,202144,88075,88075,0
2021-11-06,1200427,202144,88075,88075,0
2021-11-06,1200435,202144,88075,88075,0
2021-11-06,1200500,202144,88075,88075,0
2021-11-06,1200450,202144,88075,88075,0
2021-11-06,1200609,202144,88075,88075,0
2021-11-06,1200708,202144,88075,88075,0
2021-11-06,1200351,202144,88075,88075,0
2021-11-06,1200344,202144,88075,88075,0
2021-11-06,1200328,202144,88075,88075,0
2021-11-06,1200302,202144,88075,88075,0
2021-11-06,1200252,202144,88075,88075,0
2021-11-06,1200203,202144,88075,88075,0
2021-11-06,1200179,202144,88075,88075,0
2021-11-06,1200138,202144,88075,88075,0
2021-11-06,1200104,202144,88075,88075,0
2021-11-06,1200054,202144,88075,88075,0
2021-11-06,1200013,202144,88075,88075,0
2021-11-06,1200385,202144,88075,88075,0
2021-11-07,1200336,202145,88075,88075,0
2021-11-07,1200427,202145,88075,88075,0
2021-11-07,1200708,202145,88075,88075,0
2021-11-07,1200609,202145,88075,88075,0
2021-11-07,1200450,202145,88075,88075,0
2021-11-07,1200500,202145,88075,88075,0
2021-11-07,1200435,202145,88075,88075,0
2021-11-07,1200401,202145,88075,88075,0
2021-11-07,1200393,202145,88075,88075,0
2021-11-07,1200807,202145,88075,88075,0
2021-11-07,1200351,202145,88075,88075,0
2021-11-07,1200385,202145,88075,88075,0
2021-11-07,1200328,202145,88075,88075,0
2021-11-07,1200302,202145,88075,88075,0
2021-11-07,1200252,202145,88075,88075,0
2021-11-07,1200203,202145,88075,88075,0
2021-11-07,1200179,202145,88075,88075,0
2021-11-07,1200138,202145,88075,88075,0
2021-11-07,1200104,202145,88075,88075,0
2021-11-07,1200054,202145,88075,88075,0
2021-11-07,1200013,202145,88075,88075,0
2021-11-07,1200344,202145,88075,88075,0
2021-11-08,1200203,202145,88075,88075,0
2021-11-08,1200344,202145,88075,88075,0
2021-11-08,1200328,202145,88075,88075,0
2021-11-08,1200302,202145,88075,88075,0
2021-11-08,1200179,202145,88075,88075,0
2021-11-08,1200385,202145,88075,88075,0
2021-11-08,1200104,202145,88075,88075,0
2021-11-08,1200054,202145,88075,88075,0
2021-11-08,1200013,202145,88075,88075,0
2021-11-08,1200351,202145,88075,88075,0
2021-11-08,1200138,202145,88075,88075,0
2021-11-08,1200336,202145,88075,88075,0
2021-11-08,1200252,202145,88075,88075,0
2021-11-08,1200393,202145,88075,88075,0
2021-11-08,1200401,202145,88075,88075,0
2021-11-08,1200427,202145,88075,88075,0
2021-11-08,1200435,202145,88075,88075,0
2021-11-08,1200500,202145,88075,88075,0
2021-11-08,1200450,202145,88075,88075,0
2021-11-08,1200609,202145,88075,88075,0
2021-11-08,1200708,202145,88075,88075,0
2021-11-08,1200807,202145,88075,88075,0
2021-11-09,1200708,202145,88075,88075,0
2021-11-09,1200013,202145,88075,88075,0
2021-11-09,1200054,202145,88075,88075,0
2021-11-09,1200104,202145,88075,88075,0
2021-11-09,1200138,202145,88075,88075,0
2021-11-09,1200179,202145,88075,88075,0
2021-11-09,1200203,202145,88075,88075,0
2021-11-09,1200302,202145,88075,88075,0
2021-11-09,1200450,202145,88075,88075,0
2021-11-09,1200500,202145,88075,88075,0
2021-11-09,1200435,202145,88075,88075,0
2021-11-09,1200427,202145,88075,88075,0
2021-11-09,1200401,202145,88075,88075,0
2021-11-09,1200252,202145,88075,88075,0
2021-11-09,1200393,202145,88075,88075,0
2021-11-09,1200385,202145,88075,88075,0
2021-11-09,1200336,202145,88075,88075,0
2021-11-09,1200351,202145,88075,88075,0
2021-11-09,1200344,202145,88075,88075,0
2021-11-09,1200328,202145,88075,88075,0
2021-11-09,1200807,202145,88075,88075,0
2021-11-09,1200609,202145,88075,88075,0
2021-11-10,1200013,202145,88075,88075,0
2021-11-10,1200054,202145,88075,88075,0
2021-11-10,1200104,202145,88075,88075,0
2021-11-10,1200179,202145,88075,88075,0
2021-11-10,1200252,202145,88075,88075,0
2021-11-10,1200302,202145,88075,88075,0
2021-11-10,1200328,202145,88075,88075,0
2021-11-10,1200344,202145,88075,88075,0
2021-11-10,1200351,202145,88075,88075,0
2021-11-10,1200336,202145,88075,88075,0
2021-11-10,1200385,202145,88075,88075,0
2021-11-10,1200807,202145,88075,88075,0
2021-11-10,1200393,202145,88075,88075,0
2021-11-10,1200401,202145,88075,88075,0
2021-11-10,1200427,202145,88075,88075,0
2021-11-10,1200435,202145,88075,88075,0
2021-11-10,1200500,202145,88075,88075,0
2021-11-10,1200203,202145,88075,88075,0
2021-11-10,1200450,202145,88075,88075,0
2021-11-10,1200609,202145,88075,88075,0
2021-11-10,1200708,202145,88075,88075,0
2021-11-10,1200138,202145,88075,88075,0
2021-11-11,1200013,202145,88075,88075,0
2021-11-11,1200054,202145,88075,88075,0
2021-11-11,1200104,202145,88075,88075,0
2021-11-11,1200138,202145,88075,88075,0
2021-11-11,1200179,202145,88075,88075,0
2021-11-11,1200203,202145,88075,88075,0
2021-11-11,1200252,202145,88075,88075,0
2021-11-11,1200302,202145,88075,88075,0
2021-11-11,1200328,202145,88075,88075,0
2021-11-11,1200344,202145,88075,88075,0
2021-11-11,1200351,202145,88075,88075,0
2021-11-11,1200385,202145,88075,88075,0
2021-11-11,1200393,202145,88075,88075,0
2021-11-11,1200807,202145,88075,88075,0
2021-11-11,1200401,202145,88075,88075,0
2021-11-11,1200427,202145,88075,88075,0
2021-11-11,1200435,202145,88075,88075,0
2021-11-11,1200500,202145,88075,88075,0
2021-11-11,1200450,202145,88075,88075,0
2021-11-11,1200609,202145,88075,88075,0
2021-11-11,1200708,202145,88075,88075,0
2021-11-11,1200336,202145,88075,88075,0
2021-11-12,1200013,202145,88075,88075,0
2021-11-12,1200054,202145,88075,88075,0
2021-11-12,1200104,202145,88075,88075,0
2021-11-12,1200138,202145,88075,88075,0
2021-11-12,1200179,202145,88075,88075,0
2021-11-12,1200203,202145,88075,88075,0
2021-11-12,1200708,202145,88075,88075,0
2021-11-12,1200328,202145,88075,88075,0
2021-11-12,1200344,202145,88075,88075,0
2021-11-12,1200351,202145,88075,88075,0
2021-11-12,1200336,202145,88075,88075,0
2021-11-12,1200385,202145,88075,88075,0
2021-11-12,1200807,202145,88075,88075,0
2021-11-12,1200393,202145,88075,88075,0
2021-11-12,1200401,202145,88075,88075,0
2021-11-12,1200427,202145,88075,88075,0
2021-11-12,1200435,202145,88075,88075,0
2021-11-12,1200500,202145,88075,88075,0
2021-11-12,1200450,202145,88075,88075,0
2021-11-12,1200609,202145,88075,88075,0
2021-11-12,1200302,202145,88075,88075,0
2021-11-12,1200252,202145,88075,88075,0
2021-11-13,1200435,202145,88075,88075,0
2021-11-13,1200393,202145,88075,88075,0
2021-11-13,1200708,202145,88075,88075,0
2021-11-13,1200609,202145,88075,88075,0
2021-11-13,1200450,202145,88075,88075,0
2021-11-13,1200500,202145,88075,88075,0
2021-11-13,1200427,202145,88075,88075,0
2021-11-13,1200401,202145,88075,88075,0
2021-11-13,1200807,202145,88075,88075,0
2021-11-13,1200385,202145,88075,88075,0
2021-11-13,1200351,202145,88075,88075,0
2021-11-13,1200336,202145,88075,88075,0
2021-11-13,1200328,202145,88075,88075,0
2021-11-13,1200302,202145,88075,88075,0
2021-11-13,1200252,202145,88075,88075,0
2021-11-13,1200203,202145,88075,88075,0
2021-11-13,1200179,202145,88075,88075,0
2021-11-13,1200138,202145,88075,88075,0
2021-11-13,1200104,202145,88075,88075,0
2021-11-13,1200054,202145,88075,88075,0
2021-11-13,1200013,202145,88075,88075,0
2021-11-13,1200344,202145,88075,88075,0
2021-11-14,1200203,202146,88075,88075,0
2021-11-14,1200302,202146,88075,88075,0
2021-11-14,1200252,202146,88075,88075,0
2021-11-14,1200179,202146,88075,88075,0
2021-11-14,1200351,202146,88075,88075,0
2021-11-14,1200104,202146,88075,88075,0
2021-11-14,1200054,202146,88075,88075,0
2021-11-14,1200013,202146,88075,88075,0
2021-11-14,1200328,202146,88075,88075,0
2021-11-14,1200138,202146,88075,88075,0
2021-11-14,1200336,202146,88075,88075,0
2021-11-14,1200344,202146,88075,88075,0
2021-11-14,1200385,202146,88075,88075,0
2021-11-14,1200807,202146,88075,88075,0
2021-11-14,1200393,202146,88075,88075,0
2021-11-14,1200401,202146,88075,88075,0
2021-11-14,1200427,202146,88075,88075,0
2021-11-14,1200435,202146,88075,88075,0
2021-11-14,1200500,202146,88075,88075,0
2021-11-14,1200450,202146,88075,88075,0
2021-11-14,1200609,202146,88075,88075,0
2021-11-14,1200708,202146,88075,88075,0
2021-11-15,1200013,202146,88075,88075,0
2021-11-15,1200054,202146,88075,88075,0
2021-11-15,1200104,202146,88075,88075,0
2021-11-15,1200138,202146,88075,88075,0
2021-11-15,1200179,202146,88075,88075,0
2021-11-15,1200609,202146,88075,88075,0
2021-11-15,1200252,202146,88075,88075,0
2021-11-15,1200302,202146,88075,88075,0
2021-11-15,1200328,202146,88075,88075,0
2021-11-15,1200344,202146,88075,88075,0
2021-11-15,1200351,202146,88075,88075,0
2021-11-15,1200336,202146,88075,88075,0
2021-11-15,1200385,202146,88075,88075,0
2021-11-15,1200807,202146,88075,88075,0
2021-11-15,1200393,202146,88075,88075,0
2021-11-15,1200401,202146,88075,88075,0
2021-11-15,1200427,202146,88075,88075,0
2021-11-15,1200435,202146,88075,88075,0
2021-11-15,1200500,202146,88075,88075,0
2021-11-15,1200450,202146,88075,88075,0
2021-11-15,1200708,202146,88075,88075,0
2021-11-15,1200203,202146,88075,88075,0
2021-11-16,1200336,202146,88075,88075,0
2021-11-16,1200427,202146,88075,88075,0
2021-11-16,1200708,202146,88075,88075,0
2021-11-16,1200609,202146,88075,88075,0
2021-11-16,1200450,202146,88075,88075,0
2021-11-16,1200500,202146,88075,88075,0
2021-11-16,1200435,202146,88075,88075,0
2021-11-16,1200401,202146,88075,88075,0
2021-11-16,1200393,202146,88075,88075,0
2021-11-16,1200807,202146,88075,88075,0
2021-11-16,1200351,202146,88075,88075,0
2021-11-16,1200385,202146,88075,88075,0
2021-11-16,1200328,202146,88075,88075,0
2021-11-16,1200302,202146,88075,88075,0
2021-11-16,1200252,202146,88075,88075,0
2021-11-16,1200203,202146,88075,88075,0
2021-11-16,1200179,202146,88075,88075,0
2021-11-16,1200138,202146,88075,88075,0
2021-11-16,1200104,202146,88075,88075,0
2021-11-16,1200054,202146,88075,88075,0
2021-11-16,1200013,202146,88075,88075,0
2021-11-16,1200344,202146,88075,88075,0
2021-11-17,1200203,202146,88075,88075,0
2021-11-17,1200344,202146,88075,88075,0
2021-11-17,1200328,202146,88075,88075,0
2021-11-17,1200302,202146,88075,88075,0
2021-11-17,1200179,202146,88075,88075,0
2021-11-17,1200385,202146,88075,88075,0
2021-11-17,1200104,202146,88075,88075,0
2021-11-17,1200054,202146,88075,88075,0
2021-11-17,1200013,202146,88075,88075,0
2021-11-17,1200351,202146,88075,88075,0
2021-11-17,1200138,202146,88075,88075,0
2021-11-17,1200336,202146,88075,88075,0
2021-11-17,1200252,202146,88075,88075,0
2021-11-17,1200807,202146,88075,88075,0
2021-11-17,1200393,202146,88075,88075,0
2021-11-17,1200401,202146,88075,88075,0
2021-11-17,1200427,202146,88075,88075,0
2021-11-17,1200435,202146,88075,88075,0
2021-11-17,1200500,202146,88075,88075,0
2021-11-17,1200450,202146,88075,88075,0
2021-11-17,1200609,202146,88075,88075,0
2021-11-17,1200708,202146,88075,88075,0
2021-11-18,1200708,202146,88075,88075,0
2021-11-18,1200013,202146,88075,88075,0
2021-11-18,1200054,202146,88075,88075,0
2021-11-18,1200104,202146,88075,88075,0
2021-11-18,1200138,202146,88075,88075,0
2021-11-18,1200179,202146,88075,88075,0
2021-11-18,1200203,202146,88075,88075,0
2021-11-18,1200807,202146,88075,88075,0
2021-11-18,1200450,202146,88075,88075,0
2021-11-18,1200500,202146,88075,88075,0
2021-11-18,1200435,202146,88075,88075,0
2021-11-18,1200427,202146,88075,88075,0
2021-11-18,1200401,202146,88075,88075,0
2021-11-18,1200393,202146,88075,88075,0
2021-11-18,1200252,202146,88075,88075,0
2021-11-18,1200609,202146,88075,88075,0
2021-11-18,1200336,202146,88075,88075,0
2021-11-18,1200351,202146,88075,88075,0
2021-11-18,1200344,202146,88075,88075,0
2021-11-18,1200328,202146,88075,88075,0
2021-11-18,1200302,202146,88075,88075,0
2021-11-18,1200385,202146,88075,88075,0
2021-11-19,1200054,202146,88075,88075,0
2021-11-19,1200013,202146,88075,88075,0
2021-11-19,1200104,202146,88075,88075,0
2021-11-19,1200708,202146,88075,88075,0
2021-11-19,1200450,202146,88075,88075,0
2021-11-19,1200500,202146,88075,88075,0
2021-11-19,1200435,202146,88075,88075,0
2021-11-19,1200427,202146,88075,88075,0
2021-11-19,1200401,202146,88075,88075,0
2021-11-19,1200393,202146,88075,88075,0
2021-11-19,1200807,202146,88075,88075,0
2021-11-19,1200385,202146,88075,88075,0
2021-11-19,1200336,202146,88075,88075,0
2021-11-19,1200351,202146,88075,88075,0
2021-11-19,1200344,202146,88075,88075,0
2021-11-19,1200328,202146,88075,88075,0
2021-11-19,1200302,202146,88075,88075,0
2021-11-19,1200252,202146,88075,88075,0
2021-11-19,1200203,202146,88075,88075,0
2021-11-19,1200179,202146,88075,88075,0
2021-11-19,1200138,202146,88075,88075,0
2021-11-19,1200609,202146,88075,88075,0
2021-11-20,1200807,202146,88075,88075,0
2021-11-20,1200393,202146,88075,88075,0
2021-11-20,1200054,202146,88075,88075,0
2021-11-20,1200401,202146,88075,88075,0
2021-11-20,1200427,202146,88075,88075,0
2021-11-20,1200385,202146,88075,88075,0
2021-11-20,1200500,202146,88075,88075,0
2021-11-20,1200450,202146,88075,88075,0
2021-11-20,1200609,202146,88075,88075,0
2021-11-20,1200708,202146,88075,88075,0
2021-11-20,1200336,202146,88075,88075,0
2021-11-20,1200351,202146,88075,88075,0
2021-11-20,1200344,202146,88075,88075,0
2021-11-20,1200328,202146,88075,88075,0
2021-11-20,1200302,202146,88075,88075,0
2021-11-20,1200252,202146,88075,88075,0
2021-11-20,1200203,202146,88075,88075,0
2021-11-20,1200179,202146,88075,88075,0
2021-11-20,1200138,202146,88075,88075,0
2021-11-20,1200104,202146,88075,88075,0
2021-11-20,1200013,202146,88075,88075,0
2021-11-20,1200435,202146,88075,88075,0
2021-11-21,1200435,202147,88075,88075,0
2021-11-21,1200708,202147,88075,88075,0
2021-11-21,1200500,202147,88075,88075,0
2021-11-21,1200427,202147,88075,88075,0
2021-11-21,1200401,202147,88075,88075,0
2021-11-21,1200393,202147,88075,88075,0
2021-11-21,1200807,202147,88075,88075,0
2021-11-21,1200385,202147,88075,88075,0
2021-11-21,1200336,202147,88075,88075,0
2021-11-21,1200351,202147,88075,88075,0
2021-11-21,1200344,202147,88075,88075,0
2021-11-21,1200328,202147,88075,88075,0
2021-11-21,1200302,202147,88075,88075,0
2021-11-21,1200252,202147,88075,88075,0
2021-11-21,1200203,202147,88075,88075,0
2021-11-21,1200179,202147,88075,88075,0
2021-11-21,1200138,202147,88075,88075,0
2021-11-21,1200104,202147,88075,88075,0
2021-11-21,1200054,202147,88075,88075,0
2021-11-21,1200450,202147,88075,88075,0
2021-11-21,1200609,202147,88075,88075,0
2021-11-21,1200013,202147,88075,88075,0
2021-11-22,1200336,202147,88075,88075,0
2021-11-22,1200807,202147,88075,88075,0
2021-11-22,1200393,202147,88075,88075,0
2021-11-22,1200401,202147,88075,88075,0
2021-11-22,1200427,202147,88075,88075,0
2021-11-22,1200435,202147,88075,88075,0
2021-11-22,1200500,202147,88075,88075,0
2021-11-22,1200450,202147,88075,88075,0
2021-11-22,1200609,202147,88075,88075,0
2021-11-22,1200708,202147,88075,88075,0
2021-11-22,1200351,202147,88075,88075,0
2021-11-22,1200344,202147,88075,88075,0
2021-11-22,1200328,202147,88075,88075,0
2021-11-22,1200302,202147,88075,88075,0
2021-11-22,1200252,202147,88075,88075,0
2021-11-22,1200203,202147,88075,88075,0
2021-11-22,1200179,202147,88075,88075,0
2021-11-22,1200138,202147,88075,88075,0
2021-11-22,1200104,202147,88075,88075,0
2021-11-22,1200054,202147,88075,88075,0
2021-11-22,1200013,202147,88075,88075,0
2021-11-22,1200385,202147,88075,88075,0
