date,city_ibge_code,epidemiological_week,cumulative_confirmed,previous_period,diff_by_period
2020-03-08,2704302,202011,1,0,1
2020-03-09,2704302,202011,1,1,0
2020-03-10,2704302,202011,1,1,0
2020-03-11,2704302,202011,1,1,0
2020-03-12,2704302,202011,1,1,0
2020-03-13,2704302,202011,1,1,0
2020-03-14,2704302,202011,1,1,0
2020-03-15,2704302,202012,1,1,0
2020-03-16,2704302,202012,1,1,0
2020-03-17,2704302,202012,1,1,0
2020-03-17,1200401,202012,4,1,3
2020-03-18,2704302,202012,4,4,0
2020-03-18,1200401,202012,4,4,0
2020-03-19,2704302,202012,7,4,3
2020-03-19,1200401,202012,8,7,1
2020-03-20,2704302,202012,10,8,2
2020-03-20,1200401,202012,13,10,3
2020-03-21,2704302,202012,14,13,1
2020-03-21,1200401,202012,18,14,4
2020-03-22,2704302,202013,18,18,0
2020-03-22,1200401,202013,18,18,0
2020-03-23,2704302,202013,19,18,1
2020-03-23,1200401,202013,25,19,6
2020-03-24,2704302,202013,27,25,2
2020-03-24,1200401,202013,31,27,4
2020-03-25,1200401,202013,33,31,2
2020-03-25,2707503,202013,34,33,1
2020-03-25,2704302,202013,34,34,0
2020-03-26,1200401,202013,34,34,0
2020-03-26,2707503,202013,34,34,0
2020-03-26,2704302,202013,34,34,0
2020-03-27,1200401,202013,36,34,2
2020-03-27,2707503,202013,36,36,0
2020-03-27,2704302,202013,37,36,1
2020-03-28,1200401,202013,37,37,0
2020-03-28,2704302,202013,39,37,2
2020-03-28,2707503,202013,39,39,0
2020-03-29,2704302,202014,38,39,-1
2020-03-29,1200401,202014,44,38,6
2020-03-29,1200807,202014,45,44,1
2020-03-29,1200013,202014,47,45,2
2020-03-29,2707503,202014,47,47,0
2020-03-30,2704302,202014,47,47,0
2020-03-30,2707503,202014,47,47,0
2020-03-30,1200401,202014,50,47,3
2020-03-30,1200807,202014,50,50,0
2020-03-30,1200013,202014,54,50,4
2020-03-31,1200013,202014,55,54,1
2020-03-31,1200807,202014,55,55,0
2020-03-31,1200401,202014,55,55,0
2020-03-31,2707503,202014,55,55,0
2020-03-31,2704302,202014,56,55,1
2020-04-01,2704302,202014,56,56,0
2020-04-01,2707503,202014,56,56,0
2020-04-01,1200401,202014,56,56,0
2020-04-01,1200807,202014,56,56,0
2020-04-01,1200013,202014,57,56,1
2020-04-02,1200807,202014,57,57,0
2020-04-02,1200401,202014,59,57,2
2020-04-02,1200013,202014,59,59,0
2020-04-03,1200807,202014,59,59,0
2020-04-03,1200401,202014,59,59,0
2020-04-03,1200013,202014,60,59,1
2020-04-04,1200013,202014,60,60,0
2020-04-04,1200807,202014,60,60,0
2020-04-04,1200401,202014,60,60,0
2020-04-05,1200013,202015,60,60,0
2020-04-05,1200807,202015,60,60,0
2020-04-05,1200401,202015,62,60,2
2020-04-06,1200013,202015,62,62,0
2020-04-06,1200401,202015,63,62,1
2020-04-06,1200807,202015,63,63,0
2020-04-06,1200385,202015,64,63,1
2020-04-07,1200401,202015,64,64,0
2020-04-07,1200807,202015,64,64,0
2020-04-07,1200385,202015,64,64,0
2020-04-07,1200013,202015,64,64,0
2020-04-08,1200013,202015,64,64,0
2020-04-08,1200138,202015,65,64,1
2020-04-08,1200385,202015,66,65,1
2020-04-08,1200807,202015,66,66,0
2020-04-08,1200401,202015,72,66,6
2020-04-09,1200807,202015,72,72,0
2020-04-09,1200385,202015,73,72,1
2020-04-09,1200013,202015,73,73,0
2020-04-09,1200401,202015,76,73,3
2020-04-09,1200138,202015,76,76,0
2020-04-10,1200138,202015,76,76,0
2020-04-10,1200401,202015,83,76,7
2020-04-10,1200013,202015,83,83,0
2020-04-10,1200385,202015,84,83,1
2020-04-10,1200807,202015,84,84,0
2020-04-11,1200138,202015,84,84,0
2020-04-11,1200807,202015,84,84,0
2020-04-11,1200401,202015,86,84,2
2020-04-11,1200013,202015,86,86,0
2020-04-11,1200385,202015,86,86,0
2020-04-12,1200401,202016,89,86,3
2020-04-12,1200807,202016,89,89,0
2020-04-12,1200138,202016,89,89,0
2020-04-12,1200385,202016,90,89,1
2020-04-12,1200013,202016,91,90,1
2020-04-13,1200138,202016,91,91,0
2020-04-13,1200013,202016,92,91,1
2020-04-13,1200385,202016,94,92,2
2020-04-13,1200401,202016,102,94,8
2020-04-13,1200203,202016,104,102,2
2020-04-13,1200807,202016,104,104,0
2020-04-14,1200401,202016,110,104,6
2020-04-14,1200807,202016,110,110,0
2020-04-14,1200385,202016,113,110,3
2020-04-14,1200203,202016,113,113,0
2020-04-14,1200138,202016,113,113,0
2020-04-14,1200013,202016,113,113,0
2020-04-15,1200807,202016,113,113,0
2020-04-15,1200013,202016,113,113,0
2020-04-15,1200138,202016,113,113,0
2020-04-15,1200203,202016,113,113,0
2020-04-15,1200401,202016,115,113,2
2020-04-15,1200385,202016,115,115,0
2020-04-16,1200203,202016,115,115,0
2020-04-16,1200807,202016,115,115,0
2020-04-16,1200401,202016,125,115,10
2020-04-16,1200138,202016,125,125,0
2020-04-16,1200013,202016,126,125,1
2020-04-16,1200385,202016,129,126,3
2020-04-17,1200807,202016,129,129,0
2020-04-17,1200013,202016,129,129,0
2020-04-17,1200138,202016,129,129,0
2020-04-17,1200203,202016,129,129,0
2020-04-17,1200401,202016,148,129,19
2020-04-17,1200385,202016,149,148,1
2020-04-18,1200807,202016,149,149,0
2020-04-18,1200401,202016,156,149,7
2020-04-18,1200385,202016,156,156,0
2020-04-18,1200138,202016,156,156,0
2020-04-18,1200013,202016,156,156,0
2020-04-18,1200203,202016,156,156,0
2020-04-19,1200138,202017,156,156,0
2020-04-19,1200385,202017,161,156,5
2020-04-19,1200807,202017,161,161,0
2020-04-19,1200401,202017,172,161,11
2020-04-19,1200450,202017,174,172,2
2020-04-19,1200013,202017,174,174,0
2020-04-19,1200203,202017,177,174,3
2020-04-20,1200385,202017,177,177,0
2020-04-20,1200401,202017,190,177,13
2020-04-20,1200807,202017,190,190,0
2020-04-20,1200203,202017,190,190,0
2020-04-20,1200013,202017,190,190,0
2020-04-20,1200450,202017,190,190,0
2020-04-20,1200138,202017,190,190,0
2020-04-21,1200138,202017,190,190,0
2020-04-21,1200203,202017,190,190,0
2020-04-21,1200385,202017,191,190,1
2020-04-21,1200013,202017,191,191,0
2020-04-21,1200401,202017,209,191,18
2020-04-21,1200450,202017,209,209,0
2020-04-21,1200807,202017,209,209,0
2020-04-22,1200401,202017,227,209,18
2020-04-22,1200013,202017,227,227,0
2020-04-22,1200138,202017,227,227,0
2020-04-22,1200203,202017,227,227,0
2020-04-22,1200385,202017,228,227,1
2020-04-22,1200450,202017,228,228,0
2020-04-22,1200807,202017,228,228,0
2020-04-23,1200401,202017,241,228,13
2020-04-23,1200450,202017,241,241,0
2020-04-23,1200807,202017,241,241,0
2020-04-23,1200385,202017,241,241,0
2020-04-23,1200203,202017,241,241,0
2020-04-23,1200138,202017,241,241,0
2020-04-23,1200013,202017,241,241,0
2020-04-24,1200450,202017,241,241,0
2020-04-24,1200401,202017,247,241,6
2020-04-24,1200807,202017,247,247,0
2020-04-24,1200203,202017,247,247,0
2020-04-24,1200138,202017,247,247,0
2020-04-24,1200013,202017,247,247,0
2020-04-24,1200385,202017,248,247,1
2020-04-25,1200450,202017,248,248,0
2020-04-25,1200013,202017,248,248,0
2020-04-25,1200138,202017,248,248,0
2020-04-25,1200203,202017,248,248,0
2020-04-25,1200385,202017,248,248,0
2020-04-25,1200807,202017,248,248,0
2020-04-25,1200401,202017,272,248,24
2020-04-26,1200385,202018,272,272,0
2020-04-26,1200401,202018,292,272,20
2020-04-26,1200450,202018,292,292,0
2020-04-26,1200203,202018,292,292,0
2020-04-26,1200013,202018,292,292,0
2020-04-26,1200138,202018,292,292,0
2020-04-26,1200807,202018,293,292,1
2020-04-27,1200450,202018,293,293,0
2020-04-27,1200013,202018,294,293,1
2020-04-27,1200401,202018,315,294,21
2020-04-27,1200138,202018,315,315,0
2020-04-27,1200385,202018,315,315,0
2020-04-27,1200203,202018,315,315,0
2020-04-27,1200807,202018,315,315,0
2020-04-28,1200807,202018,315,315,0
2020-04-28,1200013,202018,315,315,0
2020-04-28,1200138,202018,315,315,0
2020-04-28,1200203,202018,315,315,0
2020-04-28,1200385,202018,315,315,0
2020-04-28,1200450,202018,315,315,0
2020-04-28,1200401,202018,331,315,16
2020-04-29,1200708,202018,334,331,3
2020-04-29,1200450,202018,335,334,1
2020-04-29,1200401,202018,363,335,28
2020-04-29,1200807,202018,363,363,0
2020-04-29,1200138,202018,364,363,1
2020-04-29,1200336,202018,365,364,1
2020-04-29,1200203,202018,365,365,0
2020-04-29,1200013,202018,365,365,0
2020-04-29,1200385,202018,368,365,3
2020-04-30,1200336,202018,369,368,1
2020-04-30,1200450,202018,369,369,0
2020-04-30,1200708,202018,374,369,5
2020-04-30,1200203,202018,374,374,0
2020-04-30,1200013,202018,374,374,0
2020-04-30,1200138,202018,374,374,0
2020-04-30,1200401,202018,418,374,44
2020-04-30,1200385,202018,418,418,0
2020-04-30,1200807,202018,418,418,0
2020-05-01,1200401,202018,482,418,64
2020-05-01,1200385,202018,491,482,9
2020-05-01,1200708,202018,492,491,1
2020-05-01,1200450,202018,493,492,1
2020-05-01,1200336,202018,493,493,0
2020-05-01,1200138,202018,493,493,0
2020-05-01,1200054,202018,494,493,1
2020-05-01,1200013,202018,494,494,0
2020-05-01,1200807,202018,494,494,0
2020-05-01,1200203,202018,501,494,7
2020-05-02,1200450,202018,501,501,0
2020-05-02,1200302,202018,502,501,1
2020-05-02,1200708,202018,502,502,0
2020-05-02,1200807,202018,502,502,0
2020-05-02,1200401,202018,568,502,66
2020-05-02,1200609,202018,569,568,1
2020-05-02,1200336,202018,570,569,1
2020-05-02,1200013,202018,570,570,0
2020-05-02,1200054,202018,570,570,0
2020-05-02,1200385,202018,570,570,0
2020-05-02,1200138,202018,570,570,0
2020-05-02,1200203,202018,567,570,-3
2020-05-03,1200609,202019,568,567,1
2020-05-03,1200708,202019,568,568,0
2020-05-03,1200385,202019,575,568,7
2020-05-03,1200336,202019,575,575,0
2020-05-03,1200401,202019,668,575,93
2020-05-03,1200807,202019,668,668,0
2020-05-03,1200203,202019,668,668,0
2020-05-03,1200138,202019,668,668,0
2020-05-03,1200054,202019,668,668,0
2020-05-03,1200013,202019,670,668,2
2020-05-03,1200450,202019,672,670,2
2020-05-03,1200302,202019,672,672,0
2020-05-04,1200138,202019,672,672,0
2020-05-04,1200708,202019,672,672,0
2020-05-04,1200609,202019,672,672,0
2020-05-04,1200450,202019,676,672,4
2020-05-04,1200500,202019,678,676,2
2020-05-04,1200401,202019,746,678,68
2020-05-04,1200807,202019,746,746,0
2020-05-04,1200336,202019,745,746,-1
2020-05-04,1200302,202019,745,745,0
2020-05-04,1200203,202019,747,745,2
2020-05-04,1200013,202019,747,747,0
2020-05-04,1200054,202019,747,747,0
2020-05-04,1200385,202019,747,747,0
2020-05-05,1200013,202019,748,747,1
2020-05-05,1200708,202019,748,748,0
2020-05-05,1200609,202019,754,748,6
2020-05-05,1200450,202019,755,754,1
2020-05-05,1200500,202019,755,755,0
2020-05-05,1200401,202019,816,755,61
2020-05-05,1200807,202019,816,816,0
2020-05-05,1200336,202019,816,816,0
2020-05-05,1200302,202019,816,816,0
2020-05-05,1200203,202019,827,816,11
2020-05-05,1200138,202019,827,827,0
2020-05-05,1200054,202019,827,827,0
2020-05-05,1200385,202019,831,827,4
2020-05-06,1200708,202019,831,831,0
2020-05-06,1200609,202019,831,831,0
2020-05-06,1200450,202019,832,831,1
2020-05-06,1200500,202019,832,832,0
2020-05-06,1200401,202019,944,832,112
2020-05-06,1200385,202019,952,944,8
2020-05-06,1200807,202019,953,952,1
2020-05-06,1200138,202019,954,953,1
2020-05-06,1200013,202019,953,954,-1
2020-05-06,1200054,202019,953,953,0
2020-05-06,1200203,202019,957,953,4
2020-05-06,1200336,202019,957,957,0
2020-05-06,1200302,202019,957,957,0
2020-05-07,1200385,202019,958,957,1
2020-05-07,1200302,202019,958,958,0
2020-05-07,1200013,202019,958,958,0
2020-05-07,1200054,202019,958,958,0
2020-05-07,1200807,202019,958,958,0
2020-05-07,1200203,202019,958,958,0
2020-05-07,1200252,202019,960,958,2
2020-05-07,1200708,202019,960,960,0
2020-05-07,1200609,202019,960,960,0
2020-05-07,1200450,202019,959,960,-1
2020-05-07,1200500,202019,959,959,0
2020-05-07,1200336,202019,960,959,1
2020-05-07,1200401,202019,1027,960,67
2020-05-07,1200138,202019,1028,1027,1
2020-05-08,1200385,202019,1036,1028,8
2020-05-08,1200450,202019,1040,1036,4
2020-05-08,1200435,202019,1041,1040,1
2020-05-08,1200401,202019,1160,1041,119
2020-05-08,1200609,202019,1161,1160,1
2020-05-08,1200708,202019,1162,1161,1
2020-05-08,1200807,202019,1167,1162,5
2020-05-08,1200336,202019,1167,1167,0
2020-05-08,1200013,202019,1169,1167,2
2020-05-08,1200252,202019,1169,1169,0
2020-05-08,1200203,202019,1190,1169,21
2020-05-08,1200179,202019,1191,1190,1
2020-05-08,1200138,202019,1191,1191,0
2020-05-08,1200054,202019,1191,1191,0
2020-05-08,1200500,202019,1191,1191,0
2020-05-08,1200302,202019,1191,1191,0
2020-05-09,1200807,202019,1191,1191,0
2020-05-09,1200013,202019,1202,1191,11
2020-05-09,1200054,202019,1202,1202,0
2020-05-09,1200104,202019,1203,1202,1
2020-05-09,1200138,202019,1203,1203,0
2020-05-09,1200252,202019,1203,1203,0
2020-05-09,1200203,202019,1202,1203,-1
2020-05-09,1200302,202019,1202,1202,0
2020-05-09,1200179,202019,1202,1202,0
2020-05-09,1200385,202019,1208,1202,6
2020-05-09,1200401,202019,1338,1208,130
2020-05-09,1200435,202019,1338,1338,0
2020-05-09,1200500,202019,1341,1338,3
2020-05-09,1200450,202019,1341,1341,0
2020-05-09,1200708,202019,1342,1341,1
2020-05-09,1200609,202019,1349,1342,7
2020-05-09,1200336,202019,1349,1349,0
2020-05-10,1200708,202020,1349,1349,0
2020-05-10,1200252,202020,1349,1349,0
2020-05-10,1200450,202020,1362,1349,13
2020-05-10,1200013,202020,1364,1362,2
2020-05-10,1200054,202020,1364,1364,0
2020-05-10,1200104,202020,1364,1364,0
2020-05-10,1200138,202020,1364,1364,0
2020-05-10,1200179,202020,1364,1364,0
2020-05-10,1200203,202020,1393,1364,29
2020-05-10,1200609,202020,1393,1393,0
2020-05-10,1200302,202020,1393,1393,0
2020-05-10,1200385,202020,1393,1393,0
2020-05-10,1200807,202020,1393,1393,0
2020-05-10,1200401,202020,1461,1393,68
2020-05-10,1200435,202020,1461,1461,0
2020-05-10,1200500,202020,1461,1461,0
2020-05-10,1200336,202020,1461,1461,0
2020-05-11,1200302,202020,1461,1461,0
2020-05-11,1200054,202020,1461,1461,0
2020-05-11,1200104,202020,1461,1461,0
2020-05-11,1200138,202020,1461,1461,0
2020-05-11,1200179,202020,1461,1461,0
2020-05-11,1200203,202020,1467,1461,6
2020-05-11,1200252,202020,1467,1467,0
2020-05-11,1200336,202020,1467,1467,0
2020-05-11,1200013,202020,1467,1467,0
2020-05-11,1200385,202020,1467,1467,0
2020-05-11,1200807,202020,1467,1467,0
2020-05-11,1200401,202020,1467,1467,0
2020-05-11,1200435,202020,1467,1467,0
2020-05-11,1200500,202020,1473,1467,6
2020-05-11,1200450,202020,1474,1473,1
2020-05-11,1200708,202020,1474,1474,0
2020-05-11,1200609,202020,1474,1474,0
2020-05-12,1200252,202020,1474,1474,0
2020-05-12,1200203,202020,1478,1474,4
2020-05-12,1200179,202020,1478,1478,0
2020-05-12,1200609,202020,1483,1478,5
2020-05-12,1200104,202020,1485,1483,2
2020-05-12,1200351,202020,1488,1485,3
2020-05-12,1200302,202020,1488,1488,0
2020-05-12,1200138,202020,1492,1488,4
2020-05-12,1200336,202020,1492,1492,0
2020-05-12,1200013,202020,1493,1492,1
2020-05-12,1200385,202020,1507,1493,14
2020-05-12,1200500,202020,1513,1507,6
2020-05-12,1200054,202020,1513,1513,0
2020-05-12,1200708,202020,1514,1513,1
2020-05-12,1200450,202020,1526,1514,12
2020-05-12,1200427,202020,1530,1526,4
2020-05-12,1200401,202020,1601,1530,71
2020-05-12,1200807,202020,1604,1601,3
2020-05-12,1200435,202020,1604,1604,0
2020-05-13,1200252,202020,1604,1604,0
2020-05-13,1200302,202020,1604,1604,0
2020-05-13,1200013,202020,1612,1604,8
2020-05-13,1200054,202020,1612,1612,0
2020-05-13,1200104,202020,1612,1612,0
2020-05-13,1200138,202020,1620,1612,8
2020-05-13,1200179,202020,1620,1620,0
2020-05-13,1200203,202020,1660,1620,40
2020-05-13,1200385,202020,1661,1660,1
2020-05-13,1200351,202020,1661,1661,0
2020-05-13,1200336,202020,1661,1661,0
2020-05-13,1200450,202020,1661,1661,0
2020-05-13,1200708,202020,1662,1661,1
2020-05-13,1200609,202020,1663,1662,1
2020-05-13,1200427,202020,1664,1663,1
2020-05-13,1200435,202020,1664,1664,0
2020-05-13,1200401,202020,1708,1664,44
2020-05-13,1200807,202020,1708,1708,0
2020-05-13,1200500,202020,1708,1708,0
2020-05-14,1200054,202020,1708,1708,0
2020-05-14,1200708,202020,1708,1708,0
2020-05-14,1200609,202020,1708,1708,0
2020-05-14,1200807,202020,1708,1708,0
2020-05-14,1200435,202020,1709,1708,1
2020-05-14,1200203,202020,1728,1709,19
2020-05-14,1200427,202020,1727,1728,-1
2020-05-14,1200013,202020,1735,1727,8
2020-05-14,1200104,202020,1735,1735,0
2020-05-14,1200450,202020,1736,1735,1
2020-05-14,1200179,202020,1736,1736,0
2020-05-14,1200302,202020,1736,1736,0
2020-05-14,1200401,202020,1740,1736,4
2020-05-14,1200385,202020,1746,1740,6
2020-05-14,1200138,202020,1746,1746,0
2020-05-14,1200351,202020,1751,1746,5
2020-05-14,1200252,202020,1752,1751,1
2020-05-14,1200500,202020,1754,1752,2
2020-05-14,1200336,202020,1754,1754,0
2020-05-15,1200179,202020,1755,1754,1
2020-05-15,1200252,202020,1755,1755,0
2020-05-15,1200013,202020,1767,1755,12
2020-05-15,1200054,202020,1767,1767,0
2020-05-15,1200104,202020,1767,1767,0
2020-05-15,1200138,202020,1768,1767,1
2020-05-15,1200708,202020,1768,1768,0
2020-05-15,1200609,202020,1771,1768,3
2020-05-15,1200450,202020,1767,1771,-4
2020-05-15,1200203,202020,1785,1767,18
2020-05-15,1200435,202020,1785,1785,0
2020-05-15,1200807,202020,1786,1785,1
2020-05-15,1200302,202020,1786,1786,0
2020-05-15,1200351,202020,1789,1786,3
2020-05-15,1200500,202020,1791,1789,2
2020-05-15,1200385,202020,1792,1791,1
2020-05-15,1200401,202020,1798,1792,6
2020-05-15,1200427,202020,1799,1798,1
2020-05-15,1200336,202020,1799,1799,0
2020-05-16,1200302,202020,1800,1799,1
2020-05-16,1200609,202020,1809,1800,9
2020-05-16,1200450,202020,1810,1809,1
2020-05-16,1200500,202020,1813,1810,3
2020-05-16,1200435,202020,1813,1813,0
2020-05-16,1200427,202020,1812,1813,-1
2020-05-16,1200401,202020,1818,1812,6
2020-05-16,1200351,202020,1819,1818,1
2020-05-16,1200708,202020,1819,1819,0
2020-05-16,1200385,202020,1821,1819,2
2020-05-16,1200203,202020,1869,1821,48
2020-05-16,1200179,202020,1869,1869,0
2020-05-16,1200138,202020,1870,1869,1
2020-05-16,1200104,202020,1869,1870,-1
2020-05-16,1200054,202020,1869,1869,0
2020-05-16,1200013,202020,1877,1869,8
2020-05-16,1200807,202020,1878,1877,1
2020-05-16,1200336,202020,1880,1878,2
2020-05-16,1200252,202020,1881,1880,1
2020-05-17,1200807,202021,1881,1881,0
2020-05-17,1200138,202021,1880,1881,-1
2020-05-17,1200104,202021,1882,1880,2
2020-05-17,1200203,202021,1883,1882,1
2020-05-17,1200013,202021,1883,1883,0
2020-05-17,1200302,202021,1883,1883,0
2020-05-17,1200385,202021,1885,1883,2
2020-05-17,1200054,202021,1885,1885,0
2020-05-17,1200252,202021,1894,1885,9
2020-05-17,1200179,202021,1894,1894,0
2020-05-17,1200351,202021,1893,1894,-1
2020-05-17,1200401,202021,2007,1893,114
2020-05-17,1200336,202021,2007,2007,0
2020-05-17,1200435,202021,2007,2007,0
2020-05-17,1200427,202021,2006,2007,-1
2020-05-17,1200450,202021,2008,2006,2
2020-05-17,1200609,202021,2007,2008,-1
2020-05-17,1200708,202021,2007,2007,0
2020-05-17,1200500,202021,2010,2007,3
2020-05-18,1200609,202021,2010,2010,0
2020-05-18,1200401,202021,2217,2010,207
2020-05-18,1200252,202021,2219,2217,2
2020-05-18,1200054,202021,2219,2219,0
2020-05-18,1200104,202021,2220,2219,1
2020-05-18,1200138,202021,2220,2220,0
2020-05-18,1200179,202021,2226,2220,6
2020-05-18,1200708,202021,2227,2226,1
2020-05-18,1200450,202021,2232,2227,5
2020-05-18,1200500,202021,2239,2232,7
2020-05-18,1200435,202021,2239,2239,0
2020-05-18,1200013,202021,2246,2239,7
2020-05-18,1200351,202021,2246,2246,0
2020-05-18,1200336,202021,2246,2246,0
2020-05-18,1200302,202021,2246,2246,0
2020-05-18,1200807,202021,2246,2246,0
2020-05-18,1200203,202021,2250,2246,4
2020-05-18,1200427,202021,2249,2250,-1
2020-05-18,1200385,202021,2248,2249,-1
2020-05-19,1200385,202021,2263,2248,15
2020-05-19,1200013,202021,2263,2263,0
2020-05-19,1200054,202021,2264,2263,1
2020-05-19,1200104,202021,2265,2264,1
2020-05-19,1200138,202021,2266,2265,1
2020-05-19,1200203,202021,2286,2266,20
2020-05-19,1200252,202021,2286,2286,0
2020-05-19,1200302,202021,2286,2286,0
2020-05-19,1200336,202021,2287,2286,1
2020-05-19,1200351,202021,2291,2287,4
2020-05-19,1200401,202021,2448,2291,157
2020-05-19,1200179,202021,2450,2448,2
2020-05-19,1200427,202021,2450,2450,0
2020-05-19,1200708,202021,2450,2450,0
2020-05-19,1200807,202021,2455,2450,5
2020-05-19,1200450,202021,2465,2455,10
2020-05-19,1200500,202021,2472,2465,7
2020-05-19,1200435,202021,2472,2472,0
2020-05-19,1200609,202021,2496,2472,24
2020-05-20,1200385,202021,2496,2496,0
2020-05-20,1200401,202021,2496,2496,0
2020-05-20,1200807,202021,2496,2496,0
2020-05-20,1200104,202021,2496,2496,0
2020-05-20,1200435,202021,2496,2496,0
2020-05-20,1200708,202021,2496,2496,0
2020-05-20,1200609,202021,2496,2496,0
2020-05-20,1200450,202021,2496,2496,0
2020-05-20,1200336,202021,2496,2496,0
2020-05-20,1200427,202021,2496,2496,0
2020-05-20,1200138,202021,2496,2496,0
2020-05-20,1200203,202021,2496,2496,0
2020-05-20,1200252,202021,2496,2496,0
2020-05-20,1200179,202021,2496,2496,0
2020-05-20,1200351,202021,2496,2496,0
2020-05-20,1200054,202021,2496,2496,0
2020-05-20,1200013,202021,2496,2496,0
2020-05-20,1200302,202021,2496,2496,0
2020-05-20,1200500,202021,2496,2496,0
2020-05-21,1200708,202021,2501,2496,5
2020-05-21,1200609,202021,2536,2501,35
2020-05-21,1200500,202021,2576,2536,40
2020-05-21,1200435,202021,2576,2576,0
2020-05-21,1200427,202021,2578,2576,2
2020-05-21,1200401,202021,2883,2578,305
2020-05-21,1200807,202021,2891,2883,8
2020-05-21,1200385,202021,2917,2891,26
2020-05-21,1200336,202021,2918,2917,1
2020-05-21,1200351,202021,2929,2918,11
2020-05-21,1200252,202021,2949,2929,20
2020-05-21,1200203,202021,3043,2949,94
2020-05-21,1200179,202021,3046,3043,3
2020-05-21,1200138,202021,3049,3046,3
2020-05-21,1200104,202021,3066,3049,17
2020-05-21,1200054,202021,3071,3066,5
2020-05-21,1200013,202021,3096,3071,25
2020-05-21,1200450,202021,3117,3096,21
2020-05-21,1200302,202021,3117,3117,0
2020-05-22,1200302,202021,3117,3117,0
2020-05-22,1200252,202021,3117,3117,0
2020-05-22,1200203,202021,3205,3117,88
2020-05-22,1200450,202021,3214,3205,9
2020-05-22,1200104,202021,3220,3214,6
2020-05-22,1200013,202021,3240,3220,20
2020-05-22,1200351,202021,3249,3240,9
2020-05-22,1200138,202021,3252,3249,3
2020-05-22,1200336,202021,3252,3252,0
2020-05-22,1200179,202021,3252,3252,0
2020-05-22,1200807,202021,3253,3252,1
2020-05-22,1200054,202021,3253,3253,0
2020-05-22,1200609,202021,3266,3253,13
2020-05-22,1200500,202021,3284,3266,18
2020-05-22,1200708,202021,3285,3284,1
2020-05-22,1200435,202021,3285,3285,0
2020-05-22,1200427,202021,3288,3285,3
2020-05-22,1200401,202021,3356,3288,68
2020-05-22,1200385,202021,3357,3356,1
2020-05-23,1200013,202021,3367,3357,10
2020-05-23,1200450,202021,3367,3367,0
2020-05-23,1200708,202021,3372,3367,5
2020-05-23,1200609,202021,3403,3372,31
2020-05-23,1200500,202021,3421,3403,18
2020-05-23,1200435,202021,3421,3421,0
2020-05-23,1200252,202021,3426,3421,5
2020-05-23,1200427,202021,3426,3426,0
2020-05-23,1200054,202021,3426,3426,0
2020-05-23,1200104,202021,3422,3426,-4
2020-05-23,1200179,202021,3426,3422,4
2020-05-23,1200807,202021,3431,3426,5
2020-05-23,1200385,202021,3435,3431,4
2020-05-23,1200336,202021,3436,3435,1
2020-05-23,1200401,202021,3858,3436,422
2020-05-23,1200302,202021,3858,3858,0
2020-05-23,1200138,202021,3861,3858,3
2020-05-23,1200203,202021,3875,3861,14
2020-05-23,1200351,202021,3881,3875,6
2020-05-24,1200609,202022,3881,3881,0
2020-05-24,1200252,202022,3881,3881,0
2020-05-24,1200013,202022,3881,3881,0
2020-05-24,1200054,202022,3881,3881,0
2020-05-24,1200104,202022,3881,3881,0
2020-05-24,1200138,202022,3883,3881,2
2020-05-24,1200179,202022,3890,3883,7
2020-05-24,1200708,202022,3891,3890,1
2020-05-24,1200450,202022,3891,3891,0
2020-05-24,1200203,202022,3900,3891,9
2020-05-24,1200435,202022,3900,3900,0
2020-05-24,1200385,202022,3905,3900,5
2020-05-24,1200302,202022,3905,3905,0
2020-05-24,1200344,202022,3906,3905,1
2020-05-24,1200351,202022,3906,3906,0
2020-05-24,1200500,202022,3920,3906,14
2020-05-24,1200807,202022,3927,3920,7
2020-05-24,1200401,202022,4172,3927,245
2020-05-24,1200427,202022,4172,4172,0
2020-05-24,1200336,202022,4174,4172,2
2020-05-25,1200302,202022,4174,4174,0
2020-05-25,1200807,202022,4184,4174,10
2020-05-25,1200435,202022,4184,4184,0
2020-05-25,1200708,202022,4184,4184,0
2020-05-25,1200609,202022,4184,4184,0
2020-05-25,1200427,202022,4184,4184,0
2020-05-25,1200401,202022,4478,4184,294
2020-05-25,1200500,202022,4490,4478,12
2020-05-25,1200252,202022,4495,4490,5
2020-05-25,1200450,202022,4508,4495,13
2020-05-25,1200203,202022,4509,4508,1
2020-05-25,1200385,202022,4509,4509,0
2020-05-25,1200013,202022,4509,4509,0
2020-05-25,1200054,202022,4509,4509,0
2020-05-25,1200351,202022,4510,4509,1
2020-05-25,1200104,202022,4516,4510,6
2020-05-25,1200138,202022,4516,4516,0
2020-05-25,1200179,202022,4516,4516,0
2020-05-25,1200336,202022,4516,4516,0
2020-05-26,1200336,202022,4516,4516,0
2020-05-26,1200393,202022,4517,4516,1
2020-05-26,1200708,202022,4518,4517,1
2020-05-26,1200609,202022,4524,4518,6
2020-05-26,1200450,202022,4524,4524,0
2020-05-26,1200500,202022,4525,4524,1
2020-05-26,1200435,202022,4526,4525,1
2020-05-26,1200427,202022,4526,4526,0
2020-05-26,1200401,202022,4745,4526,219
2020-05-26,1200351,202022,4745,4745,0
2020-05-26,1200807,202022,4751,4745,6
2020-05-26,1200252,202022,4757,4751,6
2020-05-26,1200302,202022,4761,4757,4
2020-05-26,1200203,202022,4778,4761,17
2020-05-26,1200179,202022,4782,4778,4
2020-05-26,1200138,202022,4786,4782,4
2020-05-26,1200104,202022,4779,4786,-7
2020-05-26,1200054,202022,4780,4779,1
2020-05-26,1200013,202022,4783,4780,3
2020-05-26,1200385,202022,4796,4783,13
2020-05-27,1200708,202022,4800,4796,4
2020-05-27,1200401,202022,5065,4800,265
2020-05-27,1200427,202022,5067,5065,2
2020-05-27,1200807,202022,5081,5067,14
2020-05-27,1200500,202022,5114,5081,33
2020-05-27,1200450,202022,5119,5114,5
2020-05-27,1200609,202022,5166,5119,47
2020-05-27,1200435,202022,5171,5166,5
2020-05-27,1200385,202022,5171,5171,0
2020-05-27,1200393,202022,5172,5171,1
2020-05-27,1200351,202022,5191,5172,19
2020-05-27,1200203,202022,5216,5191,25
2020-05-27,1200179,202022,5217,5216,1
2020-05-27,1200013,202022,5230,5217,13
2020-05-27,1200138,202022,5235,5230,5
2020-05-27,1200336,202022,5239,5235,4
2020-05-27,1200104,202022,5249,5239,10
2020-05-27,1200252,202022,5254,5249,5
2020-05-27,1200302,202022,5255,5254,1
2020-05-27,1200054,202022,5266,5255,11
2020-05-28,1200385,202022,5270,5266,4
2020-05-28,1200336,202022,5274,5270,4
2020-05-28,1200138,202022,5277,5274,3
2020-05-28,1200179,202022,5283,5277,6
2020-05-28,1200203,202022,5406,5283,123
2020-05-28,1200252,202022,5407,5406,1
2020-05-28,1200302,202022,5407,5407,0
2020-05-28,1200351,202022,5418,5407,11
2020-05-28,1200450,202022,5418,5418,0
2020-05-28,1200609,202022,5442,5418,24
2020-05-28,1200393,202022,5442,5442,0
2020-05-28,1200708,202022,5445,5442,3
2020-05-28,1200013,202022,5450,5445,5
2020-05-28,1200054,202022,5453,5450,3
2020-05-28,1200104,202022,5453,5453,0
2020-05-28,1200807,202022,5453,5453,0
2020-05-28,1200435,202022,5456,5453,3
2020-05-28,1200427,202022,5456,5456,0
2020-05-28,1200401,202022,5597,5456,141
2020-05-28,1200500,202022,5615,5597,18
2020-05-29,1200385,202022,5617,5615,2
2020-05-29,1200013,202022,5625,5617,8
2020-05-29,1200054,202022,5626,5625,1
2020-05-29,1200104,202022,5627,5626,1
2020-05-29,1200138,202022,5629,5627,2
2020-05-29,1200179,202022,5630,5629,1
2020-05-29,1200203,202022,5651,5630,21
2020-05-29,1200252,202022,5653,5651,2
2020-05-29,1200302,202022,5654,5653,1
2020-05-29,1200351,202022,5659,5654,5
2020-05-29,1200336,202022,5664,5659,5
2020-05-29,1200401,202022,5799,5664,135
2020-05-29,1200435,202022,5799,5799,0
2020-05-29,1200500,202022,5813,5799,14
2020-05-29,1200450,202022,5832,5813,19
2020-05-29,1200609,202022,5843,5832,11
2020-05-29,1200708,202022,5848,5843,5
2020-05-29,1200427,202022,5851,5848,3
2020-05-29,1200393,202022,5851,5851,0
2020-05-29,1200807,202022,5856,5851,5
2020-05-30,1200427,202022,5858,5856,2
2020-05-30,1200435,202022,5859,5858,1
2020-05-30,1200500,202022,5866,5859,7
2020-05-30,1200450,202022,5868,5866,2
2020-05-30,1200351,202022,5874,5868,6
2020-05-30,1200708,202022,5877,5874,3
2020-05-30,1200385,202022,5896,5877,19
2020-05-30,1200807,202022,5896,5896,0
2020-05-30,1200609,202022,5900,5896,4
2020-05-30,1200336,202022,5901,5900,1
2020-05-30,1200203,202022,5944,5901,43
2020-05-30,1200138,202022,5949,5944,5
2020-05-30,1200302,202022,5954,5949,5
2020-05-30,1200252,202022,5955,5954,1
2020-05-30,1200179,202022,5959,5955,4
2020-05-30,1200401,202022,6084,5959,125
2020-05-30,1200393,202022,6084,6084,0
2020-05-30,1200054,202022,6086,6084,2
2020-05-30,1200013,202022,6086,6086,0
2020-05-30,1200344,202022,6087,6086,1
2020-05-30,1200104,202022,6087,6087,0
2020-05-31,1200179,202023,6087,6087,0
2020-05-31,1200138,202023,6088,6087,1
2020-05-31,1200385,202023,6089,6088,1
2020-05-31,1200336,202023,6090,6089,1
2020-05-31,1200351,202023,6090,6090,0
2020-05-31,1200344,202023,6090,6090,0
2020-05-31,1200401,202023,6174,6090,84
2020-05-31,1200252,202023,6174,6174,0
2020-05-31,1200203,202023,6206,6174,32
2020-05-31,1200302,202023,6206,6206,0
2020-05-31,1200104,202023,6208,6206,2
2020-05-31,1200054,202023,6210,6208,2
2020-05-31,1200013,202023,6210,6210,0
2020-05-31,1200427,202023,6212,6210,2
2020-05-31,1200435,202023,6212,6212,0
2020-05-31,1200500,202023,6216,6212,4
2020-05-31,1200450,202023,6218,6216,2
2020-05-31,1200609,202023,6220,6218,2
2020-05-31,1200708,202023,6220,6220,0
2020-05-31,1200807,202023,6234,6220,14
2020-05-31,1200393,202023,6234,6234,0
2020-06-01,1200302,202023,6234,6234,0
2020-06-01,1200252,202023,6252,6234,18
2020-06-01,1200203,202023,6253,6252,1
2020-06-01,1200138,202023,6253,6253,0
2020-06-01,1200807,202023,6253,6253,0
2020-06-01,1200054,202023,6254,6253,1
2020-06-01,1200013,202023,6254,6254,0
2020-06-01,1200344,202023,6254,6254,0
2020-06-01,1200104,202023,6255,6254,1
2020-06-01,1200336,202023,6255,6255,0
2020-06-01,1200179,202023,6255,6255,0
2020-06-01,1200393,202023,6255,6255,0
2020-06-01,1200351,202023,6255,6255,0
2020-06-01,1200435,202023,6255,6255,0
2020-06-01,1200708,202023,6255,6255,0
2020-06-01,1200609,202023,6255,6255,0
2020-06-01,1200385,202023,6256,6255,1
2020-06-01,1200500,202023,6256,6256,0
2020-06-01,1200427,202023,6256,6256,0
2020-06-01,1200401,202023,6341,6256,85
2020-06-01,1200450,202023,6341,6341,0
2020-06-02,1200203,202023,6340,6341,-1
2020-06-02,1200435,202023,6343,6340,3
2020-06-02,1200401,202023,6391,6343,48
2020-06-02,1200708,202023,6392,6391,1
2020-06-02,1200609,202023,6420,6392,28
2020-06-02,1200450,202023,6423,6420,3
2020-06-02,1200500,202023,6442,6423,19
2020-06-02,1200427,202023,6447,6442,5
2020-06-02,1200807,202023,6457,6447,10
2020-06-02,1200179,202023,6460,6457,3
2020-06-02,1200385,202023,6463,6460,3
2020-06-02,1200013,202023,6463,6463,0
2020-06-02,1200054,202023,6470,6463,7
2020-06-02,1200104,202023,6469,6470,-1
2020-06-02,1200138,202023,6469,6469,0
2020-06-02,1200393,202023,6469,6469,0
2020-06-02,1200252,202023,6470,6469,1
2020-06-02,1200344,202023,6472,6470,2
2020-06-02,1200351,202023,6476,6472,4
2020-06-02,1200336,202023,6477,6476,1
2020-06-02,1200302,202023,6480,6477,3
2020-06-03,1200393,202023,6480,6480,0
2020-06-03,1200427,202023,6486,6480,6
2020-06-03,1200435,202023,6486,6486,0
2020-06-03,1200500,202023,6488,6486,2
2020-06-03,1200401,202023,6540,6488,52
2020-06-03,1200609,202023,6584,6540,44
2020-06-03,1200708,202023,6593,6584,9
2020-06-03,1200344,202023,6593,6593,0
2020-06-03,1200807,202023,6596,6593,3
2020-06-03,1200450,202023,6596,6596,0
2020-06-03,1200385,202023,6597,6596,1
2020-06-03,1200138,202023,6596,6597,-1
2020-06-03,1200351,202023,6600,6596,4
2020-06-03,1200302,202023,6608,6600,8
2020-06-03,1200328,202023,6609,6608,1
2020-06-03,1200252,202023,6619,6609,10
2020-06-03,1200203,202023,6656,6619,37
2020-06-03,1200179,202023,6658,6656,2
2020-06-03,1200104,202023,6675,6658,17
2020-06-03,1200054,202023,6683,6675,8
2020-06-03,1200336,202023,6692,6683,9
2020-06-03,1200013,202023,6694,6692,2
2020-06-04,1200385,202023,6694,6694,0
2020-06-04,1200351,202023,6694,6694,0
2020-06-04,1200344,202023,6694,6694,0
2020-06-04,1200328,202023,6694,6694,0
2020-06-04,1200336,202023,6694,6694,0
2020-06-04,1200252,202023,6694,6694,0
2020-06-04,1200203,202023,6694,6694,0
2020-06-04,1200450,202023,6694,6694,0
2020-06-04,1200609,202023,6694,6694,0
2020-06-04,1200302,202023,6694,6694,0
2020-06-04,1200708,202023,6694,6694,0
2020-06-04,1200013,202023,6694,6694,0
2020-06-04,1200401,202023,6694,6694,0
2020-06-04,1200427,202023,6694,6694,0
2020-06-04,1200435,202023,6694,6694,0
2020-06-04,1200500,202023,6694,6694,0
2020-06-04,1200807,202023,6694,6694,0
2020-06-04,1200054,202023,6694,6694,0
2020-06-04,1200138,202023,6694,6694,0
2020-06-04,1200179,202023,6694,6694,0
2020-06-04,1200104,202023,6694,6694,0
2020-06-04,1200393,202023,6694,6694,0
2020-06-05,1200344,202023,6709,6694,15
2020-06-05,1200328,202023,6709,6709,0
2020-06-05,1200302,202023,6718,6709,9
2020-06-05,1200252,202023,6719,6718,1
2020-06-05,1200336,202023,6743,6719,24
2020-06-05,1200179,202023,6759,6743,16
2020-06-05,1200138,202023,6780,6759,21
2020-06-05,1200351,202023,6786,6780,6
2020-06-05,1200203,202023,6927,6786,141
2020-06-05,1200054,202023,6940,6927,13
2020-06-05,1200500,202023,6947,6940,7
2020-06-05,1200807,202023,6963,6947,16
2020-06-05,1200708,202023,6987,6963,24
2020-06-05,1200609,202023,7031,6987,44
2020-06-05,1200450,202023,7050,7031,19
2020-06-05,1200393,202023,7050,7050,0
2020-06-05,1200435,202023,7080,7050,30
2020-06-05,1200104,202023,7120,7080,40
2020-06-05,1200013,202023,7125,7120,5
2020-06-05,1200401,202023,7284,7125,159
2020-06-05,1200427,202023,7286,7284,2
2020-06-05,1200385,202023,7299,7286,13
2020-06-06,1200252,202023,7303,7299,4
2020-06-06,1200203,202023,7405,7303,102
2020-06-06,1200179,202023,7408,7405,3
2020-06-06,1200138,202023,7411,7408,3
2020-06-06,1200054,202023,7414,7411,3
2020-06-06,1200302,202023,7416,7414,2
2020-06-06,1200013,202023,7416,7416,0
2020-06-06,1200450,202023,7417,7416,1
2020-06-06,1200609,202023,7440,7417,23
2020-06-06,1200104,202023,7457,7440,17
2020-06-06,1200328,202023,7460,7457,3
2020-06-06,1200427,202023,7467,7460,7
2020-06-06,1200351,202023,7473,7467,6
2020-06-06,1200500,202023,7476,7473,3
2020-06-06,1200708,202023,7484,7476,8
2020-06-06,1200435,202023,7485,7484,1
2020-06-06,1200401,202023,7523,7485,38
2020-06-06,1200344,202023,7524,7523,1
2020-06-06,1200807,202023,7528,7524,4
2020-06-06,1200385,202023,7532,7528,4
2020-06-06,1200336,202023,7540,7532,8
2020-06-06,1200393,202023,7540,7540,0
2020-06-07,1200302,202024,7548,7540,8
2020-06-07,1200385,202024,7549,7548,1
2020-06-07,1200013,202024,7549,7549,0
2020-06-07,1200054,202024,7549,7549,0
2020-06-07,1200104,202024,7549,7549,0
2020-06-07,1200138,202024,7554,7549,5
2020-06-07,1200179,202024,7554,7554,0
2020-06-07,1200203,202024,7931,7554,377
2020-06-07,1200252,202024,7932,7931,1
2020-06-07,1200328,202024,7932,7932,0
2020-06-07,1200344,202024,7933,7932,1
2020-06-07,1200336,202024,7932,7933,-1
2020-06-07,1200708,202024,7932,7932,0
2020-06-07,1200609,202024,7934,7932,2
2020-06-07,1200450,202024,7935,7934,1
2020-06-07,1200500,202024,7935,7935,0
2020-06-07,1200435,202024,7937,7935,2
2020-06-07,1200427,202024,7938,7937,1
2020-06-07,1200401,202024,7997,7938,59
2020-06-07,1200393,202024,7997,7997,0
2020-06-07,1200807,202024,7997,7997,0
2020-06-07,1200351,202024,7998,7997,1
2020-06-08,1200302,202024,7998,7998,0
2020-06-08,1200344,202024,7998,7998,0
2020-06-08,1200252,202024,7998,7998,0
2020-06-08,1200203,202024,8022,7998,24
2020-06-08,1200328,202024,8022,8022,0
2020-06-08,1200138,202024,8022,8022,0
2020-06-08,1200104,202024,8039,8022,17
2020-06-08,1200054,202024,8040,8039,1
2020-06-08,1200013,202024,8041,8040,1
2020-06-08,1200179,202024,8042,8041,1
2020-06-08,1200336,202024,8042,8042,0
2020-06-08,1200393,202024,8042,8042,0
2020-06-08,1200385,202024,8045,8042,3
2020-06-08,1200807,202024,8047,8045,2
2020-06-08,1200427,202024,8046,8047,-1
2020-06-08,1200435,202024,8046,8046,0
2020-06-08,1200450,202024,8047,8046,1
2020-06-08,1200609,202024,8048,8047,1
2020-06-08,1200708,202024,8048,8048,0
2020-06-08,1200401,202024,8132,8048,84
2020-06-08,1200500,202024,8142,8132,10
2020-06-08,1200351,202024,8142,8142,0
2020-06-09,1200351,202024,8146,8142,4
2020-06-09,1200393,202024,8146,8146,0
2020-06-09,1200401,202024,8220,8146,74
2020-06-09,1200427,202024,8222,8220,2
2020-06-09,1200609,202024,8248,8222,26
2020-06-09,1200500,202024,8253,8248,5
2020-06-09,1200450,202024,8261,8253,8
2020-06-09,1200807,202024,8277,8261,16
2020-06-09,1200708,202024,8295,8277,18
2020-06-09,1200435,202024,8309,8295,14
2020-06-09,1200336,202024,8321,8309,12
2020-06-09,1200054,202024,8330,8321,9
2020-06-09,1200344,202024,8338,8330,8
2020-06-09,1200013,202024,8339,8338,1
2020-06-09,1200104,202024,8363,8339,24
2020-06-09,1200385,202024,8365,8363,2
2020-06-09,1200179,202024,8373,8365,8
2020-06-09,1200252,202024,8380,8373,7
2020-06-09,1200302,202024,8388,8380,8
2020-06-09,1200328,202024,8388,8388,0
2020-06-09,1200203,202024,8461,8388,73
2020-06-09,1200138,202024,8472,8461,11
2020-06-10,1200336,202024,8479,8472,7
2020-06-10,1200609,202024,8502,8479,23
2020-06-10,1200351,202024,8505,8502,3
2020-06-10,1200252,202024,8505,8505,0
2020-06-10,1200328,202024,8505,8505,0
2020-06-10,1200302,202024,8511,8505,6
2020-06-10,1200385,202024,8511,8511,0
2020-06-10,1200393,202024,8511,8511,0
2020-06-10,1200344,202024,8514,8511,3
2020-06-10,1200401,202024,8528,8514,14
2020-06-10,1200427,202024,8528,8528,0
2020-06-10,1200708,202024,8533,8528,5
2020-06-10,1200500,202024,8541,8533,8
2020-06-10,1200450,202024,8542,8541,1
2020-06-10,1200807,202024,8543,8542,1
2020-06-10,1200203,202024,8717,8543,174
2020-06-10,1200179,202024,8717,8717,0
2020-06-10,1200138,202024,8719,8717,2
2020-06-10,1200104,202024,8743,8719,24
2020-06-10,1200054,202024,8753,8743,10
2020-06-10,1200013,202024,8753,8753,0
2020-06-10,1200435,202024,8761,8753,8
2020-06-11,1200344,202024,8762,8761,1
2020-06-11,1200328,202024,8765,8762,3
2020-06-11,1200302,202024,8770,8765,5
2020-06-11,1200252,202024,8779,8770,9
2020-06-11,1200807,202024,8779,8779,0
2020-06-11,1200179,202024,8789,8779,10
2020-06-11,1200336,202024,8791,8789,2
2020-06-11,1200427,202024,8800,8791,9
2020-06-11,1200351,202024,8800,8800,0
2020-06-11,1200203,202024,8834,8800,34
2020-06-11,1200385,202024,8840,8834,6
2020-06-11,1200609,202024,8846,8840,6
2020-06-11,1200393,202024,8846,8846,0
2020-06-11,1200708,202024,8862,8846,16
2020-06-11,1200401,202024,9093,8862,231
2020-06-11,1200450,202024,9093,9093,0
2020-06-11,1200138,202024,9096,9093,3
2020-06-11,1200500,202024,9107,9096,11
2020-06-11,1200104,202024,9098,9107,-9
2020-06-11,1200013,202024,9098,9098,0
2020-06-11,1200054,202024,9098,9098,0
2020-06-11,1200435,202024,9106,9098,8
2020-06-12,1200807,202024,9108,9106,2
2020-06-12,1200609,202024,9111,9108,3
2020-06-12,1200500,202024,9136,9111,25
2020-06-12,1200427,202024,9136,9136,0
2020-06-12,1200344,202024,9136,9136,0
2020-06-12,1200435,202024,9136,9136,0
2020-06-12,1200401,202024,9221,9136,85
2020-06-12,1200450,202024,9246,9221,25
2020-06-12,1200336,202024,9246,9246,0
2020-06-12,1200708,202024,9255,9246,9
2020-06-12,1200385,202024,9260,9255,5
2020-06-12,1200252,202024,9260,9260,0
2020-06-12,1200393,202024,9260,9260,0
2020-06-12,1200351,202024,9265,9260,5
2020-06-12,1200054,202024,9274,9265,9
2020-06-12,1200104,202024,9293,9274,19
2020-06-12,1200138,202024,9293,9293,0
2020-06-12,1200013,202024,9298,9293,5
2020-06-12,1200203,202024,9307,9298,9
2020-06-12,1200302,202024,9307,9307,0
2020-06-12,1200328,202024,9309,9307,2
2020-06-12,1200179,202024,9310,9309,1
2020-06-13,1200351,202024,9313,9310,3
2020-06-13,1200393,202024,9313,9313,0
2020-06-13,1200708,202024,9325,9313,12
2020-06-13,1200609,202024,9327,9325,2
2020-06-13,1200450,202024,9334,9327,7
2020-06-13,1200500,202024,9348,9334,14
2020-06-13,1200435,202024,9348,9348,0
2020-06-13,1200427,202024,9348,9348,0
2020-06-13,1200401,202024,9477,9348,129
2020-06-13,1200807,202024,9484,9477,7
2020-06-13,1200328,202024,9486,9484,2
2020-06-13,1200336,202024,9493,9486,7
2020-06-13,1200302,202024,9506,9493,13
2020-06-13,1200344,202024,9508,9506,2
2020-06-13,1200203,202024,9526,9508,18
2020-06-13,1200179,202024,9537,9526,11
2020-06-13,1200138,202024,9540,9537,3
2020-06-13,1200104,202024,9540,9540,0
2020-06-13,1200054,202024,9540,9540,0
2020-06-13,1200013,202024,9540,9540,0
2020-06-13,1200385,202024,9549,9540,9
2020-06-13,1200252,202024,9549,9549,0
2020-06-14,1200351,202025,9549,9549,0
2020-06-14,1200385,202025,9549,9549,0
2020-06-14,1200344,202025,9549,9549,0
2020-06-14,1200328,202025,9550,9549,1
2020-06-14,1200609,202025,9550,9550,0
2020-06-14,1200203,202025,9560,9550,10
2020-06-14,1200336,202025,9560,9560,0
2020-06-14,1200450,202025,9560,9560,0
2020-06-14,1200302,202025,9561,9560,1
2020-06-14,1200708,202025,9562,9561,1
2020-06-14,1200252,202025,9570,9562,8
2020-06-14,1200401,202025,9599,9570,29
2020-06-14,1200138,202025,9601,9599,2
2020-06-14,1200104,202025,9622,9601,21
2020-06-14,1200393,202025,9623,9622,1
2020-06-14,1200013,202025,9629,9623,6
2020-06-14,1200179,202025,9631,9629,2
2020-06-14,1200807,202025,9631,9631,0
2020-06-14,1200500,202025,9646,9631,15
2020-06-14,1200435,202025,9647,9646,1
2020-06-14,1200427,202025,9650,9647,3
2020-06-14,1200054,202025,9657,9650,7
2020-06-15,1200336,202025,9657,9657,0
2020-06-15,1200500,202025,9659,9657,2
2020-06-15,1200351,202025,9659,9659,0
2020-06-15,1200138,202025,9658,9659,-1
2020-06-15,1200179,202025,9659,9658,1
2020-06-15,1200203,202025,9665,9659,6
2020-06-15,1200252,202025,9665,9665,0
2020-06-15,1200302,202025,9665,9665,0
2020-06-15,1200328,202025,9666,9665,1
2020-06-15,1200344,202025,9666,9666,0
2020-06-15,1200054,202025,9666,9666,0
2020-06-15,1200385,202025,9666,9666,0
2020-06-15,1200807,202025,9675,9666,9
2020-06-15,1200401,202025,9776,9675,101
2020-06-15,1200013,202025,9776,9776,0
2020-06-15,1200104,202025,9782,9776,6
2020-06-15,1200435,202025,9782,9782,0
2020-06-15,1200427,202025,9784,9782,2
2020-06-15,1200450,202025,9785,9784,1
2020-06-15,1200609,202025,9785,9785,0
2020-06-15,1200708,202025,9786,9785,1
2020-06-15,1200393,202025,9786,9786,0
2020-06-16,1200328,202025,9787,9786,1
2020-06-16,1200013,202025,9787,9787,0
2020-06-16,1200054,202025,9791,9787,4
2020-06-16,1200344,202025,9792,9791,1
2020-06-16,1200138,202025,9798,9792,6
2020-06-16,1200179,202025,9799,9798,1
2020-06-16,1200203,202025,9823,9799,24
2020-06-16,1200252,202025,9823,9823,0
2020-06-16,1200302,202025,9836,9823,13
2020-06-16,1200336,202025,9837,9836,1
2020-06-16,1200104,202025,9837,9837,0
2020-06-16,1200807,202025,9837,9837,0
2020-06-16,1200393,202025,9838,9837,1
2020-06-16,1200427,202025,9840,9838,2
2020-06-16,1200435,202025,9842,9840,2
2020-06-16,1200500,202025,9843,9842,1
2020-06-16,1200450,202025,9844,9843,1
2020-06-16,1200609,202025,9846,9844,2
2020-06-16,1200708,202025,9845,9846,-1
2020-06-16,1200401,202025,10010,9845,165
2020-06-16,1200385,202025,10016,10010,6
2020-06-16,1200351,202025,10018,10016,2
2020-06-17,1200807,202025,10028,10018,10
2020-06-17,1200393,202025,10030,10028,2
2020-06-17,1200401,202025,10162,10030,132
2020-06-17,1200427,202025,10168,10162,6
2020-06-17,1200708,202025,10194,10168,26
2020-06-17,1200450,202025,10206,10194,12
2020-06-17,1200609,202025,10223,10206,17
2020-06-17,1200302,202025,10233,10223,10
2020-06-17,1200435,202025,10239,10233,6
2020-06-17,1200351,202025,10243,10239,4
2020-06-17,1200500,202025,10286,10243,43
2020-06-17,1200138,202025,10292,10286,6
2020-06-17,1200344,202025,10297,10292,5
2020-06-17,1200013,202025,10299,10297,2
2020-06-17,1200054,202025,10309,10299,10
2020-06-17,1200104,202025,10332,10309,23
2020-06-17,1200385,202025,10332,10332,0
2020-06-17,1200179,202025,10332,10332,0
2020-06-17,1200252,202025,10333,10332,1
2020-06-17,1200328,202025,10336,10333,3
2020-06-17,1200203,202025,10350,10336,14
2020-06-17,1200336,202025,10354,10350,4
2020-06-18,1200807,202025,10358,10354,4
2020-06-18,1200393,202025,10366,10358,8
2020-06-18,1200401,202025,10425,10366,59
2020-06-18,1200427,202025,10432,10425,7
2020-06-18,1200203,202025,10510,10432,78
2020-06-18,1200500,202025,10530,10510,20
2020-06-18,1200450,202025,10530,10530,0
2020-06-18,1200708,202025,10541,10530,11
2020-06-18,1200385,202025,10542,10541,1
2020-06-18,1200435,202025,10558,10542,16
2020-06-18,1200336,202025,10563,10558,5
2020-06-18,1200302,202025,10579,10563,16
2020-06-18,1200344,202025,10581,10579,2
2020-06-18,1200328,202025,10587,10581,6
2020-06-18,1200252,202025,10587,10587,0
2020-06-18,1200609,202025,10635,10587,48
2020-06-18,1200179,202025,10643,10635,8
2020-06-18,1200138,202025,10658,10643,15
2020-06-18,1200104,202025,10658,10658,0
2020-06-18,1200054,202025,10677,10658,19
2020-06-18,1200013,202025,10678,10677,1
2020-06-18,1200351,202025,10679,10678,1
2020-06-19,1200203,202025,10693,10679,14
2020-06-19,1200302,202025,10705,10693,12
2020-06-19,1200252,202025,10718,10705,13
2020-06-19,1200179,202025,10721,10718,3
2020-06-19,1200328,202025,10725,10721,4
2020-06-19,1200104,202025,10725,10725,0
2020-06-19,1200054,202025,10728,10725,3
2020-06-19,1200013,202025,10728,10728,0
2020-06-19,1200138,202025,10728,10728,0
2020-06-19,1200344,202025,10729,10728,1
2020-06-19,1200336,202025,10730,10729,1
2020-06-19,1200385,202025,10733,10730,3
2020-06-19,1200435,202025,10733,10733,0
2020-06-19,1200401,202025,10884,10733,151
2020-06-19,1200708,202025,10889,10884,5
2020-06-19,1200609,202025,10942,10889,53
2020-06-19,1200351,202025,10944,10942,2
2020-06-19,1200500,202025,10963,10944,19
2020-06-19,1200427,202025,10974,10963,11
2020-06-19,1200393,202025,10986,10974,12
2020-06-19,1200807,202025,10989,10986,3
2020-06-19,1200450,202025,11002,10989,13
2020-06-20,1200807,202025,11015,11002,13
2020-06-20,1200708,202025,11020,11015,5
2020-06-20,1200609,202025,11031,11020,11
2020-06-20,1200450,202025,11031,11031,0
2020-06-20,1200500,202025,11058,11031,27
2020-06-20,1200435,202025,11082,11058,24
2020-06-20,1200427,202025,11083,11082,1
2020-06-20,1200401,202025,11189,11083,106
2020-06-20,1200385,202025,11193,11189,4
2020-06-20,1200336,202025,11201,11193,8
2020-06-20,1200393,202025,11222,11201,21
2020-06-20,1200344,202025,11223,11222,1
2020-06-20,1200138,202025,11227,11223,4
2020-06-20,1200328,202025,11227,11227,0
2020-06-20,1200302,202025,11244,11227,17
2020-06-20,1200252,202025,11244,11244,0
2020-06-20,1200179,202025,11246,11244,2
2020-06-20,1200203,202025,11270,11246,24
2020-06-20,1200104,202025,11270,11270,0
2020-06-20,1200054,202025,11278,11270,8
2020-06-20,1200013,202025,11278,11278,0
2020-06-20,1200351,202025,11278,11278,0
2020-06-21,1200401,202026,11358,11278,80
2020-06-21,1200609,202026,11362,11358,4
2020-06-21,1200807,202026,11375,11362,13
2020-06-21,1200328,202026,11375,11375,0
2020-06-21,1200344,202026,11375,11375,0
2020-06-21,1200351,202026,11375,11375,0
2020-06-21,1200336,202026,11375,11375,0
2020-06-21,1200385,202026,11384,11375,9
2020-06-21,1200393,202026,11384,11384,0
2020-06-21,1200427,202026,11387,11384,3
2020-06-21,1200252,202026,11387,11387,0
2020-06-21,1200500,202026,11387,11387,0
2020-06-21,1200013,202026,11387,11387,0
2020-06-21,1200054,202026,11387,11387,0
2020-06-21,1200104,202026,11387,11387,0
2020-06-21,1200138,202026,11391,11387,4
2020-06-21,1200708,202026,11391,11391,0
2020-06-21,1200203,202026,11391,11391,0
2020-06-21,1200302,202026,11391,11391,0
2020-06-21,1200450,202026,11391,11391,0
2020-06-21,1200179,202026,11396,11391,5
2020-06-21,1200435,202026,11396,11396,0
2020-06-22,1200609,202026,11397,11396,1
2020-06-22,1200385,202026,11398,11397,1
2020-06-22,1200138,202026,11402,11398,4
2020-06-22,1200179,202026,11407,11402,5
2020-06-22,1200203,202026,11427,11407,20
2020-06-22,1200252,202026,11433,11427,6
2020-06-22,1200302,202026,11433,11433,0
2020-06-22,1200328,202026,11436,11433,3
2020-06-22,1200344,202026,11436,11436,0
2020-06-22,1200351,202026,11436,11436,0
2020-06-22,1200336,202026,11436,11436,0
2020-06-22,1200807,202026,11447,11436,11
2020-06-22,1200401,202026,11514,11447,67
2020-06-22,1200427,202026,11514,11514,0
2020-06-22,1200435,202026,11514,11514,0
2020-06-22,1200500,202026,11514,11514,0
2020-06-22,1200450,202026,11521,11514,7
2020-06-22,1200708,202026,11523,11521,2
2020-06-22,1200104,202026,11548,11523,25
2020-06-22,1200054,202026,11550,11548,2
2020-06-22,1200013,202026,11554,11550,4
2020-06-22,1200393,202026,11554,11554,0
2020-06-23,1200328,202026,11554,11554,0
2020-06-23,1200302,202026,11567,11554,13
2020-06-23,1200252,202026,11567,11567,0
2020-06-23,1200203,202026,11604,11567,37
2020-06-23,1200344,202026,11605,11604,1
2020-06-23,1200138,202026,11615,11605,10
2020-06-23,1200104,202026,11621,11615,6
2020-06-23,1200013,202026,11621,11621,0
2020-06-23,1200179,202026,11621,11621,0
2020-06-23,1200351,202026,11629,11621,8
2020-06-23,1200435,202026,11636,11629,7
2020-06-23,1200708,202026,11643,11636,7
2020-06-23,1200807,202026,11645,11643,2
2020-06-23,1200393,202026,11647,11645,2
2020-06-23,1200054,202026,11647,11647,0
2020-06-23,1200401,202026,11771,11647,124
2020-06-23,1200336,202026,11776,11771,5
2020-06-23,1200385,202026,11776,11776,0
2020-06-23,1200500,202026,11807,11776,31
2020-06-23,1200450,202026,11808,11807,1
2020-06-23,1200609,202026,11823,11808,15
2020-06-23,1200427,202026,11825,11823,2
2020-06-24,1200328,202026,11825,11825,0
2020-06-24,1200344,202026,11825,11825,0
2020-06-24,1200013,202026,11825,11825,0
2020-06-24,1200054,202026,11831,11825,6
2020-06-24,1200104,202026,11851,11831,20
2020-06-24,1200138,202026,11854,11851,3
2020-06-24,1200179,202026,11854,11854,0
2020-06-24,1200203,202026,11876,11854,22
2020-06-24,1200252,202026,11884,11876,8
2020-06-24,1200302,202026,11904,11884,20
2020-06-24,1200385,202026,11917,11904,13
2020-06-24,1200708,202026,11933,11917,16
2020-06-24,1200807,202026,11938,11933,5
2020-06-24,1200401,202026,11994,11938,56
2020-06-24,1200351,202026,11999,11994,5
2020-06-24,1200609,202026,12003,11999,4
2020-06-24,1200450,202026,12011,12003,8
2020-06-24,1200336,202026,12016,12011,5
2020-06-24,1200435,202026,12017,12016,1
2020-06-24,1200427,202026,12018,12017,1
2020-06-24,1200393,202026,12020,12018,2
2020-06-24,1200500,202026,12037,12020,17
2020-06-25,1200252,202026,12038,12037,1
2020-06-25,1200609,202026,12041,12038,3
2020-06-25,1200450,202026,12045,12041,4
2020-06-25,1200500,202026,12073,12045,28
2020-06-25,1200435,202026,12082,12073,9
2020-06-25,1200427,202026,12084,12082,2
2020-06-25,1200401,202026,12232,12084,148
2020-06-25,1200393,202026,12232,12232,0
2020-06-25,1200807,202026,12244,12232,12
2020-06-25,1200351,202026,12250,12244,6
2020-06-25,1200708,202026,12249,12250,-1
2020-06-25,1200138,202026,12251,12249,2
2020-06-25,1200203,202026,12284,12251,33
2020-06-25,1200328,202026,12284,12284,0
2020-06-25,1200302,202026,12300,12284,16
2020-06-25,1200179,202026,12306,12300,6
2020-06-25,1200336,202026,12314,12306,8
2020-06-25,1200104,202026,12314,12314,0
2020-06-25,1200054,202026,12314,12314,0
2020-06-25,1200013,202026,12314,12314,0
2020-06-25,1200344,202026,12318,12314,4
2020-06-25,1200385,202026,12319,12318,1
2020-06-26,1200385,202026,12324,12319,5
2020-06-26,1200708,202026,12328,12324,4
2020-06-26,1200450,202026,12336,12328,8
2020-06-26,1200500,202026,12356,12336,20
2020-06-26,1200435,202026,12358,12356,2
2020-06-26,1200427,202026,12365,12358,7
2020-06-26,1200401,202026,12483,12365,118
2020-06-26,1200393,202026,12483,12483,0
2020-06-26,1200807,202026,12491,12483,8
2020-06-26,1200351,202026,12493,12491,2
2020-06-26,1200203,202026,12517,12493,24
2020-06-26,1200336,202026,12518,12517,1
2020-06-26,1200013,202026,12525,12518,7
2020-06-26,1200054,202026,12549,12525,24
2020-06-26,1200104,202026,12577,12549,28
2020-06-26,1200138,202026,12586,12577,9
2020-06-26,1200344,202026,12586,12586,0
2020-06-26,1200609,202026,12640,12586,54
2020-06-26,1200252,202026,12640,12640,0
2020-06-26,1200302,202026,12652,12640,12
2020-06-26,1200328,202026,12652,12652,0
2020-06-26,1200179,202026,12659,12652,7
2020-06-27,1200427,202026,12660,12659,1
2020-06-27,1200054,202026,12660,12660,0
2020-06-27,1200104,202026,12665,12660,5
2020-06-27,1200138,202026,12674,12665,9
2020-06-27,1200179,202026,12679,12674,5
2020-06-27,1200203,202026,12702,12679,23
2020-06-27,1200252,202026,12702,12702,0
2020-06-27,1200302,202026,12717,12702,15
2020-06-27,1200328,202026,12722,12717,5
2020-06-27,1200344,202026,12722,12722,0
2020-06-27,1200351,202026,12722,12722,0
2020-06-27,1200336,202026,12726,12722,4
2020-06-27,1200807,202026,12740,12726,14
2020-06-27,1200393,202026,12740,12740,0
2020-06-27,1200401,202026,12889,12740,149
2020-06-27,1200500,202026,12919,12889,30
2020-06-27,1200450,202026,12920,12919,1
2020-06-27,1200609,202026,12923,12920,3
2020-06-27,1200708,202026,12923,12923,0
2020-06-27,1200013,202026,12923,12923,0
2020-06-27,1200435,202026,12926,12923,3
2020-06-27,1200385,202026,12928,12926,2
2020-06-28,1200385,202027,12936,12928,8
2020-06-28,1200393,202027,12936,12936,0
2020-06-28,1200401,202027,13029,12936,93
2020-06-28,1200427,202027,13028,13029,-1
2020-06-28,1200708,202027,13029,13028,1
2020-06-28,1200500,202027,13032,13029,3
2020-06-28,1200450,202027,13033,13032,1
2020-06-28,1200609,202027,13036,13033,3
2020-06-28,1200336,202027,13036,13036,0
2020-06-28,1200435,202027,13036,13036,0
2020-06-28,1200807,202027,13039,13036,3
2020-06-28,1200179,202027,13041,13039,2
2020-06-28,1200054,202027,13044,13041,3
2020-06-28,1200344,202027,13044,13044,0
2020-06-28,1200328,202027,13044,13044,0
2020-06-28,1200302,202027,13045,13044,1
2020-06-28,1200252,202027,13045,13045,0
2020-06-28,1200351,202027,13045,13045,0
2020-06-28,1200013,202027,13045,13045,0
2020-06-28,1200138,202027,13054,13045,9
2020-06-28,1200104,202027,13054,13054,0
2020-06-28,1200203,202027,13073,13054,19
2020-06-29,1200252,202027,13082,13073,9
2020-06-29,1200609,202027,13084,13082,2
2020-06-29,1200807,202027,13093,13084,9
2020-06-29,1200328,202027,13093,13093,0
2020-06-29,1200344,202027,13093,13093,0
2020-06-29,1200351,202027,13093,13093,0
2020-06-29,1200336,202027,13093,13093,0
2020-06-29,1200385,202027,13093,13093,0
2020-06-29,1200393,202027,13093,13093,0
2020-06-29,1200401,202027,13125,13093,32
2020-06-29,1200427,202027,13125,13125,0
2020-06-29,1200708,202027,13134,13125,9
2020-06-29,1200500,202027,13134,13134,0
2020-06-29,1200450,202027,13134,13134,0
2020-06-29,1200302,202027,13135,13134,1
2020-06-29,1200203,202027,13137,13135,2
2020-06-29,1200179,202027,13137,13137,0
2020-06-29,1200138,202027,13137,13137,0
2020-06-29,1200104,202027,13161,13137,24
2020-06-29,1200054,202027,13161,13161,0
2020-06-29,1200013,202027,13161,13161,0
2020-06-29,1200435,202027,13161,13161,0
2020-06-30,1200401,202027,13242,13161,81
2020-06-30,1200427,202027,13242,13242,0
2020-06-30,1200435,202027,13242,13242,0
2020-06-30,1200500,202027,13243,13242,1
2020-06-30,1200393,202027,13243,13243,0
2020-06-30,1200450,202027,13243,13243,0
2020-06-30,1200609,202027,13245,13243,2
2020-06-30,1200708,202027,13245,13245,0
2020-06-30,1200138,202027,13248,13245,3
2020-06-30,1200203,202027,13256,13248,8
2020-06-30,1200807,202027,13259,13256,3
2020-06-30,1200385,202027,13265,13259,6
2020-06-30,1200336,202027,13265,13265,0
2020-06-30,1200351,202027,13265,13265,0
2020-06-30,1200344,202027,13265,13265,0
2020-06-30,1200328,202027,13265,13265,0
2020-06-30,1200302,202027,13265,13265,0
2020-06-30,1200252,202027,13265,13265,0
2020-06-30,1200179,202027,13267,13265,2
2020-06-30,1200104,202027,13267,13267,0
2020-06-30,1200054,202027,13268,13267,1
2020-06-30,1200013,202027,13268,13268,0
2020-07-01,1200807,202027,13272,13268,4
2020-07-01,1200401,202027,13421,13272,149
2020-07-01,1200427,202027,13421,13421,0
2020-07-01,1200435,202027,13423,13421,2
2020-07-01,1200336,202027,13443,13423,20
2020-07-01,1200450,202027,13449,13443,6
2020-07-01,1200609,202027,13479,13449,30
2020-07-01,1200708,202027,13485,13479,6
2020-07-01,1200393,202027,13485,13485,0
2020-07-01,1200500,202027,13522,13485,37
2020-07-01,1200385,202027,13527,13522,5
2020-07-01,1200351,202027,13540,13527,13
2020-07-01,1200344,202027,13542,13540,2
2020-07-01,1200054,202027,13553,13542,11
2020-07-01,1200104,202027,13616,13553,63
2020-07-01,1200138,202027,13639,13616,23
2020-07-01,1200179,202027,13639,13639,0
2020-07-01,1200013,202027,13641,13639,2
2020-07-01,1200252,202027,13656,13641,15
2020-07-01,1200302,202027,13696,13656,40
2020-07-01,1200328,202027,13700,13696,4
2020-07-01,1200203,202027,13730,13700,30
2020-07-02,1200807,202027,13731,13730,1
2020-07-02,1200302,202027,13738,13731,7
2020-07-02,1200609,202027,13778,13738,40
2020-07-02,1200450,202027,13780,13778,2
2020-07-02,1200500,202027,13792,13780,12
2020-07-02,1200435,202027,13795,13792,3
2020-07-02,1200427,202027,13797,13795,2
2020-07-02,1200401,202027,13950,13797,153
2020-07-02,1200393,202027,13950,13950,0
2020-07-02,1200385,202027,13951,13950,1
2020-07-02,1200252,202027,13959,13951,8
2020-07-02,1200351,202027,13964,13959,5
2020-07-02,1200013,202027,13969,13964,5
2020-07-02,1200054,202027,13979,13969,10
2020-07-02,1200104,202027,13994,13979,15
2020-07-02,1200138,202027,14002,13994,8
2020-07-02,1200336,202027,14010,14002,8
2020-07-02,1200203,202027,14047,14010,37
2020-07-02,1200708,202027,14061,14047,14
2020-07-02,1200328,202027,14061,14061,0
2020-07-02,1200344,202027,14062,14061,1
2020-07-02,1200179,202027,14063,14062,1
2020-07-03,1200328,202027,14063,14063,0
2020-07-03,1200344,202027,14063,14063,0
2020-07-03,1200013,202027,14063,14063,0
2020-07-03,1200054,202027,14063,14063,0
2020-07-03,1200104,202027,14063,14063,0
2020-07-03,1200138,202027,14063,14063,0
2020-07-03,1200179,202027,14064,14063,1
2020-07-03,1200203,202027,14065,14064,1
2020-07-03,1200252,202027,14065,14065,0
2020-07-03,1200302,202027,14065,14065,0
2020-07-03,1200336,202027,14065,14065,0
2020-07-03,1200351,202027,14065,14065,0
2020-07-03,1200385,202027,14071,14065,6
2020-07-03,1200393,202027,14071,14071,0
2020-07-03,1200708,202027,14071,14071,0
2020-07-03,1200609,202027,14071,14071,0
2020-07-03,1200450,202027,14071,14071,0
2020-07-03,1200435,202027,14071,14071,0
2020-07-03,1200427,202027,14072,14071,1
2020-07-03,1200401,202027,14116,14072,44
2020-07-03,1200807,202027,14117,14116,1
2020-07-03,1200500,202027,14127,14117,10
2020-07-04,1200385,202027,14130,14127,3
2020-07-04,1200609,202027,14195,14130,65
2020-07-04,1200450,202027,14196,14195,1
2020-07-04,1200500,202027,14207,14196,11
2020-07-04,1200435,202027,14209,14207,2
2020-07-04,1200427,202027,14209,14209,0
2020-07-04,1200401,202027,14353,14209,144
2020-07-04,1200393,202027,14353,14353,0
2020-07-04,1200807,202027,14363,14353,10
2020-07-04,1200344,202027,14363,14363,0
2020-07-04,1200708,202027,14376,14363,13
2020-07-04,1200138,202027,14394,14376,18
2020-07-04,1200203,202027,14442,14394,48
2020-07-04,1200302,202027,14457,14442,15
2020-07-04,1200252,202027,14462,14457,5
2020-07-04,1200179,202027,14469,14462,7
2020-07-04,1200336,202027,14475,14469,6
2020-07-04,1200104,202027,14491,14475,16
2020-07-04,1200054,202027,14491,14491,0
2020-07-04,1200013,202027,14491,14491,0
2020-07-04,1200328,202027,14491,14491,0
2020-07-04,1200351,202027,14502,14491,11
2020-07-05,1200385,202028,14499,14502,-3
2020-07-05,1200708,202028,14504,14499,5
2020-07-05,1200450,202028,14511,14504,7
2020-07-05,1200500,202028,14517,14511,6
2020-07-05,1200435,202028,14517,14517,0
2020-07-05,1200427,202028,14517,14517,0
2020-07-05,1200401,202028,14602,14517,85
2020-07-05,1200393,202028,14602,14602,0
2020-07-05,1200807,202028,14607,14602,5
2020-07-05,1200336,202028,14607,14607,0
2020-07-05,1200203,202028,14610,14607,3
2020-07-05,1200344,202028,14611,14610,1
2020-07-05,1200013,202028,14613,14611,2
2020-07-05,1200054,202028,14613,14613,0
2020-07-05,1200104,202028,14618,14613,5
2020-07-05,1200138,202028,14620,14618,2
2020-07-05,1200351,202028,14620,14620,0
2020-07-05,1200609,202028,14625,14620,5
2020-07-05,1200252,202028,14628,14625,3
2020-07-05,1200302,202028,14634,14628,6
2020-07-05,1200328,202028,14635,14634,1
2020-07-05,1200179,202028,14637,14635,2
2020-07-06,1200385,202028,14637,14637,0
2020-07-06,1200013,202028,14637,14637,0
2020-07-06,1200054,202028,14637,14637,0
2020-07-06,1200104,202028,14638,14637,1
2020-07-06,1200138,202028,14638,14638,0
2020-07-06,1200179,202028,14640,14638,2
2020-07-06,1200203,202028,14641,14640,1
2020-07-06,1200252,202028,14641,14641,0
2020-07-06,1200302,202028,14654,14641,13
2020-07-06,1200328,202028,14654,14654,0
2020-07-06,1200344,202028,14654,14654,0
2020-07-06,1200351,202028,14654,14654,0
2020-07-06,1200393,202028,14654,14654,0
2020-07-06,1200401,202028,14702,14654,48
2020-07-06,1200435,202028,14702,14702,0
2020-07-06,1200500,202028,14702,14702,0
2020-07-06,1200450,202028,14703,14702,1
2020-07-06,1200609,202028,14703,14703,0
2020-07-06,1200708,202028,14703,14703,0
2020-07-06,1200427,202028,14703,14703,0
2020-07-06,1200336,202028,14703,14703,0
2020-07-06,1200807,202028,14703,14703,0
2020-07-07,1200807,202028,14705,14703,2
2020-07-07,1200393,202028,14721,14705,16
2020-07-07,1200401,202028,14795,14721,74
2020-07-07,1200427,202028,14796,14795,1
2020-07-07,1200252,202028,14805,14796,9
2020-07-07,1200450,202028,14811,14805,6
2020-07-07,1200609,202028,14850,14811,39
2020-07-07,1200708,202028,14866,14850,16
2020-07-07,1200500,202028,14871,14866,5
2020-07-07,1200336,202028,14881,14871,10
2020-07-07,1200435,202028,14886,14881,5
2020-07-07,1200351,202028,14890,14886,4
2020-07-07,1200203,202028,14901,14890,11
2020-07-07,1200344,202028,14901,14901,0
2020-07-07,1200328,202028,14902,14901,1
2020-07-07,1200302,202028,14908,14902,6
2020-07-07,1200138,202028,14913,14908,5
2020-07-07,1200385,202028,14913,14913,0
2020-07-07,1200104,202028,14934,14913,21
2020-07-07,1200054,202028,14944,14934,10
2020-07-07,1200013,202028,14954,14944,10
2020-07-07,1200179,202028,14956,14954,2
2020-07-08,1200393,202028,14956,14956,0
2020-07-08,1200385,202028,14965,14956,9
2020-07-08,1200302,202028,14970,14965,5
2020-07-08,1200328,202028,14970,14970,0
2020-07-08,1200344,202028,14970,14970,0
2020-07-08,1200351,202028,14972,14970,2
2020-07-08,1200336,202028,14973,14972,1
2020-07-08,1200609,202028,14973,14973,0
2020-07-08,1200252,202028,14975,14973,2
2020-07-08,1200401,202028,15104,14975,129
2020-07-08,1200427,202028,15104,15104,0
2020-07-08,1200435,202028,15107,15104,3
2020-07-08,1200500,202028,15146,15107,39
2020-07-08,1200450,202028,15147,15146,1
2020-07-08,1200807,202028,15149,15147,2
2020-07-08,1200203,202028,15161,15149,12
2020-07-08,1200179,202028,15161,15161,0
2020-07-08,1200138,202028,15172,15161,11
2020-07-08,1200104,202028,15181,15172,9
2020-07-08,1200054,202028,15182,15181,1
2020-07-08,1200013,202028,15182,15182,0
2020-07-08,1200708,202028,15182,15182,0
2020-07-09,1200344,202028,15185,15182,3
2020-07-09,1200328,202028,15185,15185,0
2020-07-09,1200302,202028,15213,15185,28
2020-07-09,1200252,202028,15219,15213,6
2020-07-09,1200351,202028,15226,15219,7
2020-07-09,1200179,202028,15233,15226,7
2020-07-09,1200138,202028,15245,15233,12
2020-07-09,1200609,202028,15248,15245,3
2020-07-09,1200336,202028,15263,15248,15
2020-07-09,1200203,202028,15297,15263,34
2020-07-09,1200385,202028,15308,15297,11
2020-07-09,1200104,202028,15311,15308,3
2020-07-09,1200393,202028,15331,15311,20
2020-07-09,1200401,202028,15417,15331,86
2020-07-09,1200427,202028,15419,15417,2
2020-07-09,1200435,202028,15425,15419,6
2020-07-09,1200500,202028,15463,15425,38
2020-07-09,1200450,202028,15466,15463,3
2020-07-09,1200708,202028,15467,15466,1
2020-07-09,1200013,202028,15468,15467,1
2020-07-09,1200807,202028,15476,15468,8
2020-07-09,1200054,202028,15480,15476,4
2020-07-10,1200328,202028,15487,15480,7
2020-07-10,1200302,202028,15496,15487,9
2020-07-10,1200252,202028,15514,15496,18
2020-07-10,1200203,202028,15557,15514,43
2020-07-10,1200013,202028,15567,15557,10
2020-07-10,1200138,202028,15569,15567,2
2020-07-10,1200104,202028,15588,15569,19
2020-07-10,1200344,202028,15592,15588,4
2020-07-10,1200435,202028,15590,15592,-2
2020-07-10,1200179,202028,15591,15590,1
2020-07-10,1200351,202028,15600,15591,9
2020-07-10,1200054,202028,15610,15600,10
2020-07-10,1200708,202028,15627,15610,17
2020-07-10,1200609,202028,15637,15627,10
2020-07-10,1200450,202028,15637,15637,0
2020-07-10,1200500,202028,15647,15637,10
2020-07-10,1200385,202028,15647,15647,0
2020-07-10,1200427,202028,15650,15647,3
2020-07-10,1200401,202028,15779,15650,129
2020-07-10,1200393,202028,15779,15779,0
2020-07-10,1200807,202028,15781,15779,2
2020-07-10,1200336,202028,15783,15781,2
2020-07-11,1200252,202028,15786,15783,3
2020-07-11,1200203,202028,15863,15786,77
2020-07-11,1200179,202028,15870,15863,7
2020-07-11,1200138,202028,15875,15870,5
2020-07-11,1200302,202028,15910,15875,35
2020-07-11,1200054,202028,15913,15910,3
2020-07-11,1200450,202028,15916,15913,3
2020-07-11,1200609,202028,15933,15916,17
2020-07-11,1200104,202028,15944,15933,11
2020-07-11,1200328,202028,15949,15944,5
2020-07-11,1200013,202028,15949,15949,0
2020-07-11,1200351,202028,15951,15949,2
2020-07-11,1200336,202028,15974,15951,23
2020-07-11,1200385,202028,15982,15974,8
2020-07-11,1200807,202028,15989,15982,7
2020-07-11,1200393,202028,16006,15989,17
2020-07-11,1200401,202028,16071,16006,65
2020-07-11,1200427,202028,16076,16071,5
2020-07-11,1200500,202028,16087,16076,11
2020-07-11,1200708,202028,16095,16087,8
2020-07-11,1200435,202028,16095,16095,0
2020-07-11,1200344,202028,16095,16095,0
2020-07-12,1200302,202029,16120,16095,25
2020-07-12,1200252,202029,16120,16120,0
2020-07-12,1200203,202029,16135,16120,15
2020-07-12,1200179,202029,16142,16135,7
2020-07-12,1200385,202029,16142,16142,0
2020-07-12,1200104,202029,16142,16142,0
2020-07-12,1200328,202029,16144,16142,2
2020-07-12,1200054,202029,16144,16144,0
2020-07-12,1200013,202029,16144,16144,0
2020-07-12,1200138,202029,16147,16144,3
2020-07-12,1200344,202029,16148,16147,1
2020-07-12,1200393,202029,16148,16148,0
2020-07-12,1200708,202029,16148,16148,0
2020-07-12,1200336,202029,16148,16148,0
2020-07-12,1200807,202029,16148,16148,0
2020-07-12,1200401,202029,16198,16148,50
2020-07-12,1200427,202029,16198,16198,0
2020-07-12,1200351,202029,16198,16198,0
2020-07-12,1200500,202029,16202,16198,4
2020-07-12,1200450,202029,16203,16202,1
2020-07-12,1200609,202029,16205,16203,2
2020-07-12,1200435,202029,16205,16205,0
2020-07-13,1200328,202029,16205,16205,0
2020-07-13,1200351,202029,16205,16205,0
2020-07-13,1200013,202029,16205,16205,0
2020-07-13,1200104,202029,16205,16205,0
2020-07-13,1200138,202029,16205,16205,0
2020-07-13,1200179,202029,16205,16205,0
2020-07-13,1200203,202029,16217,16205,12
2020-07-13,1200252,202029,16217,16217,0
2020-07-13,1200302,202029,16217,16217,0
2020-07-13,1200344,202029,16217,16217,0
2020-07-13,1200427,202029,16217,16217,0
2020-07-13,1200500,202029,16218,16217,1
2020-07-13,1200385,202029,16218,16218,0
2020-07-13,1200807,202029,16221,16218,3
2020-07-13,1200393,202029,16221,16221,0
2020-07-13,1200401,202029,16272,16221,51
2020-07-13,1200435,202029,16272,16272,0
2020-07-13,1200450,202029,16272,16272,0
2020-07-13,1200609,202029,16274,16272,2
2020-07-13,1200708,202029,16274,16274,0
2020-07-13,1200054,202029,16274,16274,0
2020-07-13,1200336,202029,16275,16274,1
2020-07-14,1200393,202029,16275,16275,0
2020-07-14,1200807,202029,16279,16275,4
2020-07-14,1200401,202029,16332,16279,53
2020-07-14,1200427,202029,16334,16332,2
2020-07-14,1200385,202029,16334,16334,0
2020-07-14,1200500,202029,16363,16334,29
2020-07-14,1200450,202029,16364,16363,1
2020-07-14,1200609,202029,16395,16364,31
2020-07-14,1200708,202029,16402,16395,7
2020-07-14,1200435,202029,16403,16402,1
2020-07-14,1200336,202029,16409,16403,6
2020-07-14,1200104,202029,16436,16409,27
2020-07-14,1200351,202029,16447,16436,11
2020-07-14,1200054,202029,16450,16447,3
2020-07-14,1200138,202029,16450,16450,0
2020-07-14,1200013,202029,16455,16450,5
2020-07-14,1200203,202029,16460,16455,5
2020-07-14,1200252,202029,16478,16460,18
2020-07-14,1200302,202029,16483,16478,5
2020-07-14,1200328,202029,16485,16483,2
2020-07-14,1200344,202029,16494,16485,9
2020-07-14,1200179,202029,16494,16494,0
2020-07-15,1200252,202029,16503,16494,9
2020-07-15,1200393,202029,16514,16503,11
2020-07-15,1200385,202029,16514,16514,0
2020-07-15,1200336,202029,16520,16514,6
2020-07-15,1200807,202029,16520,16520,0
2020-07-15,1200344,202029,16527,16520,7
2020-07-15,1200328,202029,16529,16527,2
2020-07-15,1200401,202029,16589,16529,60
2020-07-15,1200609,202029,16591,16589,2
2020-07-15,1200351,202029,16595,16591,4
2020-07-15,1200427,202029,16597,16595,2
2020-07-15,1200302,202029,16616,16597,19
2020-07-15,1200500,202029,16626,16616,10
2020-07-15,1200450,202029,16632,16626,6
2020-07-15,1200203,202029,16652,16632,20
2020-07-15,1200179,202029,16652,16652,0
2020-07-15,1200138,202029,16653,16652,1
2020-07-15,1200104,202029,16675,16653,22
2020-07-15,1200054,202029,16679,16675,4
2020-07-15,1200013,202029,16681,16679,2
2020-07-15,1200708,202029,16687,16681,6
2020-07-15,1200435,202029,16687,16687,0
2020-07-16,1200302,202029,16716,16687,29
2020-07-16,1200344,202029,16717,16716,1
2020-07-16,1200328,202029,16718,16717,1
2020-07-16,1200252,202029,16719,16718,1
2020-07-16,1200351,202029,16724,16719,5
2020-07-16,1200179,202029,16724,16724,0
2020-07-16,1200401,202029,16775,16724,51
2020-07-16,1200393,202029,16780,16775,5
2020-07-16,1200336,202029,16787,16780,7
2020-07-16,1200203,202029,16786,16787,-1
2020-07-16,1200385,202029,16790,16786,4
2020-07-16,1200807,202029,16794,16790,4
2020-07-16,1200708,202029,16799,16794,5
2020-07-16,1200054,202029,16801,16799,2
2020-07-16,1200104,202029,16841,16801,40
2020-07-16,1200435,202029,16842,16841,1
2020-07-16,1200427,202029,16842,16842,0
2020-07-16,1200013,202029,16850,16842,8
2020-07-16,1200500,202029,16861,16850,11
2020-07-16,1200450,202029,16864,16861,3
2020-07-16,1200609,202029,16871,16864,7
2020-07-16,1200138,202029,16880,16871,9
2020-07-17,1200351,202029,16880,16880,0
2020-07-17,1200435,202029,16880,16880,0
2020-07-17,1200401,202029,16930,16880,50
2020-07-17,1200708,202029,16930,16930,0
2020-07-17,1200609,202029,16933,16930,3
2020-07-17,1200450,202029,16933,16933,0
2020-07-17,1200500,202029,16941,16933,8
2020-07-17,1200427,202029,16941,16941,0
2020-07-17,1200336,202029,16941,16941,0
2020-07-17,1200013,202029,16941,16941,0
2020-07-17,1200344,202029,16941,16941,0
2020-07-17,1200385,202029,16942,16941,1
2020-07-17,1200302,202029,16969,16942,27
2020-07-17,1200252,202029,16969,16969,0
2020-07-17,1200203,202029,16977,16969,8
2020-07-17,1200179,202029,16978,16977,1
2020-07-17,1200138,202029,16978,16978,0
2020-07-17,1200807,202029,16980,16978,2
2020-07-17,1200104,202029,16980,16980,0
2020-07-17,1200054,202029,16980,16980,0
2020-07-17,1200393,202029,16980,16980,0
2020-07-17,1200328,202029,16980,16980,0
2020-07-18,1200393,202029,16980,16980,0
2020-07-18,1200401,202029,17058,16980,78
2020-07-18,1200427,202029,17058,17058,0
2020-07-18,1200435,202029,17061,17058,3
2020-07-18,1200807,202029,17063,17061,2
2020-07-18,1200450,202029,17080,17063,17
2020-07-18,1200609,202029,17093,17080,13
2020-07-18,1200708,202029,17101,17093,8
2020-07-18,1200344,202029,17102,17101,1
2020-07-18,1200500,202029,17111,17102,9
2020-07-18,1200385,202029,17114,17111,3
2020-07-18,1200336,202029,17142,17114,28
2020-07-18,1200351,202029,17154,17142,12
2020-07-18,1200302,202029,17165,17154,11
2020-07-18,1200328,202029,17165,17165,0
2020-07-18,1200252,202029,17174,17165,9
2020-07-18,1200203,202029,17185,17174,11
2020-07-18,1200179,202029,17195,17185,10
2020-07-18,1200138,202029,17196,17195,1
2020-07-18,1200104,202029,17202,17196,6
2020-07-18,1200054,202029,17207,17202,5
2020-07-18,1200013,202029,17217,17207,10
2020-07-19,1200385,202030,17218,17217,1
2020-07-19,1200336,202030,17218,17218,0
2020-07-19,1200351,202030,17218,17218,0
2020-07-19,1200344,202030,17218,17218,0
2020-07-19,1200500,202030,17231,17218,13
2020-07-19,1200302,202030,17238,17231,7
2020-07-19,1200252,202030,17246,17238,8
2020-07-19,1200203,202030,17252,17246,6
2020-07-19,1200807,202030,17259,17252,7
2020-07-19,1200328,202030,17259,17259,0
2020-07-19,1200393,202030,17259,17259,0
2020-07-19,1200401,202030,17280,17259,21
2020-07-19,1200427,202030,17280,17280,0
2020-07-19,1200179,202030,17280,17280,0
2020-07-19,1200138,202030,17282,17280,2
2020-07-19,1200013,202030,17282,17282,0
2020-07-19,1200054,202030,17289,17282,7
2020-07-19,1200104,202030,17305,17289,16
2020-07-19,1200609,202030,17306,17305,1
2020-07-19,1200708,202030,17306,17306,0
2020-07-19,1200435,202030,17306,17306,0
2020-07-19,1200450,202030,17310,17306,4
2020-07-20,1200351,202030,17310,17310,0
2020-07-20,1200708,202030,17310,17310,0
2020-07-20,1200609,202030,17314,17310,4
2020-07-20,1200450,202030,17314,17314,0
2020-07-20,1200435,202030,17314,17314,0
2020-07-20,1200807,202030,17314,17314,0
2020-07-20,1200385,202030,17315,17314,1
2020-07-20,1200013,202030,17315,17315,0
2020-07-20,1200336,202030,17318,17315,3
2020-07-20,1200344,202030,17318,17318,0
2020-07-20,1200500,202030,17316,17318,-2
2020-07-20,1200302,202030,17358,17316,42
2020-07-20,1200427,202030,17360,17358,2
2020-07-20,1200054,202030,17360,17360,0
2020-07-20,1200328,202030,17360,17360,0
2020-07-20,1200104,202030,17360,17360,0
2020-07-20,1200393,202030,17360,17360,0
2020-07-20,1200179,202030,17360,17360,0
2020-07-20,1200203,202030,17403,17360,43
2020-07-20,1200401,202030,17468,17403,65
2020-07-20,1200252,202030,17470,17468,2
2020-07-20,1200138,202030,17477,17470,7
2020-07-21,1200427,202030,17483,17477,6
2020-07-21,1200401,202030,17564,17483,81
2020-07-21,1200344,202030,17580,17564,16
2020-07-21,1200013,202030,17581,17580,1
2020-07-21,1200054,202030,17581,17581,0
2020-07-21,1200104,202030,17581,17581,0
2020-07-21,1200138,202030,17583,17581,2
2020-07-21,1200179,202030,17586,17583,3
2020-07-21,1200203,202030,17571,17586,-15
2020-07-21,1200252,202030,17578,17571,7
2020-07-21,1200328,202030,17579,17578,1
2020-07-21,1200302,202030,17590,17579,11
2020-07-21,1200351,202030,17597,17590,7
2020-07-21,1200393,202030,17623,17597,26
2020-07-21,1200500,202030,17655,17623,32
2020-07-21,1200450,202030,17655,17655,0
2020-07-21,1200609,202030,17693,17655,38
2020-07-21,1200435,202030,17693,17693,0
2020-07-21,1200807,202030,17694,17693,1
2020-07-21,1200385,202030,17698,17694,4
2020-07-21,1200336,202030,17706,17698,8
2020-07-21,1200708,202030,17715,17706,9
2020-07-22,1200435,202030,17718,17715,3
2020-07-22,1200427,202030,17721,17718,3
2020-07-22,1200054,202030,17738,17721,17
2020-07-22,1200807,202030,17739,17738,1
2020-07-22,1200138,202030,17742,17739,3
2020-07-22,1200708,202030,17747,17742,5
2020-07-22,1200609,202030,17768,17747,21
2020-07-22,1200450,202030,17770,17768,2
2020-07-22,1200500,202030,17789,17770,19
2020-07-22,1200401,202030,17848,17789,59
2020-07-22,1200104,202030,17864,17848,16
2020-07-22,1200393,202030,17864,17864,0
2020-07-22,1200179,202030,17866,17864,2
2020-07-22,1200385,202030,17866,17866,0
2020-07-22,1200336,202030,17885,17866,19
2020-07-22,1200351,202030,17887,17885,2
2020-07-22,1200344,202030,17893,17887,6
2020-07-22,1200328,202030,17894,17893,1
2020-07-22,1200302,202030,17900,17894,6
2020-07-22,1200013,202030,17900,17900,0
2020-07-22,1200252,202030,17903,17900,3
2020-07-22,1200203,202030,17994,17903,91
2020-07-23,1200328,202030,17994,17994,0
2020-07-23,1200252,202030,17996,17994,2
2020-07-23,1200203,202030,18049,17996,53
2020-07-23,1200179,202030,18051,18049,2
2020-07-23,1200351,202030,18052,18051,1
2020-07-23,1200054,202030,18055,18052,3
2020-07-23,1200013,202030,18055,18055,0
2020-07-23,1200344,202030,18062,18055,7
2020-07-23,1200138,202030,18064,18062,2
2020-07-23,1200385,202030,18067,18064,3
2020-07-23,1200104,202030,18071,18067,4
2020-07-23,1200807,202030,18072,18071,1
2020-07-23,1200393,202030,18080,18072,8
2020-07-23,1200427,202030,18080,18080,0
2020-07-23,1200435,202030,18081,18080,1
2020-07-23,1200500,202030,18096,18081,15
2020-07-23,1200450,202030,18104,18096,8
2020-07-23,1200609,202030,18138,18104,34
2020-07-23,1200708,202030,18145,18138,7
2020-07-23,1200401,202030,18164,18145,19
2020-07-23,1200302,202030,18167,18164,3
2020-07-23,1200336,202030,18172,18167,5
2020-07-24,1200807,202030,18172,18172,0
2020-07-24,1200393,202030,18187,18172,15
2020-07-24,1200401,202030,18210,18187,23
2020-07-24,1200427,202030,18210,18210,0
2020-07-24,1200708,202030,18227,18210,17
2020-07-24,1200500,202030,18242,18227,15
2020-07-24,1200450,202030,18251,18242,9
2020-07-24,1200609,202030,18289,18251,38
2020-07-24,1200104,202030,18334,18289,45
2020-07-24,1200435,202030,18335,18334,1
2020-07-24,1200351,202030,18338,18335,3
2020-07-24,1200013,202030,18343,18338,5
2020-07-24,1200179,202030,18343,18343,0
2020-07-24,1200344,202030,18352,18343,9
2020-07-24,1200054,202030,18363,18352,11
2020-07-24,1200138,202030,18367,18363,4
2020-07-24,1200385,202030,18368,18367,1
2020-07-24,1200203,202030,18375,18368,7
2020-07-24,1200302,202030,18376,18375,1
2020-07-24,1200328,202030,18380,18376,4
2020-07-24,1200252,202030,18398,18380,18
2020-07-24,1200336,202030,18408,18398,10
2020-07-25,1200427,202030,18408,18408,0
2020-07-25,1200393,202030,18422,18408,14
2020-07-25,1200401,202030,18496,18422,74
2020-07-25,1200435,202030,18499,18496,3
2020-07-25,1200807,202030,18507,18499,8
2020-07-25,1200450,202030,18507,18507,0
2020-07-25,1200708,202030,18512,18507,5
2020-07-25,1200203,202030,18534,18512,22
2020-07-25,1200385,202030,18537,18534,3
2020-07-25,1200500,202030,18561,18537,24
2020-07-25,1200336,202030,18562,18561,1
2020-07-25,1200351,202030,18564,18562,2
2020-07-25,1200344,202030,18572,18564,8
2020-07-25,1200054,202030,18576,18572,4
2020-07-25,1200104,202030,18605,18576,29
2020-07-25,1200138,202030,18609,18605,4
2020-07-25,1200179,202030,18613,18609,4
2020-07-25,1200013,202030,18613,18613,0
2020-07-25,1200252,202030,18613,18613,0
2020-07-25,1200302,202030,18640,18613,27
2020-07-25,1200328,202030,18646,18640,6
2020-07-25,1200609,202030,18672,18646,26
2020-07-26,1200328,202031,18672,18672,0
2020-07-26,1200351,202031,18672,18672,0
2020-07-26,1200013,202031,18672,18672,0
2020-07-26,1200104,202031,18672,18672,0
2020-07-26,1200138,202031,18672,18672,0
2020-07-26,1200179,202031,18672,18672,0
2020-07-26,1200203,202031,18676,18672,4
2020-07-26,1200252,202031,18676,18676,0
2020-07-26,1200302,202031,18692,18676,16
2020-07-26,1200344,202031,18692,18692,0
2020-07-26,1200427,202031,18692,18692,0
2020-07-26,1200500,202031,18692,18692,0
2020-07-26,1200385,202031,18692,18692,0
2020-07-26,1200807,202031,18694,18692,2
2020-07-26,1200393,202031,18694,18694,0
2020-07-26,1200401,202031,18754,18694,60
2020-07-26,1200435,202031,18754,18754,0
2020-07-26,1200450,202031,18754,18754,0
2020-07-26,1200609,202031,18760,18754,6
2020-07-26,1200708,202031,18760,18760,0
2020-07-26,1200054,202031,18760,18760,0
2020-07-26,1200336,202031,18760,18760,0
2020-07-27,1200807,202031,18760,18760,0
2020-07-27,1200393,202031,18760,18760,0
2020-07-27,1200401,202031,18782,18760,22
2020-07-27,1200427,202031,18782,18782,0
2020-07-27,1200385,202031,18783,18782,1
2020-07-27,1200500,202031,18783,18783,0
2020-07-27,1200450,202031,18784,18783,1
2020-07-27,1200609,202031,18785,18784,1
2020-07-27,1200708,202031,18785,18785,0
2020-07-27,1200435,202031,18786,18785,1
2020-07-27,1200336,202031,18786,18786,0
2020-07-27,1200179,202031,18787,18786,1
2020-07-27,1200351,202031,18787,18787,0
2020-07-27,1200054,202031,18788,18787,1
2020-07-27,1200104,202031,18788,18788,0
2020-07-27,1200138,202031,18794,18788,6
2020-07-27,1200013,202031,18795,18794,1
2020-07-27,1200203,202031,18796,18795,1
2020-07-27,1200252,202031,18796,18796,0
2020-07-27,1200302,202031,18798,18796,2
2020-07-27,1200328,202031,18798,18798,0
2020-07-27,1200344,202031,18798,18798,0
2020-07-28,1200393,202031,18798,18798,0
2020-07-28,1200252,202031,18823,18798,25
2020-07-28,1200609,202031,18857,18823,34
2020-07-28,1200336,202031,18859,18857,2
2020-07-28,1200385,202031,18862,18859,3
2020-07-28,1200344,202031,18875,18862,13
2020-07-28,1200328,202031,18875,18875,0
2020-07-28,1200302,202031,18875,18875,0
2020-07-28,1200401,202031,18907,18875,32
2020-07-28,1200351,202031,18912,18907,5
2020-07-28,1200427,202031,18913,18912,1
2020-07-28,1200435,202031,18913,18913,0
2020-07-28,1200500,202031,18934,18913,21
2020-07-28,1200013,202031,18951,18934,17
2020-07-28,1200054,202031,18975,18951,24
2020-07-28,1200104,202031,19023,18975,48
2020-07-28,1200138,202031,19025,19023,2
2020-07-28,1200708,202031,19039,19025,14
2020-07-28,1200203,202031,19069,19039,30
2020-07-28,1200807,202031,19136,19069,67
2020-07-28,1200450,202031,19147,19136,11
2020-07-28,1200179,202031,19147,19147,0
2020-07-29,1200336,202031,19181,19147,34
2020-07-29,1200138,202031,19186,19181,5
2020-07-29,1200179,202031,19187,19186,1
2020-07-29,1200203,202031,19238,19187,51
2020-07-29,1200252,202031,19247,19238,9
2020-07-29,1200302,202031,19252,19247,5
2020-07-29,1200328,202031,19252,19252,0
2020-07-29,1200344,202031,19256,19252,4
2020-07-29,1200351,202031,19258,19256,2
2020-07-29,1200385,202031,19258,19258,0
2020-07-29,1200609,202031,19290,19258,32
2020-07-29,1200393,202031,19306,19290,16
2020-07-29,1200054,202031,19312,19306,6
2020-07-29,1200013,202031,19311,19312,-1
2020-07-29,1200104,202031,19314,19311,3
2020-07-29,1200708,202031,19328,19314,14
2020-07-29,1200807,202031,19331,19328,3
2020-07-29,1200500,202031,19356,19331,25
2020-07-29,1200435,202031,19356,19356,0
2020-07-29,1200427,202031,19357,19356,1
2020-07-29,1200401,202031,19381,19357,24
2020-07-29,1200450,202031,19381,19381,0
2020-07-30,1200344,202031,19387,19381,6
2020-07-30,1200435,202031,19388,19387,1
2020-07-30,1200013,202031,19395,19388,7
2020-07-30,1200104,202031,19423,19395,28
2020-07-30,1200138,202031,19427,19423,4
2020-07-30,1200179,202031,19427,19427,0
2020-07-30,1200203,202031,19438,19427,11
2020-07-30,1200252,202031,19455,19438,17
2020-07-30,1200302,202031,19462,19455,7
2020-07-30,1200328,202031,19462,19462,0
2020-07-30,1200351,202031,19464,19462,2
2020-07-30,1200336,202031,19484,19464,20
2020-07-30,1200708,202031,19494,19484,10
2020-07-30,1200393,202031,19511,19494,17
2020-07-30,1200054,202031,19516,19511,5
2020-07-30,1200401,202031,19552,19516,36
2020-07-30,1200427,202031,19553,19552,1
2020-07-30,1200807,202031,19553,19553,0
2020-07-30,1200500,202031,19569,19553,16
2020-07-30,1200450,202031,19573,19569,4
2020-07-30,1200609,202031,19588,19573,15
2020-07-30,1200385,202031,19588,19588,0
2020-07-31,1200302,202031,19588,19588,0
2020-07-31,1200609,202031,19589,19588,1
2020-07-31,1200450,202031,19592,19589,3
2020-07-31,1200054,202031,19592,19592,0
2020-07-31,1200104,202031,19592,19592,0
2020-07-31,1200138,202031,19592,19592,0
2020-07-31,1200179,202031,19598,19592,6
2020-07-31,1200203,202031,19599,19598,1
2020-07-31,1200252,202031,19599,19599,0
2020-07-31,1200328,202031,19599,19599,0
2020-07-31,1200013,202031,19599,19599,0
2020-07-31,1200351,202031,19599,19599,0
2020-07-31,1200435,202031,19599,19599,0
2020-07-31,1200708,202031,19599,19599,0
2020-07-31,1200500,202031,19599,19599,0
2020-07-31,1200427,202031,19599,19599,0
2020-07-31,1200344,202031,19599,19599,0
2020-07-31,1200393,202031,19599,19599,0
2020-07-31,1200807,202031,19602,19599,3
2020-07-31,1200385,202031,19604,19602,2
2020-07-31,1200336,202031,19604,19604,0
2020-07-31,1200401,202031,19640,19604,36
2020-08-01,1200328,202031,19642,19640,2
2020-08-01,1200013,202031,19642,19642,0
2020-08-01,1200054,202031,19654,19642,12
2020-08-01,1200104,202031,19655,19654,1
2020-08-01,1200138,202031,19658,19655,3
2020-08-01,1200179,202031,19660,19658,2
2020-08-01,1200203,202031,19674,19660,14
2020-08-01,1200252,202031,19677,19674,3
2020-08-01,1200302,202031,19734,19677,57
2020-08-01,1200344,202031,19750,19734,16
2020-08-01,1200385,202031,19753,19750,3
2020-08-01,1200708,202031,19765,19753,12
2020-08-01,1200336,202031,19765,19765,0
2020-08-01,1200807,202031,19772,19765,7
2020-08-01,1200393,202031,19782,19772,10
2020-08-01,1200401,202031,19899,19782,117
2020-08-01,1200351,202031,19900,19899,1
2020-08-01,1200435,202031,19902,19900,2
2020-08-01,1200500,202031,19939,19902,37
2020-08-01,1200450,202031,19940,19939,1
2020-08-01,1200609,202031,19944,19940,4
2020-08-01,1200427,202031,19945,19944,1
2020-08-02,1200385,202032,19945,19945,0
2020-08-02,1200013,202032,19945,19945,0
2020-08-02,1200054,202032,19945,19945,0
2020-08-02,1200104,202032,19946,19945,1
2020-08-02,1200138,202032,19946,19946,0
2020-08-02,1200179,202032,19946,19946,0
2020-08-02,1200203,202032,19946,19946,0
2020-08-02,1200302,202032,19960,19946,14
2020-08-02,1200328,202032,19960,19960,0
2020-08-02,1200344,202032,19960,19960,0
2020-08-02,1200351,202032,19960,19960,0
2020-08-02,1200336,202032,19960,19960,0
2020-08-02,1200393,202032,19960,19960,0
2020-08-02,1200401,202032,19976,19960,16
2020-08-02,1200435,202032,19976,19976,0
2020-08-02,1200500,202032,19978,19976,2
2020-08-02,1200450,202032,19979,19978,1
2020-08-02,1200609,202032,19980,19979,1
2020-08-02,1200708,202032,19980,19980,0
2020-08-02,1200427,202032,19980,19980,0
2020-08-02,1200252,202032,19980,19980,0
2020-08-02,1200807,202032,19981,19980,1
2020-08-03,1200401,202032,20091,19981,110
2020-08-03,1200427,202032,20092,20091,1
2020-08-03,1200435,202032,20094,20092,2
2020-08-03,1200500,202032,20103,20094,9
2020-08-03,1200393,202032,20108,20103,5
2020-08-03,1200609,202032,20121,20108,13
2020-08-03,1200708,202032,20148,20121,27
2020-08-03,1200807,202032,20153,20148,5
2020-08-03,1200450,202032,20161,20153,8
2020-08-03,1200054,202032,20173,20161,12
2020-08-03,1200336,202032,20192,20173,19
2020-08-03,1200252,202032,20208,20192,16
2020-08-03,1200351,202032,20209,20208,1
2020-08-03,1200013,202032,20219,20209,10
2020-08-03,1200104,202032,20258,20219,39
2020-08-03,1200138,202032,20258,20258,0
2020-08-03,1200385,202032,20260,20258,2
2020-08-03,1200203,202032,20304,20260,44
2020-08-03,1200302,202032,20320,20304,16
2020-08-03,1200328,202032,20322,20320,2
2020-08-03,1200344,202032,20352,20322,30
2020-08-03,1200179,202032,20354,20352,2
2020-08-04,1200393,202032,20355,20354,1
2020-08-04,1200385,202032,20362,20355,7
2020-08-04,1200336,202032,20439,20362,77
2020-08-04,1200351,202032,20442,20439,3
2020-08-04,1200435,202032,20443,20442,1
2020-08-04,1200328,202032,20443,20443,0
2020-08-04,1200807,202032,20451,20443,8
2020-08-04,1200609,202032,20473,20451,22
2020-08-04,1200252,202032,20473,20473,0
2020-08-04,1200344,202032,20484,20473,11
2020-08-04,1200401,202032,20583,20484,99
2020-08-04,1200302,202032,20605,20583,22
2020-08-04,1200500,202032,20630,20605,25
2020-08-04,1200450,202032,20635,20630,5
2020-08-04,1200203,202032,20681,20635,46
2020-08-04,1200179,202032,20692,20681,11
2020-08-04,1200138,202032,20696,20692,4
2020-08-04,1200104,202032,20698,20696,2
2020-08-04,1200054,202032,20707,20698,9
2020-08-04,1200013,202032,20713,20707,6
2020-08-04,1200708,202032,20725,20713,12
2020-08-04,1200427,202032,20725,20725,0
2020-08-05,1200427,202032,20728,20725,3
2020-08-05,1200500,202032,20737,20728,9
2020-08-05,1200435,202032,20737,20737,0
2020-08-05,1200203,202032,20756,20737,19
2020-08-05,1200385,202032,20761,20756,5
2020-08-05,1200609,202032,20788,20761,27
2020-08-05,1200708,202032,20812,20788,24
2020-08-05,1200138,202032,20815,20812,3
2020-08-05,1200401,202032,20925,20815,110
2020-08-05,1200450,202032,20927,20925,2
2020-08-05,1200393,202032,20927,20927,0
2020-08-05,1200344,202032,20934,20927,7
2020-08-05,1200013,202032,20934,20934,0
2020-08-05,1200807,202032,20937,20934,3
2020-08-05,1200104,202032,20955,20937,18
2020-08-05,1200179,202032,20955,20955,0
2020-08-05,1200252,202032,20973,20955,18
2020-08-05,1200054,202032,20994,20973,21
2020-08-05,1200328,202032,20999,20994,5
2020-08-05,1200351,202032,21005,20999,6
2020-08-05,1200336,202032,21021,21005,16
2020-08-05,1200302,202032,21048,21021,27
2020-08-06,1200708,202032,21085,21048,37
2020-08-06,1200393,202032,21085,21085,0
2020-08-06,1200609,202032,21088,21085,3
2020-08-06,1200450,202032,21092,21088,4
2020-08-06,1200500,202032,21117,21092,25
2020-08-06,1200435,202032,21117,21117,0
2020-08-06,1200427,202032,21117,21117,0
2020-08-06,1200401,202032,21154,21117,37
2020-08-06,1200807,202032,21161,21154,7
2020-08-06,1200385,202032,21163,21161,2
2020-08-06,1200302,202032,21202,21163,39
2020-08-06,1200344,202032,21211,21202,9
2020-08-06,1200328,202032,21211,21211,0
2020-08-06,1200336,202032,21212,21211,1
2020-08-06,1200203,202032,21227,21212,15
2020-08-06,1200179,202032,21230,21227,3
2020-08-06,1200138,202032,21231,21230,1
2020-08-06,1200104,202032,21250,21231,19
2020-08-06,1200054,202032,21263,21250,13
2020-08-06,1200013,202032,21269,21263,6
2020-08-06,1200351,202032,21269,21269,0
2020-08-06,1200252,202032,21278,21269,9
2020-08-07,1200401,202032,21338,21278,60
2020-08-07,1200393,202032,21338,21338,0
2020-08-07,1200427,202032,21339,21338,1
2020-08-07,1200435,202032,21339,21339,0
2020-08-07,1200252,202032,21339,21339,0
2020-08-07,1200609,202032,21360,21339,21
2020-08-07,1200302,202032,21368,21360,8
2020-08-07,1200807,202032,21368,21368,0
2020-08-07,1200500,202032,21371,21368,3
2020-08-07,1200385,202032,21372,21371,1
2020-08-07,1200450,202032,21372,21372,0
2020-08-07,1200351,202032,21375,21372,3
2020-08-07,1200054,202032,21375,21375,0
2020-08-07,1200104,202032,21375,21375,0
2020-08-07,1200336,202032,21382,21375,7
2020-08-07,1200138,202032,21383,21382,1
2020-08-07,1200013,202032,21383,21383,0
2020-08-07,1200203,202032,21371,21383,-12
2020-08-07,1200708,202032,21381,21371,10
2020-08-07,1200328,202032,21390,21381,9
2020-08-07,1200344,202032,21390,21390,0
2020-08-07,1200179,202032,21391,21390,1
2020-08-08,1200328,202032,21391,21391,0
2020-08-08,1200344,202032,21391,21391,0
2020-08-08,1200013,202032,21391,21391,0
2020-08-08,1200054,202032,21391,21391,0
2020-08-08,1200104,202032,21391,21391,0
2020-08-08,1200138,202032,21393,21391,2
2020-08-08,1200179,202032,21393,21393,0
2020-08-08,1200203,202032,21396,21393,3
2020-08-08,1200252,202032,21397,21396,1
2020-08-08,1200302,202032,21425,21397,28
2020-08-08,1200336,202032,21447,21425,22
2020-08-08,1200351,202032,21448,21447,1
2020-08-08,1200385,202032,21449,21448,1
2020-08-08,1200393,202032,21449,21449,0
2020-08-08,1200708,202032,21450,21449,1
2020-08-08,1200609,202032,21450,21450,0
2020-08-08,1200450,202032,21453,21450,3
2020-08-08,1200435,202032,21453,21453,0
2020-08-08,1200427,202032,21457,21453,4
2020-08-08,1200401,202032,21505,21457,48
2020-08-08,1200807,202032,21507,21505,2
2020-08-08,1200500,202032,21513,21507,6
2020-08-09,1200385,202033,21514,21513,1
2020-08-09,1200609,202033,21514,21514,0
2020-08-09,1200450,202033,21518,21514,4
2020-08-09,1200708,202033,21532,21518,14
2020-08-09,1200435,202033,21532,21532,0
2020-08-09,1200427,202033,21532,21532,0
2020-08-09,1200401,202033,21548,21532,16
2020-08-09,1200393,202033,21548,21548,0
2020-08-09,1200807,202033,21549,21548,1
2020-08-09,1200344,202033,21549,21549,0
2020-08-09,1200500,202033,21550,21549,1
2020-08-09,1200138,202033,21555,21550,5
2020-08-09,1200328,202033,21555,21555,0
2020-08-09,1200013,202033,21560,21555,5
2020-08-09,1200054,202033,21563,21560,3
2020-08-09,1200104,202033,21589,21563,26
2020-08-09,1200351,202033,21589,21589,0
2020-08-09,1200179,202033,21591,21589,2
2020-08-09,1200252,202033,21597,21591,6
2020-08-09,1200302,202033,21601,21597,4
2020-08-09,1200203,202033,21602,21601,1
2020-08-09,1200336,202033,21602,21602,0
2020-08-10,1200807,202033,21602,21602,0
2020-08-10,1200393,202033,21602,21602,0
2020-08-10,1200401,202033,21611,21602,9
2020-08-10,1200427,202033,21611,21611,0
2020-08-10,1200203,202033,21617,21611,6
2020-08-10,1200450,202033,21617,21617,0
2020-08-10,1200708,202033,21617,21617,0
2020-08-10,1200385,202033,21617,21617,0
2020-08-10,1200435,202033,21617,21617,0
2020-08-10,1200336,202033,21618,21617,1
2020-08-10,1200500,202033,21621,21618,3
2020-08-10,1200344,202033,21621,21621,0
2020-08-10,1200328,202033,21628,21621,7
2020-08-10,1200302,202033,21630,21628,2
2020-08-10,1200252,202033,21630,21630,0
2020-08-10,1200609,202033,21630,21630,0
2020-08-10,1200179,202033,21630,21630,0
2020-08-10,1200138,202033,21631,21630,1
2020-08-10,1200104,202033,21634,21631,3
2020-08-10,1200054,202033,21634,21634,0
2020-08-10,1200013,202033,21634,21634,0
2020-08-10,1200351,202033,21634,21634,0
2020-08-11,1200302,202033,21648,21634,14
2020-08-11,1200252,202033,21650,21648,2
2020-08-11,1200203,202033,21651,21650,1
2020-08-11,1200179,202033,21651,21651,0
2020-08-11,1200344,202033,21661,21651,10
2020-08-11,1200104,202033,21670,21661,9
2020-08-11,1200054,202033,21676,21670,6
2020-08-11,1200013,202033,21680,21676,4
2020-08-11,1200328,202033,21680,21680,0
2020-08-11,1200138,202033,21684,21680,4
2020-08-11,1200385,202033,21687,21684,3
2020-08-11,1200401,202033,21708,21687,21
2020-08-11,1200807,202033,21708,21708,0
2020-08-11,1200393,202033,21708,21708,0
2020-08-11,1200435,202033,21711,21708,3
2020-08-11,1200500,202033,21741,21711,30
2020-08-11,1200450,202033,21745,21741,4
2020-08-11,1200609,202033,21746,21745,1
2020-08-11,1200708,202033,21766,21746,20
2020-08-11,1200427,202033,21767,21766,1
2020-08-11,1200336,202033,21768,21767,1
2020-08-11,1200351,202033,21772,21768,4
2020-08-12,1200393,202033,21776,21772,4
2020-08-12,1200252,202033,21787,21776,11
2020-08-12,1200807,202033,21789,21787,2
2020-08-12,1200401,202033,21815,21789,26
2020-08-12,1200336,202033,21818,21815,3
2020-08-12,1200435,202033,21822,21818,4
2020-08-12,1200500,202033,21844,21822,22
2020-08-12,1200450,202033,21852,21844,8
2020-08-12,1200609,202033,21865,21852,13
2020-08-12,1200427,202033,21865,21865,0
2020-08-12,1200708,202033,21881,21865,16
2020-08-12,1200138,202033,21882,21881,1
2020-08-12,1200013,202033,21906,21882,24
2020-08-12,1200203,202033,21956,21906,50
2020-08-12,1200344,202033,21963,21956,7
2020-08-12,1200328,202033,21970,21963,7
2020-08-12,1200302,202033,21982,21970,12
2020-08-12,1200351,202033,21985,21982,3
2020-08-12,1200385,202033,21984,21985,-1
2020-08-12,1200104,202033,21988,21984,4
2020-08-12,1200054,202033,22007,21988,19
2020-08-12,1200179,202033,22008,22007,1
2020-08-13,1200385,202033,22009,22008,1
2020-08-13,1200302,202033,22051,22009,42
2020-08-13,1200328,202033,22059,22051,8
2020-08-13,1200344,202033,22069,22059,10
2020-08-13,1200351,202033,22069,22069,0
2020-08-13,1200336,202033,22092,22069,23
2020-08-13,1200609,202033,22120,22092,28
2020-08-13,1200393,202033,22123,22120,3
2020-08-13,1200401,202033,22139,22123,16
2020-08-13,1200427,202033,22139,22139,0
2020-08-13,1200252,202033,22142,22139,3
2020-08-13,1200500,202033,22172,22142,30
2020-08-13,1200435,202033,22173,22172,1
2020-08-13,1200013,202033,22204,22173,31
2020-08-13,1200054,202033,22213,22204,9
2020-08-13,1200104,202033,22216,22213,3
2020-08-13,1200138,202033,22218,22216,2
2020-08-13,1200708,202033,22240,22218,22
2020-08-13,1200203,202033,22253,22240,13
2020-08-13,1200807,202033,22253,22253,0
2020-08-13,1200450,202033,22257,22253,4
2020-08-13,1200179,202033,22257,22257,0
2020-08-14,1200336,202033,22265,22257,8
2020-08-14,1200609,202033,22270,22265,5
2020-08-14,1200138,202033,22272,22270,2
2020-08-14,1200179,202033,22275,22272,3
2020-08-14,1200203,202033,22292,22275,17
2020-08-14,1200252,202033,22298,22292,6
2020-08-14,1200302,202033,22307,22298,9
2020-08-14,1200328,202033,22310,22307,3
2020-08-14,1200344,202033,22313,22310,3
2020-08-14,1200351,202033,22316,22313,3
2020-08-14,1200385,202033,22317,22316,1
2020-08-14,1200708,202033,22347,22317,30
2020-08-14,1200393,202033,22348,22347,1
2020-08-14,1200401,202033,22379,22348,31
2020-08-14,1200427,202033,22379,22379,0
2020-08-14,1200435,202033,22379,22379,0
2020-08-14,1200500,202033,22400,22379,21
2020-08-14,1200450,202033,22404,22400,4
2020-08-14,1200104,202033,22423,22404,19
2020-08-14,1200013,202033,22431,22423,8
2020-08-14,1200054,202033,22445,22431,14
2020-08-14,1200807,202033,22450,22445,5
2020-08-15,1200328,202033,22450,22450,0
2020-08-15,1200302,202033,22454,22450,4
2020-08-15,1200252,202033,22454,22454,0
2020-08-15,1200203,202033,22457,22454,3
2020-08-15,1200435,202033,22460,22457,3
2020-08-15,1200138,202033,22460,22460,0
2020-08-15,1200104,202033,22461,22460,1
2020-08-15,1200013,202033,22463,22461,2
2020-08-15,1200344,202033,22463,22463,0
2020-08-15,1200179,202033,22466,22463,3
2020-08-15,1200351,202033,22466,22466,0
2020-08-15,1200401,202033,22491,22466,25
2020-08-15,1200708,202033,22500,22491,9
2020-08-15,1200393,202033,22500,22500,0
2020-08-15,1200054,202033,22505,22500,5
2020-08-15,1200427,202033,22505,22505,0
2020-08-15,1200807,202033,22506,22505,1
2020-08-15,1200500,202033,22518,22506,12
2020-08-15,1200450,202033,22520,22518,2
2020-08-15,1200609,202033,22524,22520,4
2020-08-15,1200385,202033,22527,22524,3
2020-08-15,1200336,202033,22531,22527,4
2020-08-16,1200013,202034,22531,22531,0
2020-08-16,1200302,202034,22557,22531,26
2020-08-16,1200609,202034,22557,22557,0
2020-08-16,1200450,202034,22556,22557,-1
2020-08-16,1200054,202034,22555,22556,-1
2020-08-16,1200104,202034,22555,22555,0
2020-08-16,1200138,202034,22556,22555,1
2020-08-16,1200179,202034,22556,22556,0
2020-08-16,1200203,202034,22557,22556,1
2020-08-16,1200252,202034,22557,22557,0
2020-08-16,1200328,202034,22557,22557,0
2020-08-16,1200351,202034,22557,22557,0
2020-08-16,1200336,202034,22557,22557,0
2020-08-16,1200385,202034,22557,22557,0
2020-08-16,1200807,202034,22557,22557,0
2020-08-16,1200393,202034,22557,22557,0
2020-08-16,1200401,202034,22563,22557,6
2020-08-16,1200427,202034,22563,22563,0
2020-08-16,1200500,202034,22563,22563,0
2020-08-16,1200708,202034,22563,22563,0
2020-08-16,1200435,202034,22563,22563,0
2020-08-16,1200344,202034,22563,22563,0
2020-08-17,1200302,202034,22572,22563,9
2020-08-17,1200252,202034,22584,22572,12
2020-08-17,1200203,202034,22584,22584,0
2020-08-17,1200179,202034,22584,22584,0
2020-08-17,1200328,202034,22584,22584,0
2020-08-17,1200104,202034,22590,22584,6
2020-08-17,1200054,202034,22591,22590,1
2020-08-17,1200013,202034,22596,22591,5
2020-08-17,1200385,202034,22596,22596,0
2020-08-17,1200138,202034,22596,22596,0
2020-08-17,1200344,202034,22596,22596,0
2020-08-17,1200393,202034,22596,22596,0
2020-08-17,1200708,202034,22603,22596,7
2020-08-17,1200336,202034,22603,22603,0
2020-08-17,1200807,202034,22603,22603,0
2020-08-17,1200401,202034,22614,22603,11
2020-08-17,1200427,202034,22614,22614,0
2020-08-17,1200351,202034,22615,22614,1
2020-08-17,1200500,202034,22620,22615,5
2020-08-17,1200450,202034,22620,22620,0
2020-08-17,1200609,202034,22620,22620,0
2020-08-17,1200435,202034,22620,22620,0
2020-08-18,1200344,202034,22622,22620,2
2020-08-18,1200013,202034,22642,22622,20
2020-08-18,1200054,202034,22643,22642,1
2020-08-18,1200104,202034,22736,22643,93
2020-08-18,1200138,202034,22737,22736,1
2020-08-18,1200179,202034,22738,22737,1
2020-08-18,1200203,202034,22757,22738,19
2020-08-18,1200302,202034,22763,22757,6
2020-08-18,1200328,202034,22767,22763,4
2020-08-18,1200351,202034,22770,22767,3
2020-08-18,1200252,202034,22785,22770,15
2020-08-18,1200385,202034,22785,22785,0
2020-08-18,1200393,202034,22785,22785,0
2020-08-18,1200401,202034,22815,22785,30
2020-08-18,1200435,202034,22817,22815,2
2020-08-18,1200500,202034,22834,22817,17
2020-08-18,1200450,202034,22836,22834,2
2020-08-18,1200609,202034,22921,22836,85
2020-08-18,1200708,202034,22948,22921,27
2020-08-18,1200427,202034,22948,22948,0
2020-08-18,1200336,202034,22948,22948,0
2020-08-18,1200807,202034,22948,22948,0
2020-08-19,1200252,202034,22948,22948,0
2020-08-19,1200393,202034,22948,22948,0
2020-08-19,1200401,202034,22957,22948,9
2020-08-19,1200427,202034,22959,22957,2
2020-08-19,1200336,202034,22959,22959,0
2020-08-19,1200500,202034,22972,22959,13
2020-08-19,1200450,202034,22975,22972,3
2020-08-19,1200609,202034,23023,22975,48
2020-08-19,1200708,202034,23045,23023,22
2020-08-19,1200435,202034,23046,23045,1
2020-08-19,1200807,202034,23056,23046,10
2020-08-19,1200138,202034,23058,23056,2
2020-08-19,1200013,202034,23058,23058,0
2020-08-19,1200203,202034,23120,23058,62
2020-08-19,1200344,202034,23122,23120,2
2020-08-19,1200328,202034,23122,23122,0
2020-08-19,1200302,202034,23130,23122,8
2020-08-19,1200351,202034,23133,23130,3
2020-08-19,1200385,202034,23134,23133,1
2020-08-19,1200104,202034,23156,23134,22
2020-08-19,1200054,202034,23161,23156,5
2020-08-19,1200179,202034,23161,23161,0
2020-08-20,1200609,202034,23163,23161,2
2020-08-20,1200427,202034,23164,23163,1
2020-08-20,1200328,202034,23173,23164,9
2020-08-20,1200344,202034,23174,23173,1
2020-08-20,1200351,202034,23180,23174,6
2020-08-20,1200336,202034,23181,23180,1
2020-08-20,1200385,202034,23183,23181,2
2020-08-20,1200393,202034,23184,23183,1
2020-08-20,1200252,202034,23191,23184,7
2020-08-20,1200401,202034,23213,23191,22
2020-08-20,1200807,202034,23215,23213,2
2020-08-20,1200435,202034,23217,23215,2
2020-08-20,1200450,202034,23227,23217,10
2020-08-20,1200302,202034,23259,23227,32
2020-08-20,1200203,202034,23267,23259,8
2020-08-20,1200179,202034,23270,23267,3
2020-08-20,1200138,202034,23270,23270,0
2020-08-20,1200104,202034,23277,23270,7
2020-08-20,1200054,202034,23286,23277,9
2020-08-20,1200013,202034,23291,23286,5
2020-08-20,1200708,202034,23317,23291,26
2020-08-20,1200500,202034,23337,23317,20
2020-08-21,1200351,202034,23337,23337,0
2020-08-21,1200393,202034,23337,23337,0
2020-08-21,1200328,202034,23337,23337,0
2020-08-21,1200302,202034,23337,23337,0
2020-08-21,1200336,202034,23337,23337,0
2020-08-21,1200203,202034,23341,23337,4
2020-08-21,1200179,202034,23341,23341,0
2020-08-21,1200401,202034,23349,23341,8
2020-08-21,1200252,202034,23350,23349,1
2020-08-21,1200807,202034,23350,23350,0
2020-08-21,1200344,202034,23350,23350,0
2020-08-21,1200385,202034,23350,23350,0
2020-08-21,1200013,202034,23350,23350,0
2020-08-21,1200054,202034,23350,23350,0
2020-08-21,1200104,202034,23350,23350,0
2020-08-21,1200435,202034,23350,23350,0
2020-08-21,1200708,202034,23350,23350,0
2020-08-21,1200138,202034,23350,23350,0
2020-08-21,1200500,202034,23352,23350,2
2020-08-21,1200450,202034,23352,23352,0
2020-08-21,1200609,202034,23352,23352,0
2020-08-21,1200427,202034,23352,23352,0
2020-08-22,1200013,202034,23352,23352,0
2020-08-22,1200450,202034,23356,23352,4
2020-08-22,1200401,202034,23433,23356,77
2020-08-22,1200435,202034,23484,23433,51
2020-08-22,1200708,202034,23543,23484,59
2020-08-22,1200427,202034,23543,23543,0
2020-08-22,1200609,202034,23547,23543,4
2020-08-22,1200500,202034,23568,23547,21
2020-08-22,1200336,202034,23589,23568,21
2020-08-22,1200351,202034,23601,23589,12
2020-08-22,1200344,202034,23604,23601,3
2020-08-22,1200328,202034,23604,23604,0
2020-08-22,1200302,202034,23606,23604,2
2020-08-22,1200252,202034,23606,23606,0
2020-08-22,1200203,202034,23617,23606,11
2020-08-22,1200179,202034,23617,23617,0
2020-08-22,1200138,202034,23624,23617,7
2020-08-22,1200807,202034,23643,23624,19
2020-08-22,1200104,202034,23658,23643,15
2020-08-22,1200054,202034,23675,23658,17
2020-08-22,1200393,202034,23678,23675,3
2020-08-22,1200385,202034,23680,23678,2
2020-08-23,1200401,202035,23687,23680,7
2020-08-23,1200427,202035,23687,23687,0
2020-08-23,1200435,202035,23687,23687,0
2020-08-23,1200500,202035,23689,23687,2
2020-08-23,1200344,202035,23689,23689,0
2020-08-23,1200609,202035,23689,23689,0
2020-08-23,1200708,202035,23691,23689,2
2020-08-23,1200351,202035,23691,23691,0
2020-08-23,1200393,202035,23691,23691,0
2020-08-23,1200450,202035,23694,23691,3
2020-08-23,1200807,202035,23694,23694,0
2020-08-23,1200385,202035,23694,23694,0
2020-08-23,1200336,202035,23694,23694,0
2020-08-23,1200302,202035,23708,23694,14
2020-08-23,1200328,202035,23708,23708,0
2020-08-23,1200252,202035,23714,23708,6
2020-08-23,1200203,202035,23714,23714,0
2020-08-23,1200179,202035,23714,23714,0
2020-08-23,1200138,202035,23714,23714,0
2020-08-23,1200104,202035,23728,23714,14
2020-08-23,1200054,202035,23729,23728,1
2020-08-23,1200013,202035,23734,23729,5
2020-08-24,1200385,202035,23734,23734,0
2020-08-24,1200351,202035,23735,23734,1
2020-08-24,1200344,202035,23735,23735,0
2020-08-24,1200328,202035,23735,23735,0
2020-08-24,1200609,202035,23735,23735,0
2020-08-24,1200252,202035,23735,23735,0
2020-08-24,1200203,202035,23735,23735,0
2020-08-24,1200336,202035,23737,23735,2
2020-08-24,1200450,202035,23737,23737,0
2020-08-24,1200302,202035,23737,23737,0
2020-08-24,1200708,202035,23737,23737,0
2020-08-24,1200393,202035,23737,23737,0
2020-08-24,1200401,202035,23741,23737,4
2020-08-24,1200138,202035,23741,23741,0
2020-08-24,1200104,202035,23740,23741,-1
2020-08-24,1200013,202035,23740,23740,0
2020-08-24,1200054,202035,23740,23740,0
2020-08-24,1200179,202035,23740,23740,0
2020-08-24,1200500,202035,23745,23740,5
2020-08-24,1200435,202035,23744,23745,-1
2020-08-24,1200427,202035,23744,23744,0
2020-08-24,1200807,202035,23744,23744,0
2020-08-25,1200336,202035,23801,23744,57
2020-08-25,1200351,202035,23808,23801,7
2020-08-25,1200138,202035,23808,23808,0
2020-08-25,1200179,202035,23810,23808,2
2020-08-25,1200203,202035,23815,23810,5
2020-08-25,1200252,202035,23825,23815,10
2020-08-25,1200302,202035,23833,23825,8
2020-08-25,1200328,202035,23833,23833,0
2020-08-25,1200344,202035,23838,23833,5
2020-08-25,1200054,202035,23846,23838,8
2020-08-25,1200500,202035,23864,23846,18
2020-08-25,1200807,202035,23864,23864,0
2020-08-25,1200427,202035,23865,23864,1
2020-08-25,1200401,202035,23888,23865,23
2020-08-25,1200013,202035,23900,23888,12
2020-08-25,1200104,202035,23902,23900,2
2020-08-25,1200385,202035,23905,23902,3
2020-08-25,1200393,202035,23905,23905,0
2020-08-25,1200450,202035,23912,23905,7
2020-08-25,1200609,202035,23913,23912,1
2020-08-25,1200708,202035,23950,23913,37
2020-08-25,1200435,202035,23951,23950,1
2020-08-26,1200328,202035,23965,23951,14
2020-08-26,1200344,202035,23967,23965,2
2020-08-26,1200013,202035,23969,23967,2
2020-08-26,1200054,202035,23976,23969,7
2020-08-26,1200104,202035,23980,23976,4
2020-08-26,1200138,202035,23980,23980,0
2020-08-26,1200179,202035,23980,23980,0
2020-08-26,1200203,202035,23992,23980,12
2020-08-26,1200252,202035,23995,23992,3
2020-08-26,1200302,202035,24008,23995,13
2020-08-26,1200336,202035,24008,24008,0
2020-08-26,1200351,202035,24015,24008,7
2020-08-26,1200807,202035,24016,24015,1
2020-08-26,1200401,202035,24052,24016,36
2020-08-26,1200708,202035,24078,24052,26
2020-08-26,1200609,202035,24089,24078,11
2020-08-26,1200450,202035,24103,24089,14
2020-08-26,1200385,202035,24104,24103,1
2020-08-26,1200435,202035,24116,24104,12
2020-08-26,1200427,202035,24116,24116,0
2020-08-26,1200393,202035,24116,24116,0
2020-08-26,1200500,202035,24134,24116,18
2020-08-27,1200302,202035,24158,24134,24
2020-08-27,1200609,202035,24169,24158,11
2020-08-27,1200450,202035,24184,24169,15
2020-08-27,1200500,202035,24193,24184,9
2020-08-27,1200435,202035,24199,24193,6
2020-08-27,1200427,202035,24199,24199,0
2020-08-27,1200401,202035,24220,24199,21
2020-08-27,1200393,202035,24220,24220,0
2020-08-27,1200807,202035,24221,24220,1
2020-08-27,1200351,202035,24224,24221,3
2020-08-27,1200708,202035,24246,24224,22
2020-08-27,1200138,202035,24246,24246,0
2020-08-27,1200203,202035,24264,24246,18
2020-08-27,1200328,202035,24266,24264,2
2020-08-27,1200252,202035,24266,24266,0
2020-08-27,1200179,202035,24267,24266,1
2020-08-27,1200336,202035,24274,24267,7
2020-08-27,1200104,202035,24277,24274,3
2020-08-27,1200054,202035,24280,24277,3
2020-08-27,1200013,202035,24283,24280,3
2020-08-27,1200344,202035,24283,24283,0
2020-08-27,1200385,202035,24284,24283,1
2020-08-28,1200385,202035,24284,24284,0
2020-08-28,1200708,202035,24306,24284,22
2020-08-28,1200450,202035,24313,24306,7
2020-08-28,1200500,202035,24321,24313,8
2020-08-28,1200435,202035,24322,24321,1
2020-08-28,1200427,202035,24322,24322,0
2020-08-28,1200401,202035,24363,24322,41
2020-08-28,1200393,202035,24367,24363,4
2020-08-28,1200807,202035,24367,24367,0
2020-08-28,1200336,202035,24391,24367,24
2020-08-28,1200203,202035,24427,24391,36
2020-08-28,1200344,202035,24429,24427,2
2020-08-28,1200013,202035,24431,24429,2
2020-08-28,1200054,202035,24435,24431,4
2020-08-28,1200104,202035,24443,24435,8
2020-08-28,1200138,202035,24445,24443,2
2020-08-28,1200351,202035,24452,24445,7
2020-08-28,1200609,202035,24453,24452,1
2020-08-28,1200252,202035,24455,24453,2
2020-08-28,1200302,202035,24465,24455,10
2020-08-28,1200328,202035,24477,24465,12
2020-08-28,1200179,202035,24477,24477,0
2020-08-29,1200385,202035,24478,24477,1
2020-08-29,1200013,202035,24479,24478,1
2020-08-29,1200054,202035,24488,24479,9
2020-08-29,1200104,202035,24488,24488,0
2020-08-29,1200138,202035,24490,24488,2
2020-08-29,1200179,202035,24490,24490,0
2020-08-29,1200203,202035,24505,24490,15
2020-08-29,1200302,202035,24517,24505,12
2020-08-29,1200328,202035,24516,24517,-1
2020-08-29,1200344,202035,24517,24516,1
2020-08-29,1200351,202035,24519,24517,2
2020-08-29,1200336,202035,24519,24519,0
2020-08-29,1200393,202035,24529,24519,10
2020-08-29,1200401,202035,24563,24529,34
2020-08-29,1200435,202035,24563,24563,0
2020-08-29,1200500,202035,24581,24563,18
2020-08-29,1200450,202035,24581,24581,0
2020-08-29,1200609,202035,24597,24581,16
2020-08-29,1200708,202035,24613,24597,16
2020-08-29,1200427,202035,24614,24613,1
2020-08-29,1200252,202035,24616,24614,2
2020-08-29,1200807,202035,24616,24616,0
2020-08-30,1200054,202036,24616,24616,0
2020-08-30,1200807,202036,24617,24616,1
2020-08-30,1200393,202036,24617,24617,0
2020-08-30,1200401,202036,24626,24617,9
2020-08-30,1200609,202036,24626,24626,0
2020-08-30,1200435,202036,24626,24626,0
2020-08-30,1200500,202036,24626,24626,0
2020-08-30,1200450,202036,24626,24626,0
2020-08-30,1200708,202036,24626,24626,0
2020-08-30,1200427,202036,24626,24626,0
2020-08-30,1200336,202036,24626,24626,0
2020-08-30,1200179,202036,24626,24626,0
2020-08-30,1200013,202036,24626,24626,0
2020-08-30,1200252,202036,24626,24626,0
2020-08-30,1200344,202036,24626,24626,0
2020-08-30,1200328,202036,24626,24626,0
2020-08-30,1200302,202036,24649,24626,23
2020-08-30,1200351,202036,24649,24649,0
2020-08-30,1200385,202036,24649,24649,0
2020-08-30,1200138,202036,24649,24649,0
2020-08-30,1200104,202036,24653,24649,4
2020-08-30,1200203,202036,24653,24653,0
2020-08-31,1200385,202036,24655,24653,2
2020-08-31,1200302,202036,24653,24655,-2
2020-08-31,1200328,202036,24653,24653,0
2020-08-31,1200344,202036,24653,24653,0
2020-08-31,1200351,202036,24653,24653,0
2020-08-31,1200336,202036,24653,24653,0
2020-08-31,1200609,202036,24653,24653,0
2020-08-31,1200393,202036,24653,24653,0
2020-08-31,1200401,202036,24657,24653,4
2020-08-31,1200427,202036,24657,24657,0
2020-08-31,1200252,202036,24657,24657,0
2020-08-31,1200500,202036,24659,24657,2
2020-08-31,1200435,202036,24659,24659,0
2020-08-31,1200013,202036,24659,24659,0
2020-08-31,1200054,202036,24659,24659,0
2020-08-31,1200104,202036,24659,24659,0
2020-08-31,1200138,202036,24659,24659,0
2020-08-31,1200708,202036,24662,24659,3
2020-08-31,1200203,202036,24662,24662,0
2020-08-31,1200807,202036,24662,24662,0
2020-08-31,1200450,202036,24662,24662,0
2020-08-31,1200179,202036,24662,24662,0
2020-09-01,1200336,202036,24680,24662,18
2020-09-01,1200609,202036,24717,24680,37
2020-09-01,1200138,202036,24718,24717,1
2020-09-01,1200179,202036,24719,24718,1
2020-09-01,1200203,202036,24735,24719,16
2020-09-01,1200252,202036,24735,24735,0
2020-09-01,1200302,202036,24747,24735,12
2020-09-01,1200328,202036,24750,24747,3
2020-09-01,1200344,202036,24753,24750,3
2020-09-01,1200351,202036,24757,24753,4
2020-09-01,1200385,202036,24757,24757,0
2020-09-01,1200708,202036,24783,24757,26
2020-09-01,1200393,202036,24788,24783,5
2020-09-01,1200401,202036,24820,24788,32
2020-09-01,1200427,202036,24822,24820,2
2020-09-01,1200435,202036,24822,24822,0
2020-09-01,1200500,202036,24838,24822,16
2020-09-01,1200450,202036,24852,24838,14
2020-09-01,1200104,202036,24854,24852,2
2020-09-01,1200013,202036,24854,24854,0
2020-09-01,1200054,202036,24855,24854,1
2020-09-01,1200807,202036,24855,24855,0
2020-09-02,1200328,202036,24855,24855,0
2020-09-02,1200302,202036,24855,24855,0
2020-09-02,1200252,202036,24855,24855,0
2020-09-02,1200203,202036,24855,24855,0
2020-09-02,1200435,202036,24855,24855,0
2020-09-02,1200138,202036,24855,24855,0
2020-09-02,1200104,202036,24855,24855,0
2020-09-02,1200013,202036,24855,24855,0
2020-09-02,1200344,202036,24855,24855,0
2020-09-02,1200179,202036,24855,24855,0
2020-09-02,1200351,202036,24855,24855,0
2020-09-02,1200401,202036,24855,24855,0
2020-09-02,1200708,202036,24855,24855,0
2020-09-02,1200393,202036,24855,24855,0
2020-09-02,1200054,202036,24855,24855,0
2020-09-02,1200427,202036,24855,24855,0
2020-09-02,1200807,202036,24855,24855,0
2020-09-02,1200500,202036,24855,24855,0
2020-09-02,1200450,202036,24855,24855,0
2020-09-02,1200609,202036,24855,24855,0
2020-09-02,1200385,202036,24855,24855,0
2020-09-02,1200336,202036,24855,24855,0
2020-09-03,1200013,202036,24859,24855,4
2020-09-03,1200302,202036,24874,24859,15
2020-09-03,1200609,202036,24923,24874,49
2020-09-03,1200450,202036,24925,24923,2
2020-09-03,1200054,202036,24927,24925,2
2020-09-03,1200104,202036,24941,24927,14
2020-09-03,1200138,202036,24941,24941,0
2020-09-03,1200179,202036,24941,24941,0
2020-09-03,1200203,202036,24956,24941,15
2020-09-03,1200252,202036,24954,24956,-2
2020-09-03,1200328,202036,24956,24954,2
2020-09-03,1200351,202036,24961,24956,5
2020-09-03,1200336,202036,25021,24961,60
2020-09-03,1200385,202036,25024,25021,3
2020-09-03,1200807,202036,25025,25024,1
2020-09-03,1200393,202036,25031,25025,6
2020-09-03,1200401,202036,25083,25031,52
2020-09-03,1200427,202036,25083,25083,0
2020-09-03,1200500,202036,25099,25083,16
2020-09-03,1200708,202036,25132,25099,33
2020-09-03,1200435,202036,25148,25132,16
2020-09-03,1200344,202036,25150,25148,2
2020-09-04,1200302,202036,25150,25150,0
2020-09-04,1200252,202036,25152,25150,2
2020-09-04,1200203,202036,25168,25152,16
2020-09-04,1200179,202036,25168,25168,0
2020-09-04,1200328,202036,25168,25168,0
2020-09-04,1200385,202036,25168,25168,0
2020-09-04,1200104,202036,25175,25168,7
2020-09-04,1200054,202036,25180,25175,5
2020-09-04,1200013,202036,25180,25180,0
2020-09-04,1200138,202036,25180,25180,0
2020-09-04,1200344,202036,25183,25180,3
2020-09-04,1200401,202036,25196,25183,13
2020-09-04,1200708,202036,25209,25196,13
2020-09-04,1200351,202036,25215,25209,6
2020-09-04,1200807,202036,25215,25215,0
2020-09-04,1200393,202036,25217,25215,2
2020-09-04,1200427,202036,25219,25217,2
2020-09-04,1200336,202036,25215,25219,-4
2020-09-04,1200500,202036,25224,25215,9
2020-09-04,1200450,202036,25226,25224,2
2020-09-04,1200435,202036,25239,25226,13
2020-09-04,1200609,202036,25264,25239,25
2020-09-05,1200344,202036,25265,25264,1
2020-09-05,1200013,202036,25268,25265,3
2020-09-05,1200054,202036,25275,25268,7
2020-09-05,1200104,202036,25278,25275,3
2020-09-05,1200138,202036,25279,25278,1
2020-09-05,1200179,202036,25279,25279,0
2020-09-05,1200203,202036,25308,25279,29
2020-09-05,1200252,202036,25307,25308,-1
2020-09-05,1200328,202036,25316,25307,9
2020-09-05,1200385,202036,25317,25316,1
2020-09-05,1200302,202036,25332,25317,15
2020-09-05,1200807,202036,25333,25332,1
2020-09-05,1200393,202036,25338,25333,5
2020-09-05,1200401,202036,25363,25338,25
2020-09-05,1200435,202036,25368,25363,5
2020-09-05,1200500,202036,25377,25368,9
2020-09-05,1200450,202036,25380,25377,3
2020-09-05,1200609,202036,25382,25380,2
2020-09-05,1200708,202036,25396,25382,14
2020-09-05,1200427,202036,25396,25396,0
2020-09-05,1200336,202036,25419,25396,23
2020-09-05,1200351,202036,25423,25419,4
2020-09-06,1200252,202037,25423,25423,0
2020-09-06,1200393,202037,25423,25423,0
2020-09-06,1200807,202037,25423,25423,0
2020-09-06,1200427,202037,25423,25423,0
2020-09-06,1200708,202037,25423,25423,0
2020-09-06,1200500,202037,25423,25423,0
2020-09-06,1200450,202037,25423,25423,0
2020-09-06,1200609,202037,25423,25423,0
2020-09-06,1200435,202037,25423,25423,0
2020-09-06,1200138,202037,25423,25423,0
2020-09-06,1200401,202037,25457,25423,34
2020-09-06,1200013,202037,25457,25457,0
2020-09-06,1200351,202037,25457,25457,0
2020-09-06,1200203,202037,25457,25457,0
2020-09-06,1200344,202037,25457,25457,0
2020-09-06,1200328,202037,25457,25457,0
2020-09-06,1200336,202037,25457,25457,0
2020-09-06,1200179,202037,25458,25457,1
2020-09-06,1200385,202037,25458,25458,0
2020-09-06,1200104,202037,25458,25458,0
2020-09-06,1200302,202037,25458,25458,0
2020-09-06,1200054,202037,25458,25458,0
2020-09-07,1200609,202037,25458,25458,0
2020-09-07,1200807,202037,25459,25458,1
2020-09-07,1200328,202037,25459,25459,0
2020-09-07,1200344,202037,25459,25459,0
2020-09-07,1200351,202037,25460,25459,1
2020-09-07,1200336,202037,25460,25460,0
2020-09-07,1200385,202037,25460,25460,0
2020-09-07,1200393,202037,25460,25460,0
2020-09-07,1200401,202037,25470,25460,10
2020-09-07,1200427,202037,25470,25470,0
2020-09-07,1200252,202037,25475,25470,5
2020-09-07,1200450,202037,25476,25475,1
2020-09-07,1200500,202037,25478,25476,2
2020-09-07,1200708,202037,25479,25478,1
2020-09-07,1200013,202037,25479,25479,0
2020-09-07,1200054,202037,25480,25479,1
2020-09-07,1200435,202037,25480,25480,0
2020-09-07,1200138,202037,25481,25480,1
2020-09-07,1200179,202037,25481,25481,0
2020-09-07,1200203,202037,25481,25481,0
2020-09-07,1200302,202037,25482,25481,1
2020-09-07,1200104,202037,25484,25482,2
2020-09-08,1200807,202037,25485,25484,1
2020-09-08,1200708,202037,25486,25485,1
2020-09-08,1200609,202037,25486,25486,0
2020-09-08,1200450,202037,25487,25486,1
2020-09-08,1200203,202037,25488,25487,1
2020-09-08,1200500,202037,25488,25488,0
2020-09-08,1200435,202037,25488,25488,0
2020-09-08,1200427,202037,25488,25488,0
2020-09-08,1200401,202037,25497,25488,9
2020-09-08,1200393,202037,25497,25497,0
2020-09-08,1200138,202037,25497,25497,0
2020-09-08,1200385,202037,25497,25497,0
2020-09-08,1200351,202037,25497,25497,0
2020-09-08,1200013,202037,25499,25497,2
2020-09-08,1200054,202037,25501,25499,2
2020-09-08,1200104,202037,25503,25501,2
2020-09-08,1200179,202037,25503,25503,0
2020-09-08,1200336,202037,25509,25503,6
2020-09-08,1200302,202037,25509,25509,0
2020-09-08,1200328,202037,25509,25509,0
2020-09-08,1200344,202037,25509,25509,0
2020-09-08,1200252,202037,25509,25509,0
2020-09-09,1200807,202037,25510,25509,1
2020-09-09,1200336,202037,25510,25510,0
2020-09-09,1200708,202037,25526,25510,16
2020-09-09,1200609,202037,25577,25526,51
2020-09-09,1200450,202037,25590,25577,13
2020-09-09,1200500,202037,25599,25590,9
2020-09-09,1200435,202037,25614,25599,15
2020-09-09,1200427,202037,25615,25614,1
2020-09-09,1200401,202037,25632,25615,17
2020-09-09,1200393,202037,25632,25632,0
2020-09-09,1200385,202037,25633,25632,1
2020-09-09,1200013,202037,25633,25633,0
2020-09-09,1200344,202037,25633,25633,0
2020-09-09,1200328,202037,25633,25633,0
2020-09-09,1200302,202037,25637,25633,4
2020-09-09,1200252,202037,25638,25637,1
2020-09-09,1200203,202037,25653,25638,15
2020-09-09,1200179,202037,25653,25653,0
2020-09-09,1200138,202037,25654,25653,1
2020-09-09,1200104,202037,25654,25654,0
2020-09-09,1200054,202037,25671,25654,17
2020-09-09,1200351,202037,25683,25671,12
2020-09-10,1200393,202037,25686,25683,3
2020-09-10,1200401,202037,25715,25686,29
2020-09-10,1200427,202037,25715,25715,0
2020-09-10,1200435,202037,25719,25715,4
2020-09-10,1200807,202037,25719,25719,0
2020-09-10,1200450,202037,25721,25719,2
2020-09-10,1200609,202037,25768,25721,47
2020-09-10,1200302,202037,25782,25768,14
2020-09-10,1200252,202037,25782,25782,0
2020-09-10,1200500,202037,25790,25782,8
2020-09-10,1200385,202037,25793,25790,3
2020-09-10,1200336,202037,25806,25793,13
2020-09-10,1200351,202037,25812,25806,6
2020-09-10,1200344,202037,25815,25812,3
2020-09-10,1200328,202037,25826,25815,11
2020-09-10,1200708,202037,25852,25826,26
2020-09-10,1200203,202037,25881,25852,29
2020-09-10,1200179,202037,25881,25881,0
2020-09-10,1200138,202037,25881,25881,0
2020-09-10,1200104,202037,25883,25881,2
2020-09-10,1200054,202037,25889,25883,6
2020-09-10,1200013,202037,25892,25889,3
2020-09-11,1200302,202037,25895,25892,3
2020-09-11,1200252,202037,25894,25895,-1
2020-09-11,1200203,202037,25904,25894,10
2020-09-11,1200179,202037,25904,25904,0
2020-09-11,1200344,202037,25904,25904,0
2020-09-11,1200104,202037,25906,25904,2
2020-09-11,1200054,202037,25912,25906,6
2020-09-11,1200013,202037,25912,25912,0
2020-09-11,1200328,202037,25912,25912,0
2020-09-11,1200138,202037,25912,25912,0
2020-09-11,1200336,202037,25930,25912,18
2020-09-11,1200351,202037,25940,25930,10
2020-09-11,1200385,202037,25941,25940,1
2020-09-11,1200393,202037,25941,25941,0
2020-09-11,1200708,202037,25956,25941,15
2020-09-11,1200609,202037,25979,25956,23
2020-09-11,1200450,202037,25982,25979,3
2020-09-11,1200435,202037,25988,25982,6
2020-09-11,1200427,202037,25988,25988,0
2020-09-11,1200401,202037,26013,25988,25
2020-09-11,1200807,202037,26014,26013,1
2020-09-11,1200500,202037,26019,26014,5
2020-09-12,1200385,202037,26019,26019,0
2020-09-12,1200609,202037,26019,26019,0
2020-09-12,1200450,202037,26022,26019,3
2020-09-12,1200500,202037,26024,26022,2
2020-09-12,1200435,202037,26026,26024,2
2020-09-12,1200427,202037,26026,26026,0
2020-09-12,1200401,202037,26051,26026,25
2020-09-12,1200393,202037,26067,26051,16
2020-09-12,1200807,202037,26070,26067,3
2020-09-12,1200344,202037,26070,26070,0
2020-09-12,1200708,202037,26084,26070,14
2020-09-12,1200138,202037,26085,26084,1
2020-09-12,1200203,202037,26096,26085,11
2020-09-12,1200302,202037,26106,26096,10
2020-09-12,1200252,202037,26106,26106,0
2020-09-12,1200179,202037,26106,26106,0
2020-09-12,1200336,202037,26127,26106,21
2020-09-12,1200104,202037,26128,26127,1
2020-09-12,1200054,202037,26137,26128,9
2020-09-12,1200013,202037,26143,26137,6
2020-09-12,1200328,202037,26143,26143,0
2020-09-12,1200351,202037,26163,26143,20
2020-09-13,1200385,202038,26163,26163,0
2020-09-13,1200203,202038,26163,26163,0
2020-09-13,1200708,202038,26163,26163,0
2020-09-13,1200450,202038,26163,26163,0
2020-09-13,1200500,202038,26163,26163,0
2020-09-13,1200435,202038,26163,26163,0
2020-09-13,1200427,202038,26163,26163,0
2020-09-13,1200401,202038,26171,26163,8
2020-09-13,1200393,202038,26171,26171,0
2020-09-13,1200807,202038,26172,26171,1
2020-09-13,1200336,202038,26172,26172,0
2020-09-13,1200351,202038,26172,26172,0
2020-09-13,1200344,202038,26172,26172,0
2020-09-13,1200054,202038,26173,26172,1
2020-09-13,1200104,202038,26177,26173,4
2020-09-13,1200138,202038,26177,26177,0
2020-09-13,1200179,202038,26177,26177,0
2020-09-13,1200013,202038,26177,26177,0
2020-09-13,1200252,202038,26178,26177,1
2020-09-13,1200302,202038,26180,26178,2
2020-09-13,1200328,202038,26180,26180,0
2020-09-13,1200609,202038,26181,26180,1
2020-09-14,1200328,202038,26181,26181,0
2020-09-14,1200013,202038,26181,26181,0
2020-09-14,1200054,202038,26181,26181,0
2020-09-14,1200104,202038,26181,26181,0
2020-09-14,1200138,202038,26181,26181,0
2020-09-14,1200179,202038,26181,26181,0
2020-09-14,1200203,202038,26181,26181,0
2020-09-14,1200252,202038,26181,26181,0
2020-09-14,1200302,202038,26181,26181,0
2020-09-14,1200385,202038,26181,26181,0
2020-09-14,1200344,202038,26181,26181,0
2020-09-14,1200807,202038,26182,26181,1
2020-09-14,1200336,202038,26182,26182,0
2020-09-14,1200427,202038,26182,26182,0
2020-09-14,1200708,202038,26185,26182,3
2020-09-14,1200609,202038,26185,26185,0
2020-09-14,1200351,202038,26185,26185,0
2020-09-14,1200500,202038,26185,26185,0
2020-09-14,1200435,202038,26185,26185,0
2020-09-14,1200401,202038,26191,26185,6
2020-09-14,1200393,202038,26191,26191,0
2020-09-14,1200450,202038,26191,26191,0
2020-09-15,1200252,202038,26191,26191,0
2020-09-15,1200609,202038,26199,26191,8
2020-09-15,1200450,202038,26204,26199,5
2020-09-15,1200500,202038,26221,26204,17
2020-09-15,1200435,202038,26226,26221,5
2020-09-15,1200427,202038,26226,26226,0
2020-09-15,1200401,202038,26259,26226,33
2020-09-15,1200393,202038,26262,26259,3
2020-09-15,1200807,202038,26262,26262,0
2020-09-15,1200336,202038,26270,26262,8
2020-09-15,1200708,202038,26278,26270,8
2020-09-15,1200351,202038,26284,26278,6
2020-09-15,1200203,202038,26292,26284,8
2020-09-15,1200344,202038,26294,26292,2
2020-09-15,1200328,202038,26294,26294,0
2020-09-15,1200302,202038,26296,26294,2
2020-09-15,1200138,202038,26296,26296,0
2020-09-15,1200385,202038,26296,26296,0
2020-09-15,1200104,202038,26297,26296,1
2020-09-15,1200054,202038,26299,26297,2
2020-09-15,1200013,202038,26301,26299,2
2020-09-15,1200179,202038,26302,26301,1
2020-09-16,1200427,202038,26302,26302,0
2020-09-16,1200302,202038,26319,26302,17
2020-09-16,1200328,202038,26320,26319,1
2020-09-16,1200344,202038,26320,26320,0
2020-09-16,1200351,202038,26332,26320,12
2020-09-16,1200336,202038,26334,26332,2
2020-09-16,1200609,202038,26399,26334,65
2020-09-16,1200252,202038,26397,26399,-2
2020-09-16,1200393,202038,26406,26397,9
2020-09-16,1200401,202038,26423,26406,17
2020-09-16,1200385,202038,26426,26423,3
2020-09-16,1200435,202038,26425,26426,-1
2020-09-16,1200450,202038,26425,26425,0
2020-09-16,1200807,202038,26425,26425,0
2020-09-16,1200203,202038,26444,26425,19
2020-09-16,1200179,202038,26444,26444,0
2020-09-16,1200138,202038,26444,26444,0
2020-09-16,1200104,202038,26444,26444,0
2020-09-16,1200054,202038,26459,26444,15
2020-09-16,1200013,202038,26463,26459,4
2020-09-16,1200708,202038,26473,26463,10
2020-09-16,1200500,202038,26478,26473,5
2020-09-17,1200351,202038,26490,26478,12
2020-09-17,1200344,202038,26491,26490,1
2020-09-17,1200328,202038,26492,26491,1
2020-09-17,1200302,202038,26498,26492,6
2020-09-17,1200336,202038,26523,26498,25
2020-09-17,1200179,202038,26523,26523,0
2020-09-17,1200138,202038,26525,26523,2
2020-09-17,1200609,202038,26637,26525,112
2020-09-17,1200203,202038,26663,26637,26
2020-09-17,1200385,202038,26663,26663,0
2020-09-17,1200252,202038,26663,26663,0
2020-09-17,1200393,202038,26666,26663,3
2020-09-17,1200054,202038,26671,26666,5
2020-09-17,1200013,202038,26672,26671,1
2020-09-17,1200104,202038,26672,26672,0
2020-09-17,1200708,202038,26678,26672,6
2020-09-17,1200807,202038,26682,26678,4
2020-09-17,1200500,202038,26692,26682,10
2020-09-17,1200435,202038,26693,26692,1
2020-09-17,1200427,202038,26694,26693,1
2020-09-17,1200401,202038,26726,26694,32
2020-09-17,1200450,202038,26731,26726,5
2020-09-18,1200328,202038,26731,26731,0
2020-09-18,1200435,202038,26730,26731,-1
2020-09-18,1200013,202038,26731,26730,1
2020-09-18,1200104,202038,26730,26731,-1
2020-09-18,1200138,202038,26730,26730,0
2020-09-18,1200179,202038,26730,26730,0
2020-09-18,1200203,202038,26754,26730,24
2020-09-18,1200252,202038,26760,26754,6
2020-09-18,1200302,202038,26767,26760,7
2020-09-18,1200344,202038,26770,26767,3
2020-09-18,1200351,202038,26786,26770,16
2020-09-18,1200336,202038,26828,26786,42
2020-09-18,1200708,202038,26840,26828,12
2020-09-18,1200609,202038,26925,26840,85
2020-09-18,1200450,202038,26924,26925,-1
2020-09-18,1200500,202038,26931,26924,7
2020-09-18,1200385,202038,26931,26931,0
2020-09-18,1200427,202038,26931,26931,0
2020-09-18,1200401,202038,26954,26931,23
2020-09-18,1200054,202038,26955,26954,1
2020-09-18,1200393,202038,26957,26955,2
2020-09-18,1200807,202038,26957,26957,0
2020-09-19,1200203,202038,26985,26957,28
2020-09-19,1200179,202038,26985,26985,0
2020-09-19,1200138,202038,26985,26985,0
2020-09-19,1200104,202038,26986,26985,1
2020-09-19,1200252,202038,26988,26986,2
2020-09-19,1200450,202038,26993,26988,5
2020-09-19,1200609,202038,27018,26993,25
2020-09-19,1200013,202038,27019,27018,1
2020-09-19,1200302,202038,27021,27019,2
2020-09-19,1200054,202038,27022,27021,1
2020-09-19,1200328,202038,27030,27022,8
2020-09-19,1200500,202038,27036,27030,6
2020-09-19,1200351,202038,27042,27036,6
2020-09-19,1200336,202038,27049,27042,7
2020-09-19,1200385,202038,27052,27049,3
2020-09-19,1200807,202038,27052,27052,0
2020-09-19,1200393,202038,27053,27052,1
2020-09-19,1200401,202038,27066,27053,13
2020-09-19,1200427,202038,27067,27066,1
2020-09-19,1200708,202038,27076,27067,9
2020-09-19,1200344,202038,27076,27076,0
2020-09-19,1200435,202038,27076,27076,0
2020-09-20,1200302,202039,27078,27076,2
2020-09-20,1200252,202039,27078,27078,0
2020-09-20,1200203,202039,27080,27078,2
2020-09-20,1200179,202039,27080,27080,0
2020-09-20,1200013,202039,27080,27080,0
2020-09-20,1200104,202039,27080,27080,0
2020-09-20,1200054,202039,27080,27080,0
2020-09-20,1200328,202039,27080,27080,0
2020-09-20,1200385,202039,27080,27080,0
2020-09-20,1200138,202039,27080,27080,0
2020-09-20,1200344,202039,27080,27080,0
2020-09-20,1200393,202039,27080,27080,0
2020-09-20,1200708,202039,27080,27080,0
2020-09-20,1200609,202039,27080,27080,0
2020-09-20,1200450,202039,27080,27080,0
2020-09-20,1200500,202039,27080,27080,0
2020-09-20,1200435,202039,27080,27080,0
2020-09-20,1200427,202039,27080,27080,0
2020-09-20,1200401,202039,27094,27080,14
2020-09-20,1200807,202039,27094,27094,0
2020-09-20,1200336,202039,27094,27094,0
2020-09-20,1200351,202039,27094,27094,0
2020-09-21,1200328,202039,27094,27094,0
2020-09-21,1200302,202039,27095,27094,1
2020-09-21,1200203,202039,27096,27095,1
2020-09-21,1200179,202039,27096,27096,0
2020-09-21,1200344,202039,27096,27096,0
2020-09-21,1200104,202039,27098,27096,2
2020-09-21,1200054,202039,27098,27098,0
2020-09-21,1200013,202039,27100,27098,2
2020-09-21,1200138,202039,27100,27100,0
2020-09-21,1200385,202039,27100,27100,0
2020-09-21,1200351,202039,27103,27100,3
2020-09-21,1200807,202039,27104,27103,1
2020-09-21,1200393,202039,27104,27104,0
2020-09-21,1200401,202039,27117,27104,13
2020-09-21,1200435,202039,27117,27117,0
2020-09-21,1200500,202039,27117,27117,0
2020-09-21,1200450,202039,27117,27117,0
2020-09-21,1200609,202039,27117,27117,0
2020-09-21,1200708,202039,27120,27117,3
2020-09-21,1200427,202039,27120,27120,0
2020-09-21,1200252,202039,27121,27120,1
2020-09-21,1200336,202039,27121,27121,0
2020-09-22,1200393,202039,27123,27121,2
2020-09-22,1200401,202039,27143,27123,20
2020-09-22,1200427,202039,27143,27143,0
2020-09-22,1200435,202039,27143,27143,0
2020-09-22,1200807,202039,27143,27143,0
2020-09-22,1200450,202039,27144,27143,1
2020-09-22,1200054,202039,27152,27144,8
2020-09-22,1200609,202039,27183,27152,31
2020-09-22,1200708,202039,27189,27183,6
2020-09-22,1200500,202039,27202,27189,13
2020-09-22,1200336,202039,27217,27202,15
2020-09-22,1200328,202039,27220,27217,3
2020-09-22,1200351,202039,27224,27220,4
2020-09-22,1200252,202039,27224,27224,0
2020-09-22,1200344,202039,27230,27224,6
2020-09-22,1200302,202039,27234,27230,4
2020-09-22,1200203,202039,27259,27234,25
2020-09-22,1200179,202039,27259,27259,0
2020-09-22,1200138,202039,27259,27259,0
2020-09-22,1200104,202039,27261,27259,2
2020-09-22,1200013,202039,27261,27261,0
2020-09-22,1200385,202039,27261,27261,0
2020-09-23,1200252,202039,27265,27261,4
2020-09-23,1200609,202039,27292,27265,27
2020-09-23,1200807,202039,27292,27292,0
2020-09-23,1200328,202039,27295,27292,3
2020-09-23,1200344,202039,27295,27295,0
2020-09-23,1200351,202039,27318,27295,23
2020-09-23,1200336,202039,27334,27318,16
2020-09-23,1200385,202039,27330,27334,-4
2020-09-23,1200393,202039,27330,27330,0
2020-09-23,1200401,202039,27349,27330,19
2020-09-23,1200427,202039,27349,27349,0
2020-09-23,1200708,202039,27358,27349,9
2020-09-23,1200500,202039,27363,27358,5
2020-09-23,1200450,202039,27365,27363,2
2020-09-23,1200302,202039,27374,27365,9
2020-09-23,1200203,202039,27406,27374,32
2020-09-23,1200179,202039,27406,27406,0
2020-09-23,1200138,202039,27406,27406,0
2020-09-23,1200104,202039,27408,27406,2
2020-09-23,1200054,202039,27408,27408,0
2020-09-23,1200013,202039,27412,27408,4
2020-09-23,1200435,202039,27412,27412,0
2020-09-24,1200351,202039,27424,27412,12
2020-09-24,1200393,202039,27424,27424,0
2020-09-24,1200344,202039,27425,27424,1
2020-09-24,1200328,202039,27431,27425,6
2020-09-24,1200336,202039,27444,27431,13
2020-09-24,1200252,202039,27444,27444,0
2020-09-24,1200203,202039,27458,27444,14
2020-09-24,1200179,202039,27459,27458,1
2020-09-24,1200401,202039,27482,27459,23
2020-09-24,1200302,202039,27489,27482,7
2020-09-24,1200385,202039,27491,27489,2
2020-09-24,1200450,202039,27490,27491,-1
2020-09-24,1200708,202039,27499,27490,9
2020-09-24,1200609,202039,27551,27499,52
2020-09-24,1200500,202039,27559,27551,8
2020-09-24,1200138,202039,27559,27559,0
2020-09-24,1200427,202039,27563,27559,4
2020-09-24,1200435,202039,27563,27563,0
2020-09-24,1200104,202039,27567,27563,4
2020-09-24,1200054,202039,27568,27567,1
2020-09-24,1200013,202039,27571,27568,3
2020-09-24,1200807,202039,27571,27571,0
2020-09-25,1200351,202039,27580,27571,9
2020-09-25,1200336,202039,27584,27580,4
2020-09-25,1200427,202039,27584,27584,0
2020-09-25,1200500,202039,27594,27584,10
2020-09-25,1200401,202039,27615,27594,21
2020-09-25,1200609,202039,27681,27615,66
2020-09-25,1200708,202039,27691,27681,10
2020-09-25,1200013,202039,27693,27691,2
2020-09-25,1200435,202039,27694,27693,1
2020-09-25,1200450,202039,27694,27694,0
2020-09-25,1200344,202039,27696,27694,2
2020-09-25,1200203,202039,27708,27696,12
2020-09-25,1200302,202039,27708,27708,0
2020-09-25,1200252,202039,27708,27708,0
2020-09-25,1200179,202039,27708,27708,0
2020-09-25,1200138,202039,27709,27708,1
2020-09-25,1200807,202039,27711,27709,2
2020-09-25,1200104,202039,27712,27711,1
2020-09-25,1200054,202039,27725,27712,13
2020-09-25,1200393,202039,27725,27725,0
2020-09-25,1200385,202039,27725,27725,0
2020-09-25,1200328,202039,27725,27725,0
2020-09-26,1200435,202039,27728,27725,3
2020-09-26,1200401,202039,27757,27728,29
2020-09-26,1200427,202039,27760,27757,3
2020-09-26,1200500,202039,27763,27760,3
2020-09-26,1200393,202039,27763,27763,0
2020-09-26,1200609,202039,27784,27763,21
2020-09-26,1200708,202039,27789,27784,5
2020-09-26,1200344,202039,27795,27789,6
2020-09-26,1200807,202039,27795,27795,0
2020-09-26,1200450,202039,27795,27795,0
2020-09-26,1200385,202039,27795,27795,0
2020-09-26,1200336,202039,27820,27795,25
2020-09-26,1200351,202039,27842,27820,22
2020-09-26,1200054,202039,27853,27842,11
2020-09-26,1200104,202039,27854,27853,1
2020-09-26,1200138,202039,27854,27854,0
2020-09-26,1200179,202039,27854,27854,0
2020-09-26,1200013,202039,27856,27854,2
2020-09-26,1200252,202039,27857,27856,1
2020-09-26,1200328,202039,27862,27857,5
2020-09-26,1200302,202039,27865,27862,3
2020-09-26,1200203,202039,27874,27865,9
2020-09-27,1200807,202040,27874,27874,0
2020-09-27,1200203,202040,27874,27874,0
2020-09-27,1200385,202040,27874,27874,0
2020-09-27,1200252,202040,27874,27874,0
2020-09-27,1200302,202040,27874,27874,0
2020-09-27,1200328,202040,27874,27874,0
2020-09-27,1200344,202040,27874,27874,0
2020-09-27,1200351,202040,27874,27874,0
2020-09-27,1200336,202040,27874,27874,0
2020-09-27,1200708,202040,27874,27874,0
2020-09-27,1200393,202040,27874,27874,0
2020-09-27,1200104,202040,27874,27874,0
2020-09-27,1200427,202040,27874,27874,0
2020-09-27,1200435,202040,27874,27874,0
2020-09-27,1200500,202040,27874,27874,0
2020-09-27,1200450,202040,27874,27874,0
2020-09-27,1200609,202040,27874,27874,0
2020-09-27,1200054,202040,27874,27874,0
2020-09-27,1200013,202040,27874,27874,0
2020-09-27,1200138,202040,27874,27874,0
2020-09-27,1200179,202040,27874,27874,0
2020-09-27,1200401,202040,27874,27874,0
2020-09-28,1200385,202040,27874,27874,0
2020-09-28,1200013,202040,27874,27874,0
2020-09-28,1200807,202040,27874,27874,0
2020-09-28,1200401,202040,27897,27874,23
2020-09-28,1200336,202040,27897,27897,0
2020-09-28,1200450,202040,27897,27897,0
2020-09-28,1200609,202040,27897,27897,0
2020-09-28,1200708,202040,27898,27897,1
2020-09-28,1200435,202040,27898,27898,0
2020-09-28,1200500,202040,27898,27898,0
2020-09-28,1200351,202040,27898,27898,0
2020-09-28,1200344,202040,27898,27898,0
2020-09-28,1200328,202040,27898,27898,0
2020-09-28,1200302,202040,27899,27898,1
2020-09-28,1200252,202040,27899,27899,0
2020-09-28,1200203,202040,27899,27899,0
2020-09-28,1200179,202040,27899,27899,0
2020-09-28,1200138,202040,27899,27899,0
2020-09-28,1200104,202040,27899,27899,0
2020-09-28,1200054,202040,27899,27899,0
2020-09-28,1200393,202040,27899,27899,0
2020-09-28,1200427,202040,27900,27899,1
2020-09-29,1200401,202040,27916,27900,16
2020-09-29,1200427,202040,27916,27916,0
2020-09-29,1200435,202040,27917,27916,1
2020-09-29,1200500,202040,27930,27917,13
2020-09-29,1200013,202040,27930,27930,0
2020-09-29,1200609,202040,27997,27930,67
2020-09-29,1200708,202040,28019,27997,22
2020-09-29,1200336,202040,28019,28019,0
2020-09-29,1200393,202040,28019,28019,0
2020-09-29,1200450,202040,28020,28019,1
2020-09-29,1200807,202040,28020,28020,0
2020-09-29,1200054,202040,28022,28020,2
2020-09-29,1200385,202040,28023,28022,1
2020-09-29,1200104,202040,28024,28023,1
2020-09-29,1200138,202040,28026,28024,2
2020-09-29,1200179,202040,28029,28026,3
2020-09-29,1200203,202040,28029,28029,0
2020-09-29,1200344,202040,28029,28029,0
2020-09-29,1200302,202040,28035,28029,6
2020-09-29,1200328,202040,28036,28035,1
2020-09-29,1200351,202040,28045,28036,9
2020-09-29,1200252,202040,28045,28045,0
2020-09-30,1200336,202040,28045,28045,0
2020-09-30,1200609,202040,28117,28045,72
2020-09-30,1200450,202040,28118,28117,1
2020-09-30,1200500,202040,28126,28118,8
2020-09-30,1200427,202040,28126,28126,0
2020-09-30,1200401,202040,28164,28126,38
2020-09-30,1200708,202040,28178,28164,14
2020-09-30,1200807,202040,28178,28178,0
2020-09-30,1200385,202040,28178,28178,0
2020-09-30,1200351,202040,28198,28178,20
2020-09-30,1200435,202040,28198,28198,0
2020-09-30,1200328,202040,28198,28198,0
2020-09-30,1200013,202040,28201,28198,3
2020-09-30,1200054,202040,28210,28201,9
2020-09-30,1200344,202040,28211,28210,1
2020-09-30,1200203,202040,28231,28211,20
2020-09-30,1200252,202040,28238,28231,7
2020-09-30,1200104,202040,28226,28238,-12
2020-09-30,1200138,202040,28227,28226,1
2020-09-30,1200393,202040,28227,28227,0
2020-09-30,1200302,202040,28235,28227,8
2020-09-30,1200179,202040,28237,28235,2
2020-10-01,1200336,202040,28289,28237,52
2020-10-01,1200450,202040,28289,28289,0
2020-10-01,1200104,202040,28289,28289,0
2020-10-01,1200179,202040,28289,28289,0
2020-10-01,1200203,202040,28301,28289,12
2020-10-01,1200252,202040,28301,28301,0
2020-10-01,1200302,202040,28302,28301,1
2020-10-01,1200328,202040,28302,28302,0
2020-10-01,1200344,202040,28302,28302,0
2020-10-01,1200351,202040,28309,28302,7
2020-10-01,1200385,202040,28310,28309,1
2020-10-01,1200807,202040,28310,28310,0
2020-10-01,1200393,202040,28312,28310,2
2020-10-01,1200013,202040,28312,28312,0
2020-10-01,1200435,202040,28312,28312,0
2020-10-01,1200054,202040,28313,28312,1
2020-10-01,1200138,202040,28314,28313,1
2020-10-01,1200500,202040,28326,28314,12
2020-10-01,1200609,202040,28389,28326,63
2020-10-01,1200708,202040,28401,28389,12
2020-10-01,1200401,202040,28424,28401,23
2020-10-01,1200427,202040,28424,28424,0
2020-10-02,1200328,202040,28424,28424,0
2020-10-02,1200013,202040,28424,28424,0
2020-10-02,1200054,202040,28424,28424,0
2020-10-02,1200344,202040,28424,28424,0
2020-10-02,1200138,202040,28424,28424,0
2020-10-02,1200179,202040,28424,28424,0
2020-10-02,1200203,202040,28424,28424,0
2020-10-02,1200252,202040,28424,28424,0
2020-10-02,1200302,202040,28424,28424,0
2020-10-02,1200336,202040,28424,28424,0
2020-10-02,1200104,202040,28424,28424,0
2020-10-02,1200385,202040,28424,28424,0
2020-10-02,1200393,202040,28424,28424,0
2020-10-02,1200427,202040,28424,28424,0
2020-10-02,1200435,202040,28424,28424,0
2020-10-02,1200500,202040,28424,28424,0
2020-10-02,1200450,202040,28424,28424,0
2020-10-02,1200609,202040,28424,28424,0
2020-10-02,1200708,202040,28424,28424,0
2020-10-02,1200401,202040,28424,28424,0
2020-10-02,1200807,202040,28424,28424,0
2020-10-02,1200351,202040,28424,28424,0
2020-10-03,1200807,202040,28428,28424,4
2020-10-03,1200393,202040,28428,28428,0
2020-10-03,1200401,202040,28465,28428,37
2020-10-03,1200427,202040,28467,28465,2
2020-10-03,1200708,202040,28489,28467,22
2020-10-03,1200450,202040,28489,28489,0
2020-10-03,1200609,202040,28591,28489,102
2020-10-03,1200328,202040,28591,28591,0
2020-10-03,1200435,202040,28613,28591,22
2020-10-03,1200351,202040,28616,28613,3
2020-10-03,1200500,202040,28626,28616,10
2020-10-03,1200138,202040,28626,28626,0
2020-10-03,1200344,202040,28629,28626,3
2020-10-03,1200013,202040,28630,28629,1
2020-10-03,1200054,202040,28640,28630,10
2020-10-03,1200104,202040,28640,28640,0
2020-10-03,1200385,202040,28640,28640,0
2020-10-03,1200179,202040,28640,28640,0
2020-10-03,1200252,202040,28643,28640,3
2020-10-03,1200302,202040,28652,28643,9
2020-10-03,1200203,202040,28659,28652,7
2020-10-03,1200336,202040,28677,28659,18
2020-10-04,1200807,202041,28678,28677,1
2020-10-04,1200393,202041,28678,28678,0
2020-10-04,1200401,202041,28685,28678,7
2020-10-04,1200427,202041,28685,28685,0
2020-10-04,1200203,202041,28685,28685,0
2020-10-04,1200500,202041,28685,28685,0
2020-10-04,1200450,202041,28685,28685,0
2020-10-04,1200708,202041,28686,28685,1
2020-10-04,1200385,202041,28686,28686,0
2020-10-04,1200435,202041,28686,28686,0
2020-10-04,1200336,202041,28687,28686,1
2020-10-04,1200302,202041,28687,28687,0
2020-10-04,1200344,202041,28687,28687,0
2020-10-04,1200328,202041,28687,28687,0
2020-10-04,1200252,202041,28687,28687,0
2020-10-04,1200609,202041,28687,28687,0
2020-10-04,1200179,202041,28687,28687,0
2020-10-04,1200138,202041,28687,28687,0
2020-10-04,1200104,202041,28687,28687,0
2020-10-04,1200054,202041,28687,28687,0
2020-10-04,1200013,202041,28687,28687,0
2020-10-04,1200351,202041,28687,28687,0
2020-10-05,1200179,202041,28687,28687,0
2020-10-05,1200252,202041,28688,28687,1
2020-10-05,1200203,202041,28689,28688,1
2020-10-05,1200138,202041,28689,28689,0
2020-10-05,1200302,202041,28690,28689,1
2020-10-05,1200054,202041,28690,28690,0
2020-10-05,1200013,202041,28690,28690,0
2020-10-05,1200344,202041,28690,28690,0
2020-10-05,1200328,202041,28690,28690,0
2020-10-05,1200104,202041,28692,28690,2
2020-10-05,1200336,202041,28693,28692,1
2020-10-05,1200351,202041,28694,28693,1
2020-10-05,1200385,202041,28694,28694,0
2020-10-05,1200401,202041,28702,28694,8
2020-10-05,1200708,202041,28702,28702,0
2020-10-05,1200609,202041,28702,28702,0
2020-10-05,1200450,202041,28702,28702,0
2020-10-05,1200500,202041,28702,28702,0
2020-10-05,1200427,202041,28702,28702,0
2020-10-05,1200393,202041,28702,28702,0
2020-10-05,1200807,202041,28702,28702,0
2020-10-05,1200435,202041,28702,28702,0
2020-10-06,1200393,202041,28702,28702,0
2020-10-06,1200351,202041,28705,28702,3
2020-10-06,1200708,202041,28729,28705,24
2020-10-06,1200609,202041,28760,28729,31
2020-10-06,1200450,202041,28760,28760,0
2020-10-06,1200500,202041,28769,28760,9
2020-10-06,1200435,202041,28770,28769,1
2020-10-06,1200427,202041,28770,28770,0
2020-10-06,1200401,202041,28788,28770,18
2020-10-06,1200807,202041,28790,28788,2
2020-10-06,1200336,202041,28790,28790,0
2020-10-06,1200203,202041,28809,28790,19
2020-10-06,1200344,202041,28810,28809,1
2020-10-06,1200013,202041,28810,28810,0
2020-10-06,1200054,202041,28810,28810,0
2020-10-06,1200104,202041,28813,28810,3
2020-10-06,1200385,202041,28813,28813,0
2020-10-06,1200179,202041,28813,28813,0
2020-10-06,1200252,202041,28813,28813,0
2020-10-06,1200302,202041,28813,28813,0
2020-10-06,1200328,202041,28814,28813,1
2020-10-06,1200138,202041,28820,28814,6
2020-10-07,1200252,202041,28820,28820,0
2020-10-07,1200393,202041,28820,28820,0
2020-10-07,1200385,202041,28820,28820,0
2020-10-07,1200336,202041,28820,28820,0
2020-10-07,1200401,202041,28834,28820,14
2020-10-07,1200344,202041,28834,28834,0
2020-10-07,1200328,202041,28834,28834,0
2020-10-07,1200807,202041,28834,28834,0
2020-10-07,1200609,202041,28834,28834,0
2020-10-07,1200351,202041,28834,28834,0
2020-10-07,1200427,202041,28834,28834,0
2020-10-07,1200708,202041,28834,28834,0
2020-10-07,1200500,202041,28834,28834,0
2020-10-07,1200450,202041,28834,28834,0
2020-10-07,1200302,202041,28834,28834,0
2020-10-07,1200203,202041,28833,28834,-1
2020-10-07,1200179,202041,28833,28833,0
2020-10-07,1200138,202041,28833,28833,0
2020-10-07,1200104,202041,28833,28833,0
2020-10-07,1200054,202041,28833,28833,0
2020-10-07,1200013,202041,28833,28833,0
2020-10-07,1200435,202041,28833,28833,0
2020-10-08,1200351,202041,28833,28833,0
2020-10-08,1200344,202041,28833,28833,0
2020-10-08,1200328,202041,28833,28833,0
2020-10-08,1200302,202041,28833,28833,0
2020-10-08,1200609,202041,28833,28833,0
2020-10-08,1200203,202041,28834,28833,1
2020-10-08,1200179,202041,28834,28834,0
2020-10-08,1200138,202041,28836,28834,2
2020-10-08,1200336,202041,28836,28836,0
2020-10-08,1200252,202041,28836,28836,0
2020-10-08,1200385,202041,28836,28836,0
2020-10-08,1200013,202041,28836,28836,0
2020-10-08,1200393,202041,28836,28836,0
2020-10-08,1200054,202041,28836,28836,0
2020-10-08,1200104,202041,28836,28836,0
2020-10-08,1200708,202041,28836,28836,0
2020-10-08,1200450,202041,28836,28836,0
2020-10-08,1200807,202041,28836,28836,0
2020-10-08,1200435,202041,28836,28836,0
2020-10-08,1200427,202041,28836,28836,0
2020-10-08,1200401,202041,28849,28836,13
2020-10-08,1200500,202041,28849,28849,0
2020-10-09,1200344,202041,28855,28849,6
2020-10-09,1200013,202041,28860,28855,5
2020-10-09,1200104,202041,28860,28860,0
2020-10-09,1200138,202041,28860,28860,0
2020-10-09,1200179,202041,28860,28860,0
2020-10-09,1200203,202041,28863,28860,3
2020-10-09,1200252,202041,28864,28863,1
2020-10-09,1200302,202041,28868,28864,4
2020-10-09,1200328,202041,28869,28868,1
2020-10-09,1200435,202041,28869,28869,0
2020-10-09,1200351,202041,28879,28869,10
2020-10-09,1200708,202041,28913,28879,34
2020-10-09,1200609,202041,28946,28913,33
2020-10-09,1200450,202041,28946,28946,0
2020-10-09,1200500,202041,28960,28946,14
2020-10-09,1200385,202041,28961,28960,1
2020-10-09,1200427,202041,28969,28961,8
2020-10-09,1200401,202041,29009,28969,40
2020-10-09,1200054,202041,29019,29009,10
2020-10-09,1200393,202041,29019,29019,0
2020-10-09,1200807,202041,29020,29019,1
2020-10-09,1200336,202041,29032,29020,12
2020-10-10,1200302,202041,29032,29032,0
2020-10-10,1200252,202041,29032,29032,0
2020-10-10,1200203,202041,29032,29032,0
2020-10-10,1200179,202041,29032,29032,0
2020-10-10,1200328,202041,29032,29032,0
2020-10-10,1200104,202041,29032,29032,0
2020-10-10,1200054,202041,29032,29032,0
2020-10-10,1200013,202041,29033,29032,1
2020-10-10,1200344,202041,29033,29033,0
2020-10-10,1200138,202041,29033,29033,0
2020-10-10,1200385,202041,29033,29033,0
2020-10-10,1200336,202041,29033,29033,0
2020-10-10,1200807,202041,29033,29033,0
2020-10-10,1200401,202041,29045,29033,12
2020-10-10,1200708,202041,29045,29045,0
2020-10-10,1200609,202041,29045,29045,0
2020-10-10,1200450,202041,29045,29045,0
2020-10-10,1200351,202041,29046,29045,1
2020-10-10,1200435,202041,29046,29046,0
2020-10-10,1200427,202041,29046,29046,0
2020-10-10,1200393,202041,29046,29046,0
2020-10-10,1200500,202041,29046,29046,0
2020-10-11,1200708,202042,29046,29046,0
2020-10-11,1200609,202042,29046,29046,0
2020-10-11,1200450,202042,29046,29046,0
2020-10-11,1200500,202042,29046,29046,0
2020-10-11,1200435,202042,29046,29046,0
2020-10-11,1200427,202042,29046,29046,0
2020-10-11,1200401,202042,29062,29046,16
2020-10-11,1200393,202042,29062,29062,0
2020-10-11,1200252,202042,29062,29062,0
2020-10-11,1200351,202042,29063,29062,1
2020-10-11,1200807,202042,29063,29063,0
2020-10-11,1200138,202042,29063,29063,0
2020-10-11,1200203,202042,29064,29063,1
2020-10-11,1200328,202042,29064,29064,0
2020-10-11,1200302,202042,29065,29064,1
2020-10-11,1200179,202042,29065,29065,0
2020-10-11,1200336,202042,29065,29065,0
2020-10-11,1200104,202042,29065,29065,0
2020-10-11,1200054,202042,29065,29065,0
2020-10-11,1200013,202042,29065,29065,0
2020-10-11,1200344,202042,29065,29065,0
2020-10-11,1200385,202042,29065,29065,0
2020-10-12,1200385,202042,29065,29065,0
2020-10-12,1200708,202042,29065,29065,0
2020-10-12,1200450,202042,29065,29065,0
2020-10-12,1200500,202042,29065,29065,0
2020-10-12,1200435,202042,29065,29065,0
2020-10-12,1200427,202042,29065,29065,0
2020-10-12,1200401,202042,29078,29065,13
2020-10-12,1200393,202042,29078,29078,0
2020-10-12,1200807,202042,29078,29078,0
2020-10-12,1200203,202042,29078,29078,0
2020-10-12,1200336,202042,29078,29078,0
2020-10-12,1200344,202042,29078,29078,0
2020-10-12,1200013,202042,29078,29078,0
2020-10-12,1200054,202042,29078,29078,0
2020-10-12,1200104,202042,29078,29078,0
2020-10-12,1200138,202042,29078,29078,0
2020-10-12,1200351,202042,29078,29078,0
2020-10-12,1200609,202042,29078,29078,0
2020-10-12,1200252,202042,29078,29078,0
2020-10-12,1200302,202042,29078,29078,0
2020-10-12,1200328,202042,29078,29078,0
2020-10-12,1200179,202042,29078,29078,0
2020-10-13,1200427,202042,29077,29078,-1
2020-10-13,1200013,202042,29077,29077,0
2020-10-13,1200104,202042,29079,29077,2
2020-10-13,1200138,202042,29081,29079,2
2020-10-13,1200179,202042,29081,29081,0
2020-10-13,1200203,202042,29096,29081,15
2020-10-13,1200252,202042,29097,29096,1
2020-10-13,1200302,202042,29099,29097,2
2020-10-13,1200328,202042,29099,29099,0
2020-10-13,1200344,202042,29103,29099,4
2020-10-13,1200351,202042,29112,29103,9
2020-10-13,1200336,202042,29162,29112,50
2020-10-13,1200807,202042,29162,29162,0
2020-10-13,1200393,202042,29162,29162,0
2020-10-13,1200401,202042,29201,29162,39
2020-10-13,1200435,202042,29201,29201,0
2020-10-13,1200450,202042,29203,29201,2
2020-10-13,1200609,202042,29217,29203,14
2020-10-13,1200708,202042,29257,29217,40
2020-10-13,1200054,202042,29258,29257,1
2020-10-13,1200500,202042,29285,29258,27
2020-10-13,1200385,202042,29287,29285,2
2020-10-14,1200393,202042,29287,29287,0
2020-10-14,1200401,202042,29315,29287,28
2020-10-14,1200427,202042,29315,29315,0
2020-10-14,1200435,202042,29315,29315,0
2020-10-14,1200807,202042,29315,29315,0
2020-10-14,1200450,202042,29315,29315,0
2020-10-14,1200609,202042,29315,29315,0
2020-10-14,1200708,202042,29315,29315,0
2020-10-14,1200385,202042,29315,29315,0
2020-10-14,1200500,202042,29315,29315,0
2020-10-14,1200336,202042,29315,29315,0
2020-10-14,1200104,202042,29315,29315,0
2020-10-14,1200351,202042,29315,29315,0
2020-10-14,1200328,202042,29315,29315,0
2020-10-14,1200302,202042,29315,29315,0
2020-10-14,1200252,202042,29315,29315,0
2020-10-14,1200203,202042,29316,29315,1
2020-10-14,1200344,202042,29316,29316,0
2020-10-14,1200138,202042,29316,29316,0
2020-10-14,1200179,202042,29316,29316,0
2020-10-14,1200054,202042,29316,29316,0
2020-10-14,1200013,202042,29316,29316,0
2020-10-15,1200252,202042,29318,29316,2
2020-10-15,1200609,202042,29330,29318,12
2020-10-15,1200807,202042,29330,29330,0
2020-10-15,1200328,202042,29330,29330,0
2020-10-15,1200344,202042,29330,29330,0
2020-10-15,1200351,202042,29344,29330,14
2020-10-15,1200336,202042,29345,29344,1
2020-10-15,1200385,202042,29346,29345,1
2020-10-15,1200393,202042,29346,29346,0
2020-10-15,1200401,202042,29378,29346,32
2020-10-15,1200427,202042,29385,29378,7
2020-10-15,1200708,202042,29398,29385,13
2020-10-15,1200500,202042,29405,29398,7
2020-10-15,1200450,202042,29406,29405,1
2020-10-15,1200302,202042,29406,29406,0
2020-10-15,1200203,202042,29421,29406,15
2020-10-15,1200179,202042,29421,29421,0
2020-10-15,1200138,202042,29422,29421,1
2020-10-15,1200104,202042,29422,29422,0
2020-10-15,1200054,202042,29421,29422,-1
2020-10-15,1200013,202042,29421,29421,0
2020-10-15,1200435,202042,29421,29421,0
2020-10-16,1200401,202042,29460,29421,39
2020-10-16,1200427,202042,29469,29460,9
2020-10-16,1200435,202042,29469,29469,0
2020-10-16,1200500,202042,29490,29469,21
2020-10-16,1200393,202042,29491,29490,1
2020-10-16,1200450,202042,29492,29491,1
2020-10-16,1200609,202042,29492,29492,0
2020-10-16,1200708,202042,29537,29492,45
2020-10-16,1200138,202042,29538,29537,1
2020-10-16,1200203,202042,29552,29538,14
2020-10-16,1200807,202042,29552,29552,0
2020-10-16,1200385,202042,29552,29552,0
2020-10-16,1200336,202042,29555,29552,3
2020-10-16,1200351,202042,29560,29555,5
2020-10-16,1200344,202042,29560,29560,0
2020-10-16,1200328,202042,29560,29560,0
2020-10-16,1200302,202042,29562,29560,2
2020-10-16,1200252,202042,29562,29562,0
2020-10-16,1200179,202042,29562,29562,0
2020-10-16,1200104,202042,29563,29562,1
2020-10-16,1200054,202042,29612,29563,49
2020-10-16,1200013,202042,29613,29612,1
2020-10-17,1200807,202042,29613,29613,0
2020-10-17,1200401,202042,29648,29613,35
2020-10-17,1200427,202042,29653,29648,5
2020-10-17,1200435,202042,29653,29653,0
2020-10-17,1200336,202042,29662,29653,9
2020-10-17,1200450,202042,29662,29662,0
2020-10-17,1200609,202042,29662,29662,0
2020-10-17,1200708,202042,29666,29662,4
2020-10-17,1200393,202042,29666,29666,0
2020-10-17,1200500,202042,29678,29666,12
2020-10-17,1200385,202042,29678,29678,0
2020-10-17,1200351,202042,29684,29678,6
2020-10-17,1200344,202042,29685,29684,1
2020-10-17,1200054,202042,29687,29685,2
2020-10-17,1200104,202042,29687,29687,0
2020-10-17,1200138,202042,29689,29687,2
2020-10-17,1200179,202042,29689,29689,0
2020-10-17,1200013,202042,29690,29689,1
2020-10-17,1200252,202042,29692,29690,2
2020-10-17,1200302,202042,29699,29692,7
2020-10-17,1200328,202042,29699,29699,0
2020-10-17,1200203,202042,29708,29699,9
2020-10-18,1200807,202043,29708,29708,0
2020-10-18,1200302,202043,29708,29708,0
2020-10-18,1200609,202043,29708,29708,0
2020-10-18,1200252,202043,29708,29708,0
2020-10-18,1200500,202043,29708,29708,0
2020-10-18,1200435,202043,29708,29708,0
2020-10-18,1200427,202043,29708,29708,0
2020-10-18,1200401,202043,29730,29708,22
2020-10-18,1200393,202043,29730,29730,0
2020-10-18,1200385,202043,29730,29730,0
2020-10-18,1200450,202043,29730,29730,0
2020-10-18,1200351,202043,29730,29730,0
2020-10-18,1200013,202043,29730,29730,0
2020-10-18,1200054,202043,29730,29730,0
2020-10-18,1200104,202043,29732,29730,2
2020-10-18,1200138,202043,29732,29732,0
2020-10-18,1200336,202043,29732,29732,0
2020-10-18,1200203,202043,29733,29732,1
2020-10-18,1200708,202043,29733,29733,0
2020-10-18,1200328,202043,29733,29733,0
2020-10-18,1200344,202043,29733,29733,0
2020-10-18,1200179,202043,29733,29733,0
2020-10-19,1200328,202043,29733,29733,0
2020-10-19,1200344,202043,29733,29733,0
2020-10-19,1200013,202043,29738,29733,5
2020-10-19,1200054,202043,29738,29738,0
2020-10-19,1200104,202043,29738,29738,0
2020-10-19,1200138,202043,29738,29738,0
2020-10-19,1200179,202043,29738,29738,0
2020-10-19,1200203,202043,29741,29738,3
2020-10-19,1200252,202043,29742,29741,1
2020-10-19,1200302,202043,29742,29742,0
2020-10-19,1200336,202043,29742,29742,0
2020-10-19,1200351,202043,29742,29742,0
2020-10-19,1200385,202043,29742,29742,0
2020-10-19,1200393,202043,29742,29742,0
2020-10-19,1200708,202043,29742,29742,0
2020-10-19,1200609,202043,29742,29742,0
2020-10-19,1200450,202043,29744,29742,2
2020-10-19,1200435,202043,29744,29744,0
2020-10-19,1200427,202043,29745,29744,1
2020-10-19,1200401,202043,29780,29745,35
2020-10-19,1200807,202043,29780,29780,0
2020-10-19,1200500,202043,29780,29780,0
2020-10-20,1200385,202043,29780,29780,0
2020-10-20,1200609,202043,29780,29780,0
2020-10-20,1200450,202043,29781,29780,1
2020-10-20,1200708,202043,29794,29781,13
2020-10-20,1200435,202043,29794,29794,0
2020-10-20,1200427,202043,29794,29794,0
2020-10-20,1200401,202043,29820,29794,26
2020-10-20,1200393,202043,29820,29820,0
2020-10-20,1200807,202043,29820,29820,0
2020-10-20,1200344,202043,29823,29820,3
2020-10-20,1200500,202043,29857,29823,34
2020-10-20,1200138,202043,29859,29857,2
2020-10-20,1200328,202043,29859,29859,0
2020-10-20,1200013,202043,29859,29859,0
2020-10-20,1200054,202043,29865,29859,6
2020-10-20,1200104,202043,29866,29865,1
2020-10-20,1200351,202043,29867,29866,1
2020-10-20,1200179,202043,29868,29867,1
2020-10-20,1200252,202043,29868,29868,0
2020-10-20,1200302,202043,29868,29868,0
2020-10-20,1200203,202043,29875,29868,7
2020-10-20,1200336,202043,29880,29875,5
2020-10-21,1200807,202043,29880,29880,0
2020-10-21,1200393,202043,29881,29880,1
2020-10-21,1200401,202043,29908,29881,27
2020-10-21,1200427,202043,29908,29908,0
2020-10-21,1200203,202043,29923,29908,15
2020-10-21,1200450,202043,29923,29923,0
2020-10-21,1200708,202043,29928,29923,5
2020-10-21,1200385,202043,29929,29928,1
2020-10-21,1200435,202043,29929,29929,0
2020-10-21,1200336,202043,29931,29929,2
2020-10-21,1200500,202043,29935,29931,4
2020-10-21,1200344,202043,29939,29935,4
2020-10-21,1200328,202043,29939,29939,0
2020-10-21,1200302,202043,29939,29939,0
2020-10-21,1200252,202043,29939,29939,0
2020-10-21,1200609,202043,29939,29939,0
2020-10-21,1200179,202043,29939,29939,0
2020-10-21,1200138,202043,29940,29939,1
2020-10-21,1200104,202043,29940,29940,0
2020-10-21,1200054,202043,29940,29940,0
2020-10-21,1200013,202043,29940,29940,0
2020-10-21,1200351,202043,29940,29940,0
2020-10-22,1200302,202043,29942,29940,2
2020-10-22,1200252,202043,29942,29942,0
2020-10-22,1200203,202043,29945,29942,3
2020-10-22,1200179,202043,29945,29945,0
2020-10-22,1200344,202043,29947,29945,2
2020-10-22,1200104,202043,29953,29947,6
2020-10-22,1200054,202043,29954,29953,1
2020-10-22,1200013,202043,29954,29954,0
2020-10-22,1200328,202043,29954,29954,0
2020-10-22,1200138,202043,29956,29954,2
2020-10-22,1200385,202043,29956,29956,0
2020-10-22,1200401,202043,30014,29956,58
2020-10-22,1200807,202043,30014,30014,0
2020-10-22,1200393,202043,30014,30014,0
2020-10-22,1200435,202043,30014,30014,0
2020-10-22,1200500,202043,30020,30014,6
2020-10-22,1200450,202043,30021,30020,1
2020-10-22,1200609,202043,30021,30021,0
2020-10-22,1200708,202043,30028,30021,7
2020-10-22,1200427,202043,30028,30028,0
2020-10-22,1200336,202043,30042,30028,14
2020-10-22,1200351,202043,30043,30042,1
2020-10-23,1200427,202043,30044,30043,1
2020-10-23,1200393,202043,30044,30044,0
2020-10-23,1200401,202043,30088,30044,44
2020-10-23,1200435,202043,30088,30088,0
2020-10-23,1200807,202043,30088,30088,0
2020-10-23,1200450,202043,30088,30088,0
2020-10-23,1200609,202043,30087,30088,-1
2020-10-23,1200708,202043,30102,30087,15
2020-10-23,1200252,202043,30102,30102,0
2020-10-23,1200500,202043,30108,30102,6
2020-10-23,1200336,202043,30118,30108,10
2020-10-23,1200138,202043,30120,30118,2
2020-10-23,1200351,202043,30120,30120,0
2020-10-23,1200344,202043,30120,30120,0
2020-10-23,1200328,202043,30120,30120,0
2020-10-23,1200302,202043,30125,30120,5
2020-10-23,1200179,202043,30125,30125,0
2020-10-23,1200203,202043,30130,30125,5
2020-10-23,1200104,202043,30131,30130,1
2020-10-23,1200054,202043,30132,30131,1
2020-10-23,1200013,202043,30136,30132,4
2020-10-23,1200385,202043,30136,30136,0
2020-10-24,1200393,202043,30136,30136,0
2020-10-24,1200385,202043,30136,30136,0
2020-10-24,1200302,202043,30138,30136,2
2020-10-24,1200328,202043,30138,30138,0
2020-10-24,1200344,202043,30139,30138,1
2020-10-24,1200351,202043,30143,30139,4
2020-10-24,1200336,202043,30152,30143,9
2020-10-24,1200609,202043,30162,30152,10
2020-10-24,1200252,202043,30163,30162,1
2020-10-24,1200401,202043,30200,30163,37
2020-10-24,1200427,202043,30200,30200,0
2020-10-24,1200708,202043,30209,30200,9
2020-10-24,1200500,202043,30212,30209,3
2020-10-24,1200450,202043,30212,30212,0
2020-10-24,1200807,202043,30212,30212,0
2020-10-24,1200203,202043,30219,30212,7
2020-10-24,1200179,202043,30219,30219,0
2020-10-24,1200138,202043,30220,30219,1
2020-10-24,1200104,202043,30229,30220,9
2020-10-24,1200054,202043,30230,30229,1
2020-10-24,1200013,202043,30232,30230,2
2020-10-24,1200435,202043,30232,30232,0
2020-10-25,1200351,202044,30232,30232,0
2020-10-25,1200344,202044,30232,30232,0
2020-10-25,1200328,202044,30232,30232,0
2020-10-25,1200302,202044,30234,30232,2
2020-10-25,1200336,202044,30234,30234,0
2020-10-25,1200203,202044,30234,30234,0
2020-10-25,1200179,202044,30234,30234,0
2020-10-25,1200138,202044,30235,30234,1
2020-10-25,1200609,202044,30235,30235,0
2020-10-25,1200252,202044,30235,30235,0
2020-10-25,1200385,202044,30237,30235,2
2020-10-25,1200054,202044,30237,30237,0
2020-10-25,1200393,202044,30237,30237,0
2020-10-25,1200401,202044,30318,30237,81
2020-10-25,1200427,202044,30318,30318,0
2020-10-25,1200435,202044,30318,30318,0
2020-10-25,1200500,202044,30318,30318,0
2020-10-25,1200450,202044,30318,30318,0
2020-10-25,1200708,202044,30318,30318,0
2020-10-25,1200104,202044,30318,30318,0
2020-10-25,1200013,202044,30318,30318,0
2020-10-25,1200807,202044,30319,30318,1
2020-10-26,1200328,202044,30319,30319,0
2020-10-26,1200302,202044,30319,30319,0
2020-10-26,1200252,202044,30319,30319,0
2020-10-26,1200203,202044,30321,30319,2
2020-10-26,1200435,202044,30321,30321,0
2020-10-26,1200138,202044,30321,30321,0
2020-10-26,1200104,202044,30323,30321,2
2020-10-26,1200013,202044,30322,30323,-1
2020-10-26,1200344,202044,30322,30322,0
2020-10-26,1200179,202044,30322,30322,0
2020-10-26,1200351,202044,30322,30322,0
2020-10-26,1200807,202044,30322,30322,0
2020-10-26,1200708,202044,30322,30322,0
2020-10-26,1200393,202044,30322,30322,0
2020-10-26,1200054,202044,30322,30322,0
2020-10-26,1200401,202044,30331,30322,9
2020-10-26,1200427,202044,30331,30331,0
2020-10-26,1200336,202044,30331,30331,0
2020-10-26,1200500,202044,30332,30331,1
2020-10-26,1200450,202044,30332,30332,0
2020-10-26,1200609,202044,30332,30332,0
2020-10-26,1200385,202044,30332,30332,0
2020-10-27,1200302,202044,30332,30332,0
2020-10-27,1200609,202044,30342,30332,10
2020-10-27,1200450,202044,30343,30342,1
2020-10-27,1200054,202044,30343,30343,0
2020-10-27,1200104,202044,30342,30343,-1
2020-10-27,1200138,202044,30345,30342,3
2020-10-27,1200179,202044,30345,30345,0
2020-10-27,1200203,202044,30349,30345,4
2020-10-27,1200252,202044,30351,30349,2
2020-10-27,1200013,202044,30351,30351,0
2020-10-27,1200328,202044,30351,30351,0
2020-10-27,1200351,202044,30363,30351,12
2020-10-27,1200336,202044,30362,30363,-1
2020-10-27,1200385,202044,30362,30362,0
2020-10-27,1200807,202044,30363,30362,1
2020-10-27,1200393,202044,30364,30363,1
2020-10-27,1200401,202044,30381,30364,17
2020-10-27,1200427,202044,30381,30381,0
2020-10-27,1200500,202044,30383,30381,2
2020-10-27,1200708,202044,30389,30383,6
2020-10-27,1200435,202044,30389,30389,0
2020-10-27,1200344,202044,30395,30389,6
2020-10-28,1200302,202044,30395,30395,0
2020-10-28,1200252,202044,30396,30395,1
2020-10-28,1200203,202044,30402,30396,6
2020-10-28,1200179,202044,30402,30402,0
2020-10-28,1200328,202044,30402,30402,0
2020-10-28,1200104,202044,30402,30402,0
2020-10-28,1200054,202044,30403,30402,1
2020-10-28,1200013,202044,30404,30403,1
2020-10-28,1200385,202044,30404,30404,0
2020-10-28,1200138,202044,30404,30404,0
2020-10-28,1200344,202044,30405,30404,1
2020-10-28,1200336,202044,30408,30405,3
2020-10-28,1200708,202044,30412,30408,4
2020-10-28,1200807,202044,30412,30412,0
2020-10-28,1200393,202044,30412,30412,0
2020-10-28,1200401,202044,30545,30412,133
2020-10-28,1200427,202044,30545,30545,0
2020-10-28,1200351,202044,30546,30545,1
2020-10-28,1200500,202044,30551,30546,5
2020-10-28,1200450,202044,30552,30551,1
2020-10-28,1200609,202044,30560,30552,8
2020-10-28,1200435,202044,30560,30560,0
2020-10-29,1200351,202044,30573,30560,13
2020-10-29,1200013,202044,30574,30573,1
2020-10-29,1200054,202044,30574,30574,0
2020-10-29,1200104,202044,30576,30574,2
2020-10-29,1200138,202044,30577,30576,1
2020-10-29,1200179,202044,30577,30577,0
2020-10-29,1200203,202044,30583,30577,6
2020-10-29,1200302,202044,30583,30583,0
2020-10-29,1200344,202044,30585,30583,2
2020-10-29,1200385,202044,30585,30585,0
2020-10-29,1200328,202044,30585,30585,0
2020-10-29,1200807,202044,30585,30585,0
2020-10-29,1200252,202044,30585,30585,0
2020-10-29,1200427,202044,30585,30585,0
2020-10-29,1200708,202044,30586,30585,1
2020-10-29,1200609,202044,30587,30586,1
2020-10-29,1200336,202044,30594,30587,7
2020-10-29,1200500,202044,30599,30594,5
2020-10-29,1200435,202044,30599,30599,0
2020-10-29,1200401,202044,30653,30599,54
2020-10-29,1200393,202044,30653,30653,0
2020-10-29,1200450,202044,30653,30653,0
2020-10-30,1200054,202044,30653,30653,0
2020-10-30,1200708,202044,30657,30653,4
2020-10-30,1200609,202044,30666,30657,9
2020-10-30,1200450,202044,30671,30666,5
2020-10-30,1200500,202044,30673,30671,2
2020-10-30,1200435,202044,30673,30673,0
2020-10-30,1200427,202044,30673,30673,0
2020-10-30,1200401,202044,30760,30673,87
2020-10-30,1200393,202044,30760,30760,0
2020-10-30,1200807,202044,30762,30760,2
2020-10-30,1200336,202044,30763,30762,1
2020-10-30,1200351,202044,30762,30763,-1
2020-10-30,1200252,202044,30763,30762,1
2020-10-30,1200344,202044,30765,30763,2
2020-10-30,1200328,202044,30765,30765,0
2020-10-30,1200302,202044,30765,30765,0
2020-10-30,1200179,202044,30765,30765,0
2020-10-30,1200385,202044,30768,30765,3
2020-10-30,1200138,202044,30769,30768,1
2020-10-30,1200104,202044,30770,30769,1
2020-10-30,1200013,202044,30770,30770,0
2020-10-30,1200203,202044,30773,30770,3
2020-10-31,1200427,202044,30775,30773,2
2020-10-31,1200807,202044,30775,30775,0
2020-10-31,1200328,202044,30775,30775,0
2020-10-31,1200344,202044,30775,30775,0
2020-10-31,1200351,202044,30775,30775,0
2020-10-31,1200336,202044,30800,30775,25
2020-10-31,1200385,202044,30800,30800,0
2020-10-31,1200393,202044,30800,30800,0
2020-10-31,1200252,202044,30800,30800,0
2020-10-31,1200401,202044,30810,30800,10
2020-10-31,1200609,202044,30810,30810,0
2020-10-31,1200435,202044,30810,30810,0
2020-10-31,1200450,202044,30810,30810,0
2020-10-31,1200302,202044,30810,30810,0
2020-10-31,1200203,202044,30811,30810,1
2020-10-31,1200179,202044,30811,30811,0
2020-10-31,1200138,202044,30811,30811,0
2020-10-31,1200104,202044,30811,30811,0
2020-10-31,1200054,202044,30811,30811,0
2020-10-31,1200013,202044,30811,30811,0
2020-10-31,1200708,202044,30811,30811,0
2020-10-31,1200500,202044,30811,30811,0
2020-11-01,1200351,202045,30811,30811,0
2020-11-01,1200344,202045,30811,30811,0
2020-11-01,1200328,202045,30811,30811,0
2020-11-01,1200302,202045,30816,30811,5
2020-11-01,1200393,202045,30817,30816,1
2020-11-01,1200203,202045,30821,30817,4
2020-11-01,1200179,202045,30821,30821,0
2020-11-01,1200401,202045,30964,30821,143
2020-11-01,1200336,202045,30964,30964,0
2020-11-01,1200252,202045,30965,30964,1
2020-11-01,1200385,202045,30965,30965,0
2020-11-01,1200807,202045,30965,30965,0
2020-11-01,1200708,202045,30965,30965,0
2020-11-01,1200054,202045,30965,30965,0
2020-11-01,1200104,202045,30965,30965,0
2020-11-01,1200435,202045,30965,30965,0
2020-11-01,1200427,202045,30965,30965,0
2020-11-01,1200013,202045,30965,30965,0
2020-11-01,1200500,202045,30965,30965,0
2020-11-01,1200450,202045,30966,30965,1
2020-11-01,1200609,202045,30966,30966,0
2020-11-01,1200138,202045,30966,30966,0
2020-11-02,1200351,202045,30966,30966,0
2020-11-02,1200450,202045,30966,30966,0
2020-11-02,1200401,202045,30967,30966,1
2020-11-02,1200435,202045,30967,30967,0
2020-11-02,1200708,202045,30967,30967,0
2020-11-02,1200427,202045,30967,30967,0
2020-11-02,1200609,202045,30967,30967,0
2020-11-02,1200500,202045,30967,30967,0
2020-11-02,1200336,202045,30967,30967,0
2020-11-02,1200013,202045,30967,30967,0
2020-11-02,1200344,202045,30967,30967,0
2020-11-02,1200385,202045,30967,30967,0
2020-11-02,1200302,202045,30967,30967,0
2020-11-02,1200252,202045,30967,30967,0
2020-11-02,1200203,202045,30969,30967,2
2020-11-02,1200179,202045,30969,30969,0
2020-11-02,1200138,202045,30969,30969,0
2020-11-02,1200807,202045,30969,30969,0
2020-11-02,1200104,202045,30969,30969,0
2020-11-02,1200054,202045,30969,30969,0
2020-11-02,1200393,202045,30969,30969,0
2020-11-02,1200328,202045,30969,30969,0
2020-11-03,1200401,202045,30971,30969,2
2020-11-03,1200427,202045,30973,30971,2
2020-11-03,1200435,202045,30973,30973,0
2020-11-03,1200500,202045,30973,30973,0
2020-11-03,1200393,202045,30973,30973,0
2020-11-03,1200609,202045,30973,30973,0
2020-11-03,1200708,202045,30973,30973,0
2020-11-03,1200351,202045,30973,30973,0
2020-11-03,1200344,202045,30973,30973,0
2020-11-03,1200450,202045,30973,30973,0
2020-11-03,1200807,202045,30972,30973,-1
2020-11-03,1200385,202045,30972,30972,0
2020-11-03,1200336,202045,30974,30972,2
2020-11-03,1200302,202045,30974,30974,0
2020-11-03,1200328,202045,30974,30974,0
2020-11-03,1200252,202045,30974,30974,0
2020-11-03,1200203,202045,30976,30974,2
2020-11-03,1200179,202045,30976,30976,0
2020-11-03,1200138,202045,30976,30976,0
2020-11-03,1200104,202045,30977,30976,1
2020-11-03,1200054,202045,30977,30977,0
2020-11-03,1200013,202045,30977,30977,0
2020-11-04,1200385,202045,30978,30977,1
2020-11-04,1200351,202045,30981,30978,3
2020-11-04,1200344,202045,30981,30981,0
2020-11-04,1200328,202045,30981,30981,0
2020-11-04,1200609,202045,30982,30981,1
2020-11-04,1200252,202045,30982,30982,0
2020-11-04,1200203,202045,30987,30982,5
2020-11-04,1200336,202045,30987,30987,0
2020-11-04,1200450,202045,30987,30987,0
2020-11-04,1200302,202045,30987,30987,0
2020-11-04,1200708,202045,30991,30987,4
2020-11-04,1200393,202045,30990,30991,-1
2020-11-04,1200401,202045,31222,30990,232
2020-11-04,1200138,202045,31222,31222,0
2020-11-04,1200104,202045,31222,31222,0
2020-11-04,1200013,202045,31222,31222,0
2020-11-04,1200054,202045,31223,31222,1
2020-11-04,1200179,202045,31224,31223,1
2020-11-04,1200500,202045,31231,31224,7
2020-11-04,1200435,202045,31231,31231,0
2020-11-04,1200427,202045,31233,31231,2
2020-11-04,1200807,202045,31233,31233,0
2020-11-05,1200336,202045,31233,31233,0
2020-11-05,1200351,202045,31233,31233,0
2020-11-05,1200138,202045,31233,31233,0
2020-11-05,1200179,202045,31233,31233,0
2020-11-05,1200203,202045,31233,31233,0
2020-11-05,1200252,202045,31233,31233,0
2020-11-05,1200302,202045,31233,31233,0
2020-11-05,1200328,202045,31233,31233,0
2020-11-05,1200344,202045,31233,31233,0
2020-11-05,1200054,202045,31233,31233,0
2020-11-05,1200500,202045,31233,31233,0
2020-11-05,1200807,202045,31233,31233,0
2020-11-05,1200427,202045,31237,31233,4
2020-11-05,1200401,202045,31254,31237,17
2020-11-05,1200013,202045,31254,31254,0
2020-11-05,1200104,202045,31256,31254,2
2020-11-05,1200385,202045,31257,31256,1
2020-11-05,1200393,202045,31257,31257,0
2020-11-05,1200450,202045,31257,31257,0
2020-11-05,1200609,202045,31258,31257,1
2020-11-05,1200708,202045,31263,31258,5
2020-11-05,1200435,202045,31263,31263,0
2020-11-06,1200328,202045,31268,31263,5
2020-11-06,1200344,202045,31268,31268,0
2020-11-06,1200013,202045,31268,31268,0
2020-11-06,1200054,202045,31276,31268,8
2020-11-06,1200104,202045,31276,31276,0
2020-11-06,1200138,202045,31276,31276,0
2020-11-06,1200179,202045,31276,31276,0
2020-11-06,1200203,202045,31287,31276,11
2020-11-06,1200252,202045,31288,31287,1
2020-11-06,1200302,202045,31296,31288,8
2020-11-06,1200336,202045,31296,31296,0
2020-11-06,1200351,202045,31297,31296,1
2020-11-06,1200807,202045,31298,31297,1
2020-11-06,1200401,202045,31318,31298,20
2020-11-06,1200708,202045,31333,31318,15
2020-11-06,1200609,202045,31333,31333,0
2020-11-06,1200450,202045,31337,31333,4
2020-11-06,1200385,202045,31337,31337,0
2020-11-06,1200435,202045,31337,31337,0
2020-11-06,1200427,202045,31338,31337,1
2020-11-06,1200393,202045,31338,31338,0
2020-11-06,1200500,202045,31341,31338,3
2020-11-07,1200302,202045,31341,31341,0
2020-11-07,1200609,202045,31347,31341,6
2020-11-07,1200450,202045,31347,31347,0
2020-11-07,1200500,202045,31356,31347,9
2020-11-07,1200435,202045,31356,31356,0
2020-11-07,1200427,202045,31356,31356,0
2020-11-07,1200401,202045,31554,31356,198
2020-11-07,1200393,202045,31554,31554,0
2020-11-07,1200807,202045,31555,31554,1
2020-11-07,1200351,202045,31557,31555,2
2020-11-07,1200708,202045,31563,31557,6
2020-11-07,1200138,202045,31569,31563,6
2020-11-07,1200203,202045,31572,31569,3
2020-11-07,1200328,202045,31572,31572,0
2020-11-07,1200252,202045,31574,31572,2
2020-11-07,1200179,202045,31574,31574,0
2020-11-07,1200336,202045,31574,31574,0
2020-11-07,1200104,202045,31576,31574,2
2020-11-07,1200054,202045,31578,31576,2
2020-11-07,1200013,202045,31584,31578,6
2020-11-07,1200344,202045,31590,31584,6
2020-11-07,1200385,202045,31590,31590,0
2020-11-08,1200385,202046,31592,31590,2
2020-11-08,1200708,202046,31592,31592,0
2020-11-08,1200450,202046,31597,31592,5
2020-11-08,1200500,202046,31597,31597,0
2020-11-08,1200435,202046,31597,31597,0
2020-11-08,1200427,202046,31597,31597,0
2020-11-08,1200401,202046,31715,31597,118
2020-11-08,1200393,202046,31715,31715,0
2020-11-08,1200807,202046,31716,31715,1
2020-11-08,1200336,202046,31716,31716,0
2020-11-08,1200203,202046,31717,31716,1
2020-11-08,1200344,202046,31717,31717,0
2020-11-08,1200013,202046,31717,31717,0
2020-11-08,1200054,202046,31717,31717,0
2020-11-08,1200104,202046,31717,31717,0
2020-11-08,1200138,202046,31719,31717,2
2020-11-08,1200351,202046,31719,31719,0
2020-11-08,1200609,202046,31719,31719,0
2020-11-08,1200252,202046,31721,31719,2
2020-11-08,1200302,202046,31722,31721,1
2020-11-08,1200328,202046,31722,31722,0
2020-11-08,1200179,202046,31722,31722,0
2020-11-09,1200385,202046,31722,31722,0
2020-11-09,1200013,202046,31721,31722,-1
2020-11-09,1200054,202046,31723,31721,2
2020-11-09,1200104,202046,31725,31723,2
2020-11-09,1200138,202046,31725,31725,0
2020-11-09,1200179,202046,31725,31725,0
2020-11-09,1200203,202046,31726,31725,1
2020-11-09,1200302,202046,31726,31726,0
2020-11-09,1200328,202046,31726,31726,0
2020-11-09,1200344,202046,31726,31726,0
2020-11-09,1200351,202046,31727,31726,1
2020-11-09,1200336,202046,31728,31727,1
2020-11-09,1200393,202046,31728,31728,0
2020-11-09,1200401,202046,31794,31728,66
2020-11-09,1200435,202046,31794,31794,0
2020-11-09,1200500,202046,31797,31794,3
2020-11-09,1200450,202046,31797,31797,0
2020-11-09,1200609,202046,31798,31797,1
2020-11-09,1200708,202046,31803,31798,5
2020-11-09,1200427,202046,31803,31803,0
2020-11-09,1200252,202046,31803,31803,0
2020-11-09,1200807,202046,31803,31803,0
2020-11-10,1200393,202046,31803,31803,0
2020-11-10,1200401,202046,31912,31803,109
2020-11-10,1200427,202046,31912,31912,0
2020-11-10,1200435,202046,31912,31912,0
2020-11-10,1200807,202046,31913,31912,1
2020-11-10,1200450,202046,31913,31913,0
2020-11-10,1200609,202046,31913,31913,0
2020-11-10,1200708,202046,31914,31913,1
2020-11-10,1200500,202046,31914,31914,0
2020-11-10,1200054,202046,31914,31914,0
2020-11-10,1200336,202046,31914,31914,0
2020-11-10,1200179,202046,31914,31914,0
2020-11-10,1200344,202046,31916,31914,2
2020-11-10,1200328,202046,31916,31916,0
2020-11-10,1200302,202046,31917,31916,1
2020-11-10,1200203,202046,31932,31917,15
2020-11-10,1200252,202046,31931,31932,-1
2020-11-10,1200138,202046,31932,31931,1
2020-11-10,1200104,202046,31937,31932,5
2020-11-10,1200013,202046,31937,31937,0
2020-11-10,1200351,202046,31940,31937,3
2020-11-10,1200385,202046,31941,31940,1
2020-11-11,1200401,202046,32061,31941,120
2020-11-11,1200385,202046,32061,32061,0
2020-11-11,1200302,202046,32066,32061,5
2020-11-11,1200328,202046,32066,32066,0
2020-11-11,1200344,202046,32067,32066,1
2020-11-11,1200351,202046,32078,32067,11
2020-11-11,1200336,202046,32079,32078,1
2020-11-11,1200609,202046,32079,32079,0
2020-11-11,1200252,202046,32079,32079,0
2020-11-11,1200393,202046,32079,32079,0
2020-11-11,1200427,202046,32087,32079,8
2020-11-11,1200435,202046,32087,32087,0
2020-11-11,1200500,202046,32096,32087,9
2020-11-11,1200450,202046,32097,32096,1
2020-11-11,1200807,202046,32102,32097,5
2020-11-11,1200203,202046,32120,32102,18
2020-11-11,1200179,202046,32121,32120,1
2020-11-11,1200138,202046,32122,32121,1
2020-11-11,1200104,202046,32122,32122,0
2020-11-11,1200054,202046,32122,32122,0
2020-11-11,1200013,202046,32122,32122,0
2020-11-11,1200708,202046,32128,32122,6
2020-11-12,1200351,202046,32131,32128,3
2020-11-12,1200344,202046,32132,32131,1
2020-11-12,1200328,202046,32135,32132,3
2020-11-12,1200302,202046,32138,32135,3
2020-11-12,1200609,202046,32138,32138,0
2020-11-12,1200203,202046,32145,32138,7
2020-11-12,1200179,202046,32145,32145,0
2020-11-12,1200138,202046,32155,32145,10
2020-11-12,1200336,202046,32187,32155,32
2020-11-12,1200252,202046,32189,32187,2
2020-11-12,1200385,202046,32189,32189,0
2020-11-12,1200807,202046,32189,32189,0
2020-11-12,1200393,202046,32190,32189,1
2020-11-12,1200401,202046,32484,32190,294
2020-11-12,1200427,202046,32488,32484,4
2020-11-12,1200435,202046,32489,32488,1
2020-11-12,1200500,202046,32500,32489,11
2020-11-12,1200450,202046,32503,32500,3
2020-11-12,1200708,202046,32527,32503,24
2020-11-12,1200104,202046,32530,32527,3
2020-11-12,1200013,202046,32530,32530,0
2020-11-12,1200054,202046,32530,32530,0
2020-11-13,1200328,202046,32530,32530,0
2020-11-13,1200302,202046,32532,32530,2
2020-11-13,1200252,202046,32532,32532,0
2020-11-13,1200203,202046,32532,32532,0
2020-11-13,1200435,202046,32532,32532,0
2020-11-13,1200138,202046,32533,32532,1
2020-11-13,1200104,202046,32535,32533,2
2020-11-13,1200013,202046,32535,32535,0
2020-11-13,1200344,202046,32535,32535,0
2020-11-13,1200179,202046,32535,32535,0
2020-11-13,1200351,202046,32535,32535,0
2020-11-13,1200336,202046,32535,32535,0
2020-11-13,1200708,202046,32546,32535,11
2020-11-13,1200393,202046,32546,32546,0
2020-11-13,1200054,202046,32547,32546,1
2020-11-13,1200401,202046,32673,32547,126
2020-11-13,1200427,202046,32673,32673,0
2020-11-13,1200807,202046,32673,32673,0
2020-11-13,1200500,202046,32674,32673,1
2020-11-13,1200450,202046,32676,32674,2
2020-11-13,1200609,202046,32676,32676,0
2020-11-13,1200385,202046,32676,32676,0
2020-11-14,1200302,202046,32681,32676,5
2020-11-14,1200609,202046,32681,32681,0
2020-11-14,1200450,202046,32681,32681,0
2020-11-14,1200054,202046,32681,32681,0
2020-11-14,1200104,202046,32682,32681,1
2020-11-14,1200138,202046,32682,32682,0
2020-11-14,1200179,202046,32683,32682,1
2020-11-14,1200203,202046,32692,32683,9
2020-11-14,1200252,202046,32692,32692,0
2020-11-14,1200328,202046,32692,32692,0
2020-11-14,1200013,202046,32693,32692,1
2020-11-14,1200351,202046,32697,32693,4
2020-11-14,1200435,202046,32697,32697,0
2020-11-14,1200708,202046,32710,32697,13
2020-11-14,1200500,202046,32725,32710,15
2020-11-14,1200427,202046,32725,32725,0
2020-11-14,1200344,202046,32726,32725,1
2020-11-14,1200393,202046,32726,32726,0
2020-11-14,1200807,202046,32730,32726,4
2020-11-14,1200385,202046,32730,32730,0
2020-11-14,1200336,202046,32730,32730,0
2020-11-14,1200401,202046,33006,32730,276
2020-11-15,1200328,202047,33006,33006,0
2020-11-15,1200385,202047,33008,33006,2
2020-11-15,1200013,202047,33008,33008,0
2020-11-15,1200054,202047,33008,33008,0
2020-11-15,1200104,202047,33008,33008,0
2020-11-15,1200138,202047,33010,33008,2
2020-11-15,1200179,202047,33011,33010,1
2020-11-15,1200203,202047,33013,33011,2
2020-11-15,1200252,202047,33013,33013,0
2020-11-15,1200302,202047,33013,33013,0
2020-11-15,1200344,202047,33013,33013,0
2020-11-15,1200351,202047,33013,33013,0
2020-11-15,1200708,202047,33013,33013,0
2020-11-15,1200807,202047,33014,33013,1
2020-11-15,1200393,202047,33014,33014,0
2020-11-15,1200401,202047,33168,33014,154
2020-11-15,1200427,202047,33168,33168,0
2020-11-15,1200336,202047,33168,33168,0
2020-11-15,1200500,202047,33168,33168,0
2020-11-15,1200450,202047,33171,33168,3
2020-11-15,1200609,202047,33171,33171,0
2020-11-15,1200435,202047,33171,33171,0
2020-11-16,1200328,202047,33171,33171,0
2020-11-16,1200013,202047,33171,33171,0
2020-11-16,1200054,202047,33171,33171,0
2020-11-16,1200104,202047,33174,33171,3
2020-11-16,1200138,202047,33174,33174,0
2020-11-16,1200179,202047,33174,33174,0
2020-11-16,1200203,202047,33177,33174,3
2020-11-16,1200252,202047,33180,33177,3
2020-11-16,1200302,202047,33180,33180,0
2020-11-16,1200385,202047,33180,33180,0
2020-11-16,1200344,202047,33180,33180,0
2020-11-16,1200807,202047,33182,33180,2
2020-11-16,1200336,202047,33182,33182,0
2020-11-16,1200427,202047,33182,33182,0
2020-11-16,1200708,202047,33182,33182,0
2020-11-16,1200609,202047,33182,33182,0
2020-11-16,1200351,202047,33182,33182,0
2020-11-16,1200500,202047,33182,33182,0
2020-11-16,1200435,202047,33182,33182,0
2020-11-16,1200401,202047,33309,33182,127
2020-11-16,1200393,202047,33309,33309,0
2020-11-16,1200450,202047,33310,33309,1
2020-11-17,1200252,202047,33310,33310,0
2020-11-17,1200708,202047,33313,33310,3
2020-11-17,1200609,202047,33314,33313,1
2020-11-17,1200450,202047,33314,33314,0
2020-11-17,1200500,202047,33325,33314,11
2020-11-17,1200435,202047,33325,33325,0
2020-11-17,1200427,202047,33326,33325,1
2020-11-17,1200401,202047,33474,33326,148
2020-11-17,1200393,202047,33474,33474,0
2020-11-17,1200336,202047,33474,33474,0
2020-11-17,1200807,202047,33473,33474,-1
2020-11-17,1200351,202047,33474,33473,1
2020-11-17,1200203,202047,33479,33474,5
2020-11-17,1200344,202047,33479,33479,0
2020-11-17,1200328,202047,33488,33479,9
2020-11-17,1200302,202047,33488,33488,0
2020-11-17,1200138,202047,33488,33488,0
2020-11-17,1200385,202047,33489,33488,1
2020-11-17,1200104,202047,33490,33489,1
2020-11-17,1200054,202047,33490,33490,0
2020-11-17,1200013,202047,33490,33490,0
2020-11-17,1200179,202047,33490,33490,0
2020-11-18,1200427,202047,33490,33490,0
2020-11-18,1200807,202047,33490,33490,0
2020-11-18,1200328,202047,33490,33490,0
2020-11-18,1200344,202047,33491,33490,1
2020-11-18,1200351,202047,33494,33491,3
2020-11-18,1200336,202047,33494,33494,0
2020-11-18,1200385,202047,33496,33494,2
2020-11-18,1200393,202047,33496,33496,0
2020-11-18,1200252,202047,33496,33496,0
2020-11-18,1200401,202047,33719,33496,223
2020-11-18,1200609,202047,33719,33719,0
2020-11-18,1200435,202047,33719,33719,0
2020-11-18,1200450,202047,33719,33719,0
2020-11-18,1200302,202047,33724,33719,5
2020-11-18,1200203,202047,33728,33724,4
2020-11-18,1200179,202047,33728,33728,0
2020-11-18,1200138,202047,33728,33728,0
2020-11-18,1200104,202047,33728,33728,0
2020-11-18,1200054,202047,33731,33728,3
2020-11-18,1200013,202047,33731,33731,0
2020-11-18,1200708,202047,33730,33731,-1
2020-11-18,1200500,202047,33740,33730,10
2020-11-19,1200401,202047,33924,33740,184
2020-11-19,1200427,202047,33924,33924,0
2020-11-19,1200435,202047,33924,33924,0
2020-11-19,1200500,202047,33943,33924,19
2020-11-19,1200138,202047,33943,33943,0
2020-11-19,1200450,202047,33944,33943,1
2020-11-19,1200609,202047,33945,33944,1
2020-11-19,1200708,202047,33949,33945,4
2020-11-19,1200393,202047,33949,33949,0
2020-11-19,1200203,202047,33966,33949,17
2020-11-19,1200385,202047,33967,33966,1
2020-11-19,1200344,202047,33972,33967,5
2020-11-19,1200336,202047,33988,33972,16
2020-11-19,1200054,202047,33988,33988,0
2020-11-19,1200104,202047,33991,33988,3
2020-11-19,1200179,202047,33991,33991,0
2020-11-19,1200252,202047,33991,33991,0
2020-11-19,1200013,202047,33991,33991,0
2020-11-19,1200328,202047,33991,33991,0
2020-11-19,1200807,202047,33991,33991,0
2020-11-19,1200351,202047,33991,33991,0
2020-11-19,1200302,202047,33991,33991,0
2020-11-20,1200807,202047,34001,33991,10
2020-11-20,1200336,202047,34013,34001,12
2020-11-20,1200708,202047,34024,34013,11
2020-11-20,1200609,202047,34034,34024,10
2020-11-20,1200450,202047,34036,34034,2
2020-11-20,1200500,202047,34048,34036,12
2020-11-20,1200435,202047,34048,34048,0
2020-11-20,1200427,202047,34048,34048,0
2020-11-20,1200401,202047,34199,34048,151
2020-11-20,1200393,202047,34199,34199,0
2020-11-20,1200385,202047,34210,34199,11
2020-11-20,1200013,202047,34215,34210,5
2020-11-20,1200344,202047,34222,34215,7
2020-11-20,1200328,202047,34222,34222,0
2020-11-20,1200302,202047,34238,34222,16
2020-11-20,1200252,202047,34243,34238,5
2020-11-20,1200203,202047,34250,34243,7
2020-11-20,1200179,202047,34253,34250,3
2020-11-20,1200138,202047,34253,34253,0
2020-11-20,1200104,202047,34257,34253,4
2020-11-20,1200054,202047,34261,34257,4
2020-11-20,1200351,202047,34261,34261,0
2020-11-21,1200393,202047,34261,34261,0
2020-11-21,1200401,202047,34421,34261,160
2020-11-21,1200427,202047,34422,34421,1
2020-11-21,1200435,202047,34422,34422,0
2020-11-21,1200807,202047,34422,34422,0
2020-11-21,1200450,202047,34422,34422,0
2020-11-21,1200609,202047,34422,34422,0
2020-11-21,1200302,202047,34421,34422,-1
2020-11-21,1200252,202047,34421,34421,0
2020-11-21,1200500,202047,34427,34421,6
2020-11-21,1200385,202047,34427,34427,0
2020-11-21,1200336,202047,34444,34427,17
2020-11-21,1200351,202047,34445,34444,1
2020-11-21,1200344,202047,34447,34445,2
2020-11-21,1200328,202047,34447,34447,0
2020-11-21,1200708,202047,34450,34447,3
2020-11-21,1200203,202047,34450,34450,0
2020-11-21,1200179,202047,34450,34450,0
2020-11-21,1200138,202047,34449,34450,-1
2020-11-21,1200104,202047,34450,34449,1
2020-11-21,1200054,202047,34450,34450,0
2020-11-21,1200013,202047,34450,34450,0
2020-11-22,1200302,202048,34461,34450,11
2020-11-22,1200252,202048,34462,34461,1
2020-11-22,1200203,202048,34463,34462,1
2020-11-22,1200179,202048,34463,34463,0
2020-11-22,1200344,202048,34463,34463,0
2020-11-22,1200104,202048,34466,34463,3
2020-11-22,1200054,202048,34466,34466,0
2020-11-22,1200013,202048,34466,34466,0
2020-11-22,1200328,202048,34466,34466,0
2020-11-22,1200138,202048,34466,34466,0
2020-11-22,1200336,202048,34466,34466,0
2020-11-22,1200351,202048,34466,34466,0
2020-11-22,1200385,202048,34471,34466,5
2020-11-22,1200393,202048,34471,34471,0
2020-11-22,1200708,202048,34471,34471,0
2020-11-22,1200609,202048,34471,34471,0
2020-11-22,1200450,202048,34479,34471,8
2020-11-22,1200435,202048,34479,34479,0
2020-11-22,1200427,202048,34479,34479,0
2020-11-22,1200401,202048,34640,34479,161
2020-11-22,1200807,202048,34641,34640,1
2020-11-22,1200500,202048,34641,34641,0
2020-11-23,1200385,202048,34647,34641,6
2020-11-23,1200609,202048,34657,34647,10
2020-11-23,1200450,202048,34664,34657,7
2020-11-23,1200708,202048,34668,34664,4
2020-11-23,1200435,202048,34668,34668,0
2020-11-23,1200427,202048,34668,34668,0
2020-11-23,1200401,202048,34856,34668,188
2020-11-23,1200393,202048,34856,34856,0
2020-11-23,1200807,202048,34856,34856,0
2020-11-23,1200344,202048,34856,34856,0
2020-11-23,1200500,202048,34856,34856,0
2020-11-23,1200138,202048,34857,34856,1
2020-11-23,1200203,202048,34861,34857,4
2020-11-23,1200302,202048,34861,34861,0
2020-11-23,1200252,202048,34862,34861,1
2020-11-23,1200179,202048,34862,34862,0
2020-11-23,1200336,202048,34863,34862,1
2020-11-23,1200104,202048,34863,34863,0
2020-11-23,1200054,202048,34863,34863,0
2020-11-23,1200013,202048,34863,34863,0
2020-11-23,1200328,202048,34863,34863,0
2020-11-23,1200351,202048,34864,34863,1
2020-11-24,1200385,202048,34864,34864,0
2020-11-24,1200203,202048,34870,34864,6
2020-11-24,1200708,202048,34875,34870,5
2020-11-24,1200450,202048,34875,34875,0
2020-11-24,1200500,202048,34917,34875,42
2020-11-24,1200435,202048,34917,34917,0
2020-11-24,1200427,202048,34917,34917,0
2020-11-24,1200401,202048,35042,34917,125
2020-11-24,1200393,202048,35042,35042,0
2020-11-24,1200807,202048,35043,35042,1
2020-11-24,1200336,202048,35043,35043,0
2020-11-24,1200351,202048,35043,35043,0
2020-11-24,1200344,202048,35054,35043,11
2020-11-24,1200054,202048,35054,35054,0
2020-11-24,1200104,202048,35055,35054,1
2020-11-24,1200138,202048,35054,35055,-1
2020-11-24,1200179,202048,35056,35054,2
2020-11-24,1200013,202048,35056,35056,0
2020-11-24,1200252,202048,35055,35056,-1
2020-11-24,1200302,202048,35054,35055,-1
2020-11-24,1200328,202048,35054,35054,0
2020-11-24,1200609,202048,35068,35054,14
2020-11-25,1200328,202048,35068,35068,0
2020-11-25,1200013,202048,35068,35068,0
2020-11-25,1200054,202048,35068,35068,0
2020-11-25,1200344,202048,35068,35068,0
2020-11-25,1200138,202048,35068,35068,0
2020-11-25,1200179,202048,35068,35068,0
2020-11-25,1200203,202048,35071,35068,3
2020-11-25,1200252,202048,35071,35071,0
2020-11-25,1200302,202048,35071,35071,0
2020-11-25,1200385,202048,35072,35071,1
2020-11-25,1200104,202048,35072,35072,0
2020-11-25,1200807,202048,35076,35072,4
2020-11-25,1200393,202048,35076,35076,0
2020-11-25,1200401,202048,35202,35076,126
2020-11-25,1200435,202048,35202,35202,0
2020-11-25,1200500,202048,35202,35202,0
2020-11-25,1200450,202048,35203,35202,1
2020-11-25,1200609,202048,35203,35203,0
2020-11-25,1200708,202048,35203,35203,0
2020-11-25,1200427,202048,35203,35203,0
2020-11-25,1200336,202048,35203,35203,0
2020-11-25,1200351,202048,35203,35203,0
2020-11-26,1200807,202048,35203,35203,0
2020-11-26,1200393,202048,35203,35203,0
2020-11-26,1200401,202048,35295,35203,92
2020-11-26,1200427,202048,35295,35295,0
2020-11-26,1200708,202048,35295,35295,0
2020-11-26,1200450,202048,35297,35295,2
2020-11-26,1200609,202048,35297,35297,0
2020-11-26,1200252,202048,35301,35297,4
2020-11-26,1200435,202048,35301,35301,0
2020-11-26,1200336,202048,35302,35301,1
2020-11-26,1200500,202048,35302,35302,0
2020-11-26,1200351,202048,35302,35302,0
2020-11-26,1200013,202048,35302,35302,0
2020-11-26,1200054,202048,35302,35302,0
2020-11-26,1200104,202048,35305,35302,3
2020-11-26,1200385,202048,35305,35305,0
2020-11-26,1200179,202048,35316,35305,11
2020-11-26,1200302,202048,35316,35316,0
2020-11-26,1200328,202048,35316,35316,0
2020-11-26,1200344,202048,35316,35316,0
2020-11-26,1200203,202048,35317,35316,1
2020-11-26,1200138,202048,35319,35317,2
2020-11-27,1200393,202048,35319,35319,0
2020-11-27,1200252,202048,35319,35319,0
2020-11-27,1200609,202048,35343,35319,24
2020-11-27,1200336,202048,35367,35343,24
2020-11-27,1200385,202048,35370,35367,3
2020-11-27,1200344,202048,35414,35370,44
2020-11-27,1200328,202048,35414,35414,0
2020-11-27,1200302,202048,35446,35414,32
2020-11-27,1200401,202048,35617,35446,171
2020-11-27,1200351,202048,35620,35617,3
2020-11-27,1200427,202048,35627,35620,7
2020-11-27,1200807,202048,35640,35627,13
2020-11-27,1200500,202048,35689,35640,49
2020-11-27,1200450,202048,35693,35689,4
2020-11-27,1200203,202048,35732,35693,39
2020-11-27,1200179,202048,35732,35732,0
2020-11-27,1200138,202048,35732,35732,0
2020-11-27,1200104,202048,35733,35732,1
2020-11-27,1200054,202048,35733,35733,0
2020-11-27,1200013,202048,35737,35733,4
2020-11-27,1200708,202048,35769,35737,32
2020-11-27,1200435,202048,35771,35769,2
2020-11-28,1200344,202048,35771,35771,0
2020-11-28,1200336,202048,35771,35771,0
2020-11-28,1200351,202048,35771,35771,0
2020-11-28,1200328,202048,35771,35771,0
2020-11-28,1200385,202048,35776,35771,5
2020-11-28,1200252,202048,35776,35776,0
2020-11-28,1200203,202048,35777,35776,1
2020-11-28,1200179,202048,35777,35777,0
2020-11-28,1200138,202048,35777,35777,0
2020-11-28,1200302,202048,35778,35777,1
2020-11-28,1200609,202048,35778,35778,0
2020-11-28,1200807,202048,35782,35778,4
2020-11-28,1200401,202048,35930,35782,148
2020-11-28,1200054,202048,35930,35930,0
2020-11-28,1200013,202048,35932,35930,2
2020-11-28,1200104,202048,35932,35932,0
2020-11-28,1200708,202048,35932,35932,0
2020-11-28,1200393,202048,35932,35932,0
2020-11-28,1200500,202048,35935,35932,3
2020-11-28,1200435,202048,35935,35935,0
2020-11-28,1200427,202048,35935,35935,0
2020-11-28,1200450,202048,35935,35935,0
2020-11-29,1200435,202049,35935,35935,0
2020-11-29,1200013,202049,35942,35935,7
2020-11-29,1200104,202049,35942,35942,0
2020-11-29,1200138,202049,35942,35942,0
2020-11-29,1200179,202049,35942,35942,0
2020-11-29,1200203,202049,35943,35942,1
2020-11-29,1200252,202049,35947,35943,4
2020-11-29,1200328,202049,35947,35947,0
2020-11-29,1200344,202049,35947,35947,0
2020-11-29,1200351,202049,35947,35947,0
2020-11-29,1200302,202049,35947,35947,0
2020-11-29,1200708,202049,35949,35947,2
2020-11-29,1200336,202049,35949,35949,0
2020-11-29,1200393,202049,35949,35949,0
2020-11-29,1200054,202049,35949,35949,0
2020-11-29,1200401,202049,36087,35949,138
2020-11-29,1200427,202049,36087,36087,0
2020-11-29,1200807,202049,36091,36087,4
2020-11-29,1200500,202049,36091,36091,0
2020-11-29,1200450,202049,36094,36091,3
2020-11-29,1200609,202049,36094,36094,0
2020-11-29,1200385,202049,36095,36094,1
2020-11-30,1200302,202049,36103,36095,8
2020-11-30,1200013,202049,36103,36103,0
2020-11-30,1200609,202049,36124,36103,21
2020-11-30,1200450,202049,36125,36124,1
2020-11-30,1200054,202049,36126,36125,1
2020-11-30,1200104,202049,36130,36126,4
2020-11-30,1200138,202049,36130,36130,0
2020-11-30,1200179,202049,36130,36130,0
2020-11-30,1200203,202049,36142,36130,12
2020-11-30,1200252,202049,36144,36142,2
2020-11-30,1200328,202049,36144,36144,0
2020-11-30,1200427,202049,36146,36144,2
2020-11-30,1200351,202049,36146,36146,0
2020-11-30,1200336,202049,36154,36146,8
2020-11-30,1200385,202049,36159,36154,5
2020-11-30,1200807,202049,36159,36159,0
2020-11-30,1200393,202049,36160,36159,1
2020-11-30,1200401,202049,36228,36160,68
2020-11-30,1200500,202049,36257,36228,29
2020-11-30,1200708,202049,36266,36257,9
2020-11-30,1200435,202049,36267,36266,1
2020-11-30,1200344,202049,36274,36267,7
2020-12-01,1200302,202049,36302,36274,28
2020-12-01,1200252,202049,36305,36302,3
2020-12-01,1200203,202049,36346,36305,41
2020-12-01,1200179,202049,36349,36346,3
2020-12-01,1200385,202049,36350,36349,1
2020-12-01,1200104,202049,36350,36350,0
2020-12-01,1200054,202049,36351,36350,1
2020-12-01,1200013,202049,36351,36351,0
2020-12-01,1200328,202049,36351,36351,0
2020-12-01,1200138,202049,36351,36351,0
2020-12-01,1200344,202049,36352,36351,1
2020-12-01,1200401,202049,36503,36352,151
2020-12-01,1200708,202049,36513,36503,10
2020-12-01,1200807,202049,36513,36513,0
2020-12-01,1200393,202049,36513,36513,0
2020-12-01,1200427,202049,36514,36513,1
2020-12-01,1200336,202049,36514,36514,0
2020-12-01,1200500,202049,36548,36514,34
2020-12-01,1200450,202049,36551,36548,3
2020-12-01,1200609,202049,36576,36551,25
2020-12-01,1200435,202049,36576,36576,0
2020-12-01,1200351,202049,36578,36576,2
2020-12-02,1200344,202049,36583,36578,5
2020-12-02,1200328,202049,36583,36583,0
2020-12-02,1200013,202049,36583,36583,0
2020-12-02,1200054,202049,36583,36583,0
2020-12-02,1200104,202049,36583,36583,0
2020-12-02,1200138,202049,36600,36583,17
2020-12-02,1200179,202049,36600,36600,0
2020-12-02,1200203,202049,36605,36600,5
2020-12-02,1200252,202049,36608,36605,3
2020-12-02,1200302,202049,36610,36608,2
2020-12-02,1200385,202049,36611,36610,1
2020-12-02,1200807,202049,36613,36611,2
2020-12-02,1200393,202049,36613,36613,0
2020-12-02,1200401,202049,36696,36613,83
2020-12-02,1200435,202049,36697,36696,1
2020-12-02,1200500,202049,36719,36697,22
2020-12-02,1200450,202049,36720,36719,1
2020-12-02,1200609,202049,36751,36720,31
2020-12-02,1200708,202049,36761,36751,10
2020-12-02,1200427,202049,36761,36761,0
2020-12-02,1200336,202049,36761,36761,0
2020-12-02,1200351,202049,36761,36761,0
2020-12-03,1200393,202049,36764,36761,3
2020-12-03,1200401,202049,36846,36764,82
2020-12-03,1200427,202049,36846,36846,0
2020-12-03,1200435,202049,36846,36846,0
2020-12-03,1200252,202049,36847,36846,1
2020-12-03,1200450,202049,36847,36847,0
2020-12-03,1200609,202049,36847,36847,0
2020-12-03,1200708,202049,36859,36847,12
2020-12-03,1200807,202049,36862,36859,3
2020-12-03,1200500,202049,36872,36862,10
2020-12-03,1200336,202049,36873,36872,1
2020-12-03,1200328,202049,36881,36873,8
2020-12-03,1200351,202049,36882,36881,1
2020-12-03,1200203,202049,36893,36882,11
2020-12-03,1200344,202049,36897,36893,4
2020-12-03,1200302,202049,36900,36897,3
2020-12-03,1200179,202049,36908,36900,8
2020-12-03,1200138,202049,36912,36908,4
2020-12-03,1200104,202049,36912,36912,0
2020-12-03,1200054,202049,36912,36912,0
2020-12-03,1200013,202049,36912,36912,0
2020-12-03,1200385,202049,36914,36912,2
2020-12-04,1200609,202049,36929,36914,15
2020-12-04,1200807,202049,36930,36929,1
2020-12-04,1200328,202049,36933,36930,3
2020-12-04,1200344,202049,36934,36933,1
2020-12-04,1200351,202049,36934,36934,0
2020-12-04,1200336,202049,36934,36934,0
2020-12-04,1200385,202049,36938,36934,4
2020-12-04,1200252,202049,36938,36938,0
2020-12-04,1200401,202049,37107,36938,169
2020-12-04,1200435,202049,37107,37107,0
2020-12-04,1200393,202049,37107,37107,0
2020-12-04,1200427,202049,37107,37107,0
2020-12-04,1200450,202049,37107,37107,0
2020-12-04,1200302,202049,37113,37107,6
2020-12-04,1200203,202049,37118,37113,5
2020-12-04,1200179,202049,37120,37118,2
2020-12-04,1200138,202049,37124,37120,4
2020-12-04,1200104,202049,37124,37124,0
2020-12-04,1200054,202049,37124,37124,0
2020-12-04,1200013,202049,37124,37124,0
2020-12-04,1200708,202049,37134,37124,10
2020-12-04,1200500,202049,37167,37134,33
2020-12-05,1200336,202049,37167,37167,0
2020-12-05,1200351,202049,37168,37167,1
2020-12-05,1200344,202049,37168,37168,0
2020-12-05,1200328,202049,37168,37168,0
2020-12-05,1200385,202049,37174,37168,6
2020-12-05,1200252,202049,37174,37174,0
2020-12-05,1200203,202049,37176,37174,2
2020-12-05,1200179,202049,37176,37176,0
2020-12-05,1200401,202049,37241,37176,65
2020-12-05,1200302,202049,37260,37241,19
2020-12-05,1200393,202049,37261,37260,1
2020-12-05,1200807,202049,37261,37261,0
2020-12-05,1200609,202049,37266,37261,5
2020-12-05,1200013,202049,37267,37266,1
2020-12-05,1200054,202049,37267,37267,0
2020-12-05,1200104,202049,37267,37267,0
2020-12-05,1200435,202049,37267,37267,0
2020-12-05,1200708,202049,37271,37267,4
2020-12-05,1200138,202049,37272,37271,1
2020-12-05,1200500,202049,37290,37272,18
2020-12-05,1200450,202049,37292,37290,2
2020-12-05,1200427,202049,37292,37292,0
2020-12-06,1200435,202050,37292,37292,0
2020-12-06,1200344,202050,37292,37292,0
2020-12-06,1200708,202050,37292,37292,0
2020-12-06,1200609,202050,37292,37292,0
2020-12-06,1200450,202050,37295,37292,3
2020-12-06,1200500,202050,37295,37295,0
2020-12-06,1200427,202050,37295,37295,0
2020-12-06,1200336,202050,37295,37295,0
2020-12-06,1200351,202050,37295,37295,0
2020-12-06,1200013,202050,37295,37295,0
2020-12-06,1200401,202050,37332,37295,37
2020-12-06,1200328,202050,37332,37332,0
2020-12-06,1200252,202050,37332,37332,0
2020-12-06,1200203,202050,37333,37332,1
2020-12-06,1200179,202050,37335,37333,2
2020-12-06,1200138,202050,37335,37335,0
2020-12-06,1200807,202050,37336,37335,1
2020-12-06,1200104,202050,37336,37336,0
2020-12-06,1200054,202050,37336,37336,0
2020-12-06,1200393,202050,37336,37336,0
2020-12-06,1200385,202050,37336,37336,0
2020-12-06,1200302,202050,37336,37336,0
2020-12-07,1200401,202050,37380,37336,44
2020-12-07,1200427,202050,37383,37380,3
2020-12-07,1200435,202050,37383,37383,0
2020-12-07,1200500,202050,37414,37383,31
2020-12-07,1200807,202050,37414,37414,0
2020-12-07,1200609,202050,37427,37414,13
2020-12-07,1200708,202050,37433,37427,6
2020-12-07,1200344,202050,37433,37433,0
2020-12-07,1200450,202050,37434,37433,1
2020-12-07,1200385,202050,37435,37434,1
2020-12-07,1200393,202050,37435,37435,0
2020-12-07,1200351,202050,37435,37435,0
2020-12-07,1200054,202050,37435,37435,0
2020-12-07,1200104,202050,37436,37435,1
2020-12-07,1200138,202050,37437,37436,1
2020-12-07,1200179,202050,37437,37437,0
2020-12-07,1200013,202050,37438,37437,1
2020-12-07,1200252,202050,37438,37438,0
2020-12-07,1200328,202050,37438,37438,0
2020-12-07,1200336,202050,37438,37438,0
2020-12-07,1200302,202050,37438,37438,0
2020-12-07,1200203,202050,37443,37438,5
2020-12-08,1200807,202050,37443,37443,0
2020-12-08,1200500,202050,37444,37443,1
2020-12-08,1200203,202050,37444,37444,0
2020-12-08,1200252,202050,37444,37444,0
2020-12-08,1200302,202050,37458,37444,14
2020-12-08,1200328,202050,37458,37458,0
2020-12-08,1200344,202050,37458,37458,0
2020-12-08,1200351,202050,37458,37458,0
2020-12-08,1200336,202050,37458,37458,0
2020-12-08,1200385,202050,37462,37458,4
2020-12-08,1200393,202050,37462,37462,0
2020-12-08,1200401,202050,37571,37462,109
2020-12-08,1200427,202050,37571,37571,0
2020-12-08,1200435,202050,37571,37571,0
2020-12-08,1200708,202050,37571,37571,0
2020-12-08,1200609,202050,37571,37571,0
2020-12-08,1200450,202050,37571,37571,0
2020-12-08,1200054,202050,37571,37571,0
2020-12-08,1200013,202050,37571,37571,0
2020-12-08,1200138,202050,37571,37571,0
2020-12-08,1200179,202050,37571,37571,0
2020-12-08,1200104,202050,37571,37571,0
2020-12-09,1200336,202050,37572,37571,1
2020-12-09,1200013,202050,37573,37572,1
2020-12-09,1200385,202050,37572,37573,-1
2020-12-09,1200807,202050,37573,37572,1
2020-12-09,1200708,202050,37576,37573,3
2020-12-09,1200500,202050,37598,37576,22
2020-12-09,1200450,202050,37599,37598,1
2020-12-09,1200609,202050,37599,37599,0
2020-12-09,1200351,202050,37599,37599,0
2020-12-09,1200435,202050,37599,37599,0
2020-12-09,1200344,202050,37603,37599,4
2020-12-09,1200328,202050,37603,37603,0
2020-12-09,1200302,202050,37613,37603,10
2020-12-09,1200252,202050,37613,37613,0
2020-12-09,1200401,202050,37666,37613,53
2020-12-09,1200203,202050,37675,37666,9
2020-12-09,1200179,202050,37675,37675,0
2020-12-09,1200138,202050,37683,37675,8
2020-12-09,1200104,202050,37682,37683,-1
2020-12-09,1200054,202050,37687,37682,5
2020-12-09,1200427,202050,37687,37687,0
2020-12-09,1200393,202050,37687,37687,0
2020-12-10,1200252,202050,37691,37687,4
2020-12-10,1200203,202050,37695,37691,4
2020-12-10,1200179,202050,37696,37695,1
2020-12-10,1200138,202050,37697,37696,1
2020-12-10,1200401,202050,37865,37697,168
2020-12-10,1200054,202050,37866,37865,1
2020-12-10,1200013,202050,37867,37866,1
2020-12-10,1200344,202050,37868,37867,1
2020-12-10,1200427,202050,37868,37868,0
2020-12-10,1200104,202050,37872,37868,4
2020-12-10,1200328,202050,37872,37872,0
2020-12-10,1200302,202050,37877,37872,5
2020-12-10,1200351,202050,37877,37877,0
2020-12-10,1200393,202050,37877,37877,0
2020-12-10,1200500,202050,37893,37877,16
2020-12-10,1200450,202050,37894,37893,1
2020-12-10,1200609,202050,37894,37894,0
2020-12-10,1200435,202050,37895,37894,1
2020-12-10,1200807,202050,37895,37895,0
2020-12-10,1200385,202050,37899,37895,4
2020-12-10,1200336,202050,37906,37899,7
2020-12-10,1200708,202050,37917,37906,11
2020-12-11,1200435,202050,37917,37917,0
2020-12-11,1200427,202050,37917,37917,0
2020-12-11,1200054,202050,37916,37917,-1
2020-12-11,1200104,202050,37913,37916,-3
2020-12-11,1200138,202050,37915,37913,2
2020-12-11,1200708,202050,37924,37915,9
2020-12-11,1200609,202050,37934,37924,10
2020-12-11,1200450,202050,37934,37934,0
2020-12-11,1200500,202050,37971,37934,37
2020-12-11,1200401,202050,38146,37971,175
2020-12-11,1200807,202050,38148,38146,2
2020-12-11,1200393,202050,38148,38148,0
2020-12-11,1200252,202050,38148,38148,0
2020-12-11,1200013,202050,38153,38148,5
2020-12-11,1200302,202050,38154,38153,1
2020-12-11,1200328,202050,38158,38154,4
2020-12-11,1200203,202050,38160,38158,2
2020-12-11,1200351,202050,38160,38160,0
2020-12-11,1200336,202050,38160,38160,0
2020-12-11,1200385,202050,38164,38160,4
2020-12-11,1200179,202050,38164,38164,0
2020-12-11,1200344,202050,38165,38164,1
2020-12-12,1200344,202050,38165,38165,0
2020-12-12,1200351,202050,38168,38165,3
2020-12-12,1200013,202050,38170,38168,2
2020-12-12,1200054,202050,38175,38170,5
2020-12-12,1200104,202050,38176,38175,1
2020-12-12,1200138,202050,38182,38176,6
2020-12-12,1200179,202050,38184,38182,2
2020-12-12,1200203,202050,38191,38184,7
2020-12-12,1200252,202050,38191,38191,0
2020-12-12,1200328,202050,38191,38191,0
2020-12-12,1200385,202050,38191,38191,0
2020-12-12,1200336,202050,38191,38191,0
2020-12-12,1200807,202050,38191,38191,0
2020-12-12,1200401,202050,38328,38191,137
2020-12-12,1200708,202050,38337,38328,9
2020-12-12,1200609,202050,38346,38337,9
2020-12-12,1200450,202050,38351,38346,5
2020-12-12,1200302,202050,38351,38351,0
2020-12-12,1200435,202050,38354,38351,3
2020-12-12,1200427,202050,38354,38354,0
2020-12-12,1200393,202050,38354,38354,0
2020-12-12,1200500,202050,38378,38354,24
2020-12-13,1200104,202051,38378,38378,0
2020-12-13,1200609,202051,38378,38378,0
2020-12-13,1200450,202051,38378,38378,0
2020-12-13,1200500,202051,38378,38378,0
2020-12-13,1200435,202051,38378,38378,0
2020-12-13,1200427,202051,38378,38378,0
2020-12-13,1200401,202051,38422,38378,44
2020-12-13,1200393,202051,38422,38422,0
2020-12-13,1200807,202051,38422,38422,0
2020-12-13,1200351,202051,38422,38422,0
2020-12-13,1200708,202051,38422,38422,0
2020-12-13,1200179,202051,38422,38422,0
2020-12-13,1200252,202051,38422,38422,0
2020-12-13,1200328,202051,38422,38422,0
2020-12-13,1200302,202051,38422,38422,0
2020-12-13,1200203,202051,38422,38422,0
2020-12-13,1200336,202051,38422,38422,0
2020-12-13,1200138,202051,38422,38422,0
2020-12-13,1200054,202051,38422,38422,0
2020-12-13,1200013,202051,38422,38422,0
2020-12-13,1200344,202051,38422,38422,0
2020-12-13,1200385,202051,38427,38422,5
2020-12-14,1200385,202051,38427,38427,0
2020-12-14,1200708,202051,38434,38427,7
2020-12-14,1200450,202051,38435,38434,1
2020-12-14,1200500,202051,38481,38435,46
2020-12-14,1200435,202051,38481,38481,0
2020-12-14,1200427,202051,38481,38481,0
2020-12-14,1200401,202051,38579,38481,98
2020-12-14,1200393,202051,38579,38579,0
2020-12-14,1200807,202051,38583,38579,4
2020-12-14,1200336,202051,38582,38583,-1
2020-12-14,1200203,202051,38610,38582,28
2020-12-14,1200344,202051,38612,38610,2
2020-12-14,1200013,202051,38613,38612,1
2020-12-14,1200054,202051,38614,38613,1
2020-12-14,1200104,202051,38614,38614,0
2020-12-14,1200138,202051,38615,38614,1
2020-12-14,1200351,202051,38615,38615,0
2020-12-14,1200609,202051,38625,38615,10
2020-12-14,1200252,202051,38626,38625,1
2020-12-14,1200302,202051,38641,38626,15
2020-12-14,1200328,202051,38643,38641,2
2020-12-14,1200179,202051,38643,38643,0
2020-12-15,1200427,202051,38645,38643,2
2020-12-15,1200013,202051,38645,38645,0
2020-12-15,1200104,202051,38645,38645,0
2020-12-15,1200138,202051,38645,38645,0
2020-12-15,1200179,202051,38645,38645,0
2020-12-15,1200203,202051,38651,38645,6
2020-12-15,1200252,202051,38651,38651,0
2020-12-15,1200302,202051,38652,38651,1
2020-12-15,1200328,202051,38652,38652,0
2020-12-15,1200344,202051,38652,38652,0
2020-12-15,1200351,202051,38652,38652,0
2020-12-15,1200336,202051,38653,38652,1
2020-12-15,1200807,202051,38655,38653,2
2020-12-15,1200393,202051,38655,38655,0
2020-12-15,1200401,202051,38719,38655,64
2020-12-15,1200435,202051,38719,38719,0
2020-12-15,1200450,202051,38719,38719,0
2020-12-15,1200609,202051,38719,38719,0
2020-12-15,1200708,202051,38720,38719,1
2020-12-15,1200054,202051,38720,38720,0
2020-12-15,1200500,202051,38727,38720,7
2020-12-15,1200385,202051,38727,38727,0
2020-12-16,1200807,202051,38726,38727,-1
2020-12-16,1200708,202051,38738,38726,12
2020-12-16,1200401,202051,38895,38738,157
2020-12-16,1200427,202051,38895,38895,0
2020-12-16,1200385,202051,38895,38895,0
2020-12-16,1200500,202051,38929,38895,34
2020-12-16,1200450,202051,38929,38929,0
2020-12-16,1200609,202051,38929,38929,0
2020-12-16,1200435,202051,38929,38929,0
2020-12-16,1200179,202051,38929,38929,0
2020-12-16,1200393,202051,38929,38929,0
2020-12-16,1200336,202051,38929,38929,0
2020-12-16,1200344,202051,38931,38929,2
2020-12-16,1200328,202051,38931,38931,0
2020-12-16,1200302,202051,38946,38931,15
2020-12-16,1200252,202051,38946,38946,0
2020-12-16,1200351,202051,38946,38946,0
2020-12-16,1200013,202051,38946,38946,0
2020-12-16,1200138,202051,38946,38946,0
2020-12-16,1200104,202051,38946,38946,0
2020-12-16,1200054,202051,38946,38946,0
2020-12-16,1200203,202051,38953,38946,7
2020-12-17,1200385,202051,38954,38953,1
2020-12-17,1200302,202051,38959,38954,5
2020-12-17,1200328,202051,38962,38959,3
2020-12-17,1200344,202051,38965,38962,3
2020-12-17,1200351,202051,38968,38965,3
2020-12-17,1200336,202051,38968,38968,0
2020-12-17,1200609,202051,38969,38968,1
2020-12-17,1200252,202051,38972,38969,3
2020-12-17,1200401,202051,39101,38972,129
2020-12-17,1200427,202051,39103,39101,2
2020-12-17,1200393,202051,39103,39103,0
2020-12-17,1200500,202051,39144,39103,41
2020-12-17,1200435,202051,39145,39144,1
2020-12-17,1200013,202051,39145,39145,0
2020-12-17,1200054,202051,39148,39145,3
2020-12-17,1200104,202051,39147,39148,-1
2020-12-17,1200138,202051,39155,39147,8
2020-12-17,1200708,202051,39166,39155,11
2020-12-17,1200203,202051,39176,39166,10
2020-12-17,1200807,202051,39181,39176,5
2020-12-17,1200450,202051,39181,39181,0
2020-12-17,1200179,202051,39181,39181,0
2020-12-18,1200336,202051,39183,39181,2
2020-12-18,1200609,202051,39183,39183,0
2020-12-18,1200138,202051,39188,39183,5
2020-12-18,1200179,202051,39188,39188,0
2020-12-18,1200203,202051,39203,39188,15
2020-12-18,1200252,202051,39205,39203,2
2020-12-18,1200302,202051,39206,39205,1
2020-12-18,1200328,202051,39211,39206,5
2020-12-18,1200344,202051,39213,39211,2
2020-12-18,1200385,202051,39213,39213,0
2020-12-18,1200351,202051,39214,39213,1
2020-12-18,1200393,202051,39215,39214,1
2020-12-18,1200013,202051,39217,39215,2
2020-12-18,1200104,202051,39217,39217,0
2020-12-18,1200708,202051,39227,39217,10
2020-12-18,1200450,202051,39227,39227,0
2020-12-18,1200054,202051,39227,39227,0
2020-12-18,1200435,202051,39227,39227,0
2020-12-18,1200427,202051,39228,39227,1
2020-12-18,1200401,202051,39325,39228,97
2020-12-18,1200500,202051,39357,39325,32
2020-12-18,1200807,202051,39356,39357,-1
2020-12-19,1200435,202051,39356,39356,0
2020-12-19,1200351,202051,39358,39356,2
2020-12-19,1200013,202051,39365,39358,7
2020-12-19,1200104,202051,39382,39365,17
2020-12-19,1200138,202051,39384,39382,2
2020-12-19,1200179,202051,39391,39384,7
2020-12-19,1200203,202051,39439,39391,48
2020-12-19,1200252,202051,39451,39439,12
2020-12-19,1200302,202051,39474,39451,23
2020-12-19,1200328,202051,39474,39474,0
2020-12-19,1200344,202051,39478,39474,4
2020-12-19,1200336,202051,39479,39478,1
2020-12-19,1200609,202051,39481,39479,2
2020-12-19,1200450,202051,39498,39481,17
2020-12-19,1200500,202051,39524,39498,26
2020-12-19,1200385,202051,39526,39524,2
2020-12-19,1200427,202051,39528,39526,2
2020-12-19,1200401,202051,39808,39528,280
2020-12-19,1200054,202051,39816,39808,8
2020-12-19,1200393,202051,39816,39816,0
2020-12-19,1200807,202051,39874,39816,58
2020-12-19,1200708,202051,39884,39874,10
2020-12-20,1200252,202052,39884,39884,0
2020-12-20,1200203,202052,39884,39884,0
2020-12-20,1200179,202052,39884,39884,0
2020-12-20,1200138,202052,39884,39884,0
2020-12-20,1200302,202052,39885,39884,1
2020-12-20,1200054,202052,39885,39885,0
2020-12-20,1200450,202052,39885,39885,0
2020-12-20,1200609,202052,39885,39885,0
2020-12-20,1200104,202052,39885,39885,0
2020-12-20,1200328,202052,39885,39885,0
2020-12-20,1200013,202052,39885,39885,0
2020-12-20,1200351,202052,39885,39885,0
2020-12-20,1200435,202052,39885,39885,0
2020-12-20,1200708,202052,39885,39885,0
2020-12-20,1200500,202052,39887,39885,2
2020-12-20,1200427,202052,39887,39887,0
2020-12-20,1200344,202052,39887,39887,0
2020-12-20,1200393,202052,39887,39887,0
2020-12-20,1200807,202052,39887,39887,0
2020-12-20,1200385,202052,39891,39887,4
2020-12-20,1200336,202052,39891,39891,0
2020-12-20,1200401,202052,40011,39891,120
2020-12-21,1200328,202052,40012,40011,1
2020-12-21,1200385,202052,40012,40012,0
2020-12-21,1200013,202052,40022,40012,10
2020-12-21,1200054,202052,40022,40022,0
2020-12-21,1200104,202052,40024,40022,2
2020-12-21,1200138,202052,40024,40024,0
2020-12-21,1200179,202052,40024,40024,0
2020-12-21,1200203,202052,40039,40024,15
2020-12-21,1200252,202052,40043,40039,4
2020-12-21,1200302,202052,40043,40043,0
2020-12-21,1200344,202052,40044,40043,1
2020-12-21,1200393,202052,40044,40044,0
2020-12-21,1200708,202052,40044,40044,0
2020-12-21,1200807,202052,40044,40044,0
2020-12-21,1200351,202052,40046,40044,2
2020-12-21,1200401,202052,40229,40046,183
2020-12-21,1200427,202052,40230,40229,1
2020-12-21,1200336,202052,40233,40230,3
2020-12-21,1200500,202052,40253,40233,20
2020-12-21,1200450,202052,40255,40253,2
2020-12-21,1200609,202052,40254,40255,-1
2020-12-21,1200435,202052,40264,40254,10
2020-12-22,1200344,202052,40264,40264,0
2020-12-22,1200013,202052,40265,40264,1
2020-12-22,1200054,202052,40265,40265,0
2020-12-22,1200104,202052,40270,40265,5
2020-12-22,1200138,202052,40271,40270,1
2020-12-22,1200179,202052,40272,40271,1
2020-12-22,1200203,202052,40272,40272,0
2020-12-22,1200302,202052,40291,40272,19
2020-12-22,1200328,202052,40291,40291,0
2020-12-22,1200385,202052,40292,40291,1
2020-12-22,1200351,202052,40292,40292,0
2020-12-22,1200807,202052,40295,40292,3
2020-12-22,1200252,202052,40296,40295,1
2020-12-22,1200427,202052,40296,40296,0
2020-12-22,1200708,202052,40296,40296,0
2020-12-22,1200609,202052,40296,40296,0
2020-12-22,1200336,202052,40297,40296,1
2020-12-22,1200500,202052,40308,40297,11
2020-12-22,1200435,202052,40308,40308,0
2020-12-22,1200401,202052,40328,40308,20
2020-12-22,1200393,202052,40328,40328,0
2020-12-22,1200450,202052,40329,40328,1
2020-12-23,1200054,202052,40329,40329,0
2020-12-23,1200708,202052,40334,40329,5
2020-12-23,1200609,202052,40337,40334,3
2020-12-23,1200450,202052,40337,40337,0
2020-12-23,1200500,202052,40361,40337,24
2020-12-23,1200435,202052,40360,40361,-1
2020-12-23,1200427,202052,40364,40360,4
2020-12-23,1200401,202052,40391,40364,27
2020-12-23,1200393,202052,40391,40391,0
2020-12-23,1200179,202052,40391,40391,0
2020-12-23,1200807,202052,40391,40391,0
2020-12-23,1200336,202052,40392,40391,1
2020-12-23,1200252,202052,40395,40392,3
2020-12-23,1200344,202052,40399,40395,4
2020-12-23,1200328,202052,40405,40399,6
2020-12-23,1200302,202052,40407,40405,2
2020-12-23,1200351,202052,40406,40407,-1
2020-12-23,1200385,202052,40407,40406,1
2020-12-23,1200138,202052,40406,40407,-1
2020-12-23,1200104,202052,40407,40406,1
2020-12-23,1200013,202052,40411,40407,4
2020-12-23,1200203,202052,40414,40411,3
2020-12-24,1200427,202052,40414,40414,0
2020-12-24,1200807,202052,40418,40414,4
2020-12-24,1200328,202052,40420,40418,2
2020-12-24,1200344,202052,40421,40420,1
2020-12-24,1200351,202052,40422,40421,1
2020-12-24,1200336,202052,40422,40422,0
2020-12-24,1200385,202052,40422,40422,0
2020-12-24,1200393,202052,40422,40422,0
2020-12-24,1200252,202052,40425,40422,3
2020-12-24,1200401,202052,40617,40425,192
2020-12-24,1200609,202052,40617,40617,0
2020-12-24,1200435,202052,40618,40617,1
2020-12-24,1200450,202052,40618,40618,0
2020-12-24,1200302,202052,40618,40618,0
2020-12-24,1200203,202052,40622,40618,4
2020-12-24,1200179,202052,40622,40622,0
2020-12-24,1200138,202052,40622,40622,0
2020-12-24,1200104,202052,40630,40622,8
2020-12-24,1200054,202052,40631,40630,1
2020-12-24,1200013,202052,40635,40631,4
2020-12-24,1200708,202052,40635,40635,0
2020-12-24,1200500,202052,40653,40635,18
2020-12-25,1200393,202052,40653,40653,0
2020-12-25,1200401,202052,40682,40653,29
2020-12-25,1200427,202052,40682,40682,0
2020-12-25,1200435,202052,40681,40682,-1
2020-12-25,1200708,202052,40697,40681,16
2020-12-25,1200203,202052,40707,40697,10
2020-12-25,1200450,202052,40707,40707,0
2020-12-25,1200609,202052,40708,40707,1
2020-12-25,1200807,202052,40713,40708,5
2020-12-25,1200500,202052,40729,40713,16
2020-12-25,1200138,202052,40730,40729,1
2020-12-25,1200385,202052,40730,40730,0
2020-12-25,1200351,202052,40730,40730,0
2020-12-25,1200013,202052,40730,40730,0
2020-12-25,1200054,202052,40735,40730,5
2020-12-25,1200104,202052,40735,40735,0
2020-12-25,1200179,202052,40735,40735,0
2020-12-25,1200336,202052,40736,40735,1
2020-12-25,1200302,202052,40736,40736,0
2020-12-25,1200328,202052,40736,40736,0
2020-12-25,1200344,202052,40737,40736,1
2020-12-25,1200252,202052,40738,40737,1
2020-12-26,1200807,202052,40738,40738,0
2020-12-26,1200336,202052,40738,40738,0
2020-12-26,1200708,202052,40738,40738,0
2020-12-26,1200609,202052,40738,40738,0
2020-12-26,1200450,202052,40738,40738,0
2020-12-26,1200500,202052,40740,40738,2
2020-12-26,1200435,202052,40740,40740,0
2020-12-26,1200427,202052,40740,40740,0
2020-12-26,1200401,202052,40749,40740,9
2020-12-26,1200393,202052,40749,40749,0
2020-12-26,1200385,202052,40749,40749,0
2020-12-26,1200013,202052,40749,40749,0
2020-12-26,1200344,202052,40749,40749,0
2020-12-26,1200328,202052,40749,40749,0
2020-12-26,1200302,202052,40751,40749,2
2020-12-26,1200252,202052,40751,40751,0
2020-12-26,1200203,202052,40751,40751,0
2020-12-26,1200179,202052,40751,40751,0
2020-12-26,1200138,202052,40751,40751,0
2020-12-26,1200104,202052,40751,40751,0
2020-12-26,1200054,202052,40751,40751,0
2020-12-26,1200351,202052,40751,40751,0
2020-12-27,1200393,202053,40751,40751,0
2020-12-27,1200401,202053,40865,40751,114
2020-12-27,1200427,202053,40865,40865,0
2020-12-27,1200435,202053,40865,40865,0
2020-12-27,1200807,202053,40870,40865,5
2020-12-27,1200450,202053,40870,40870,0
2020-12-27,1200609,202053,40870,40870,0
2020-12-27,1200302,202053,40870,40870,0
2020-12-27,1200252,202053,40870,40870,0
2020-12-27,1200500,202053,40881,40870,11
2020-12-27,1200385,202053,40881,40881,0
2020-12-27,1200013,202053,40881,40881,0
2020-12-27,1200351,202053,40881,40881,0
2020-12-27,1200344,202053,40881,40881,0
2020-12-27,1200328,202053,40881,40881,0
2020-12-27,1200708,202053,40881,40881,0
2020-12-27,1200203,202053,40893,40881,12
2020-12-27,1200179,202053,40893,40893,0
2020-12-27,1200138,202053,40893,40893,0
2020-12-27,1200104,202053,40915,40893,22
2020-12-27,1200054,202053,40915,40915,0
2020-12-27,1200336,202053,40915,40915,0
2020-12-28,1200302,202053,40916,40915,1
2020-12-28,1200252,202053,40916,40916,0
2020-12-28,1200203,202053,40916,40916,0
2020-12-28,1200179,202053,40916,40916,0
2020-12-28,1200344,202053,40916,40916,0
2020-12-28,1200104,202053,40916,40916,0
2020-12-28,1200054,202053,40916,40916,0
2020-12-28,1200013,202053,40916,40916,0
2020-12-28,1200328,202053,40916,40916,0
2020-12-28,1200138,202053,40916,40916,0
2020-12-28,1200336,202053,40917,40916,1
2020-12-28,1200435,202053,40917,40917,0
2020-12-28,1200385,202053,40920,40917,3
2020-12-28,1200393,202053,40920,40920,0
2020-12-28,1200708,202053,40920,40920,0
2020-12-28,1200609,202053,40920,40920,0
2020-12-28,1200450,202053,40920,40920,0
2020-12-28,1200351,202053,40920,40920,0
2020-12-28,1200427,202053,40920,40920,0
2020-12-28,1200401,202053,41023,40920,103
2020-12-28,1200807,202053,41023,41023,0
2020-12-28,1200500,202053,41025,41023,2
2020-12-29,1200385,202053,41033,41025,8
2020-12-29,1200609,202053,41036,41033,3
2020-12-29,1200450,202053,41038,41036,2
2020-12-29,1200500,202053,41085,41038,47
2020-12-29,1200435,202053,41085,41085,0
2020-12-29,1200427,202053,41086,41085,1
2020-12-29,1200401,202053,41167,41086,81
2020-12-29,1200393,202053,41167,41167,0
2020-12-29,1200807,202053,41170,41167,3
2020-12-29,1200708,202053,41185,41170,15
2020-12-29,1200344,202053,41193,41185,8
2020-12-29,1200138,202053,41193,41193,0
2020-12-29,1200328,202053,41194,41193,1
2020-12-29,1200013,202053,41195,41194,1
2020-12-29,1200054,202053,41195,41195,0
2020-12-29,1200104,202053,41197,41195,2
2020-12-29,1200351,202053,41197,41197,0
2020-12-29,1200179,202053,41199,41197,2
2020-12-29,1200252,202053,41203,41199,4
2020-12-29,1200302,202053,41235,41203,32
2020-12-29,1200203,202053,41247,41235,12
2020-12-29,1200336,202053,41247,41247,0
2020-12-30,1200807,202053,41247,41247,0
2020-12-30,1200393,202053,41247,41247,0
2020-12-30,1200401,202053,41332,41247,85
2020-12-30,1200427,202053,41332,41332,0
2020-12-30,1200385,202053,41336,41332,4
2020-12-30,1200500,202053,41340,41336,4
2020-12-30,1200450,202053,41343,41340,3
2020-12-30,1200708,202053,41346,41343,3
2020-12-30,1200203,202053,41357,41346,11
2020-12-30,1200435,202053,41357,41357,0
2020-12-30,1200336,202053,41357,41357,0
2020-12-30,1200013,202053,41363,41357,6
2020-12-30,1200344,202053,41365,41363,2
2020-12-30,1200054,202053,41365,41365,0
2020-12-30,1200104,202053,41367,41365,2
2020-12-30,1200138,202053,41367,41367,0
2020-12-30,1200179,202053,41368,41367,1
2020-12-30,1200351,202053,41368,41368,0
2020-12-30,1200252,202053,41369,41368,1
2020-12-30,1200302,202053,41369,41369,0
2020-12-30,1200328,202053,41369,41369,0
2020-12-30,1200609,202053,41370,41369,1
2020-12-31,1200344,202053,41376,41370,6
2020-12-31,1200013,202053,41376,41376,0
2020-12-31,1200054,202053,41377,41376,1
2020-12-31,1200104,202053,41388,41377,11
2020-12-31,1200138,202053,41388,41388,0
2020-12-31,1200179,202053,41388,41388,0
2020-12-31,1200203,202053,41398,41388,10
2020-12-31,1200252,202053,41402,41398,4
2020-12-31,1200328,202053,41408,41402,6
2020-12-31,1200385,202053,41408,41408,0
2020-12-31,1200302,202053,41409,41408,1
2020-12-31,1200807,202053,41419,41409,10
2020-12-31,1200336,202053,41412,41419,-7
2020-12-31,1200427,202053,41412,41412,0
2020-12-31,1200708,202053,41414,41412,2
2020-12-31,1200609,202053,41414,41414,0
2020-12-31,1200351,202053,41415,41414,1
2020-12-31,1200500,202053,41422,41415,7
2020-12-31,1200435,202053,41422,41422,0
2020-12-31,1200401,202053,41635,41422,213
2020-12-31,1200393,202053,41635,41635,0
2020-12-31,1200450,202053,41635,41635,0
2021-01-01,1200252,202053,41635,41635,0
2021-01-01,1200609,202053,41635,41635,0
2021-01-01,1200450,202053,41635,41635,0
2021-01-01,1200500,202053,41658,41635,23
2021-01-01,1200435,202053,41658,41658,0
2021-01-01,1200427,202053,41658,41658,0
2021-01-01,1200401,202053,41691,41658,33
2021-01-01,1200393,202053,41691,41691,0
2021-01-01,1200807,202053,41702,41691,11
2021-01-01,1200708,202053,41702,41702,0
2021-01-01,1200336,202053,41702,41702,0
2021-01-01,1200351,202053,41702,41702,0
2021-01-01,1200203,202053,41705,41702,3
2021-01-01,1200344,202053,41705,41705,0
2021-01-01,1200328,202053,41704,41705,-1
2021-01-01,1200302,202053,41704,41704,0
2021-01-01,1200138,202053,41704,41704,0
2021-01-01,1200385,202053,41704,41704,0
2021-01-01,1200104,202053,41704,41704,0
2021-01-01,1200054,202053,41704,41704,0
2021-01-01,1200013,202053,41704,41704,0
2021-01-01,1200179,202053,41704,41704,0
2021-01-02,1200427,202053,41704,41704,0
2021-01-02,1200302,202053,41734,41704,30
2021-01-02,1200328,202053,41734,41734,0
2021-01-02,1200344,202053,41734,41734,0
2021-01-02,1200351,202053,41734,41734,0
2021-01-02,1200336,202053,41734,41734,0
2021-01-02,1200609,202053,41734,41734,0
2021-01-02,1200252,202053,41735,41734,1
2021-01-02,1200393,202053,41735,41735,0
2021-01-02,1200401,202053,41930,41735,195
2021-01-02,1200385,202053,41938,41930,8
2021-01-02,1200435,202053,41938,41938,0
2021-01-02,1200450,202053,41938,41938,0
2021-01-02,1200807,202053,41945,41938,7
2021-01-02,1200203,202053,41946,41945,1
2021-01-02,1200179,202053,41947,41946,1
2021-01-02,1200138,202053,41947,41947,0
2021-01-02,1200104,202053,41954,41947,7
2021-01-02,1200054,202053,41954,41954,0
2021-01-02,1200013,202053,41954,41954,0
2021-01-02,1200708,202053,41954,41954,0
2021-01-02,1200500,202053,41956,41954,2
2021-01-03,1200336,202101,41956,41956,0
2021-01-03,1200351,202101,41956,41956,0
2021-01-03,1200344,202101,41956,41956,0
2021-01-03,1200328,202101,41956,41956,0
2021-01-03,1200138,202101,41956,41956,0
2021-01-03,1200252,202101,41956,41956,0
2021-01-03,1200203,202101,41956,41956,0
2021-01-03,1200179,202101,41956,41956,0
2021-01-03,1200609,202101,41956,41956,0
2021-01-03,1200302,202101,41956,41956,0
2021-01-03,1200385,202101,41960,41956,4
2021-01-03,1200807,202101,41960,41960,0
2021-01-03,1200401,202101,42061,41960,101
2021-01-03,1200054,202101,42061,42061,0
2021-01-03,1200013,202101,42061,42061,0
2021-01-03,1200104,202101,42061,42061,0
2021-01-03,1200708,202101,42061,42061,0
2021-01-03,1200393,202101,42061,42061,0
2021-01-03,1200500,202101,42061,42061,0
2021-01-03,1200435,202101,42061,42061,0
2021-01-03,1200427,202101,42061,42061,0
2021-01-03,1200450,202101,42061,42061,0
2021-01-04,1200435,202101,42061,42061,0
2021-01-04,1200013,202101,42061,42061,0
2021-01-04,1200104,202101,42090,42061,29
2021-01-04,1200138,202101,42090,42090,0
2021-01-04,1200179,202101,42090,42090,0
2021-01-04,1200203,202101,42089,42090,-1
2021-01-04,1200252,202101,42098,42089,9
2021-01-04,1200328,202101,42098,42098,0
2021-01-04,1200344,202101,42097,42098,-1
2021-01-04,1200351,202101,42097,42097,0
2021-01-04,1200302,202101,42097,42097,0
2021-01-04,1200708,202101,42098,42097,1
2021-01-04,1200336,202101,42098,42098,0
2021-01-04,1200393,202101,42098,42098,0
2021-01-04,1200054,202101,42098,42098,0
2021-01-04,1200401,202101,42105,42098,7
2021-01-04,1200427,202101,42106,42105,1
2021-01-04,1200807,202101,42112,42106,6
2021-01-04,1200500,202101,42118,42112,6
2021-01-04,1200450,202101,42119,42118,1
2021-01-04,1200609,202101,42119,42119,0
2021-01-04,1200385,202101,42132,42119,13
2021-01-05,1200302,202101,42132,42132,0
2021-01-05,1200013,202101,42132,42132,0
2021-01-05,1200609,202101,42131,42132,-1
2021-01-05,1200450,202101,42132,42131,1
2021-01-05,1200054,202101,42132,42132,0
2021-01-05,1200104,202101,42133,42132,1
2021-01-05,1200138,202101,42134,42133,1
2021-01-05,1200179,202101,42134,42134,0
2021-01-05,1200203,202101,42137,42134,3
2021-01-05,1200252,202101,42137,42137,0
2021-01-05,1200328,202101,42137,42137,0
2021-01-05,1200427,202101,42137,42137,0
2021-01-05,1200351,202101,42138,42137,1
2021-01-05,1200336,202101,42138,42138,0
2021-01-05,1200385,202101,42138,42138,0
2021-01-05,1200807,202101,42140,42138,2
2021-01-05,1200393,202101,42140,42140,0
2021-01-05,1200401,202101,42184,42140,44
2021-01-05,1200500,202101,42184,42184,0
2021-01-05,1200708,202101,42185,42184,1
2021-01-05,1200435,202101,42185,42185,0
2021-01-05,1200344,202101,42185,42185,0
2021-01-06,1200302,202101,42185,42185,0
2021-01-06,1200252,202101,42186,42185,1
2021-01-06,1200203,202101,42213,42186,27
2021-01-06,1200179,202101,42213,42213,0
2021-01-06,1200385,202101,42234,42213,21
2021-01-06,1200104,202101,42235,42234,1
2021-01-06,1200054,202101,42235,42235,0
2021-01-06,1200013,202101,42241,42235,6
2021-01-06,1200328,202101,42241,42241,0
2021-01-06,1200138,202101,42241,42241,0
2021-01-06,1200344,202101,42244,42241,3
2021-01-06,1200401,202101,42297,42244,53
2021-01-06,1200708,202101,42338,42297,41
2021-01-06,1200807,202101,42344,42338,6
2021-01-06,1200393,202101,42344,42344,0
2021-01-06,1200427,202101,42346,42344,2
2021-01-06,1200336,202101,42346,42346,0
2021-01-06,1200500,202101,42387,42346,41
2021-01-06,1200450,202101,42387,42387,0
2021-01-06,1200609,202101,42391,42387,4
2021-01-06,1200435,202101,42393,42391,2
2021-01-06,1200351,202101,42393,42393,0
2021-01-07,1200344,202101,42393,42393,0
2021-01-07,1200328,202101,42393,42393,0
2021-01-07,1200013,202101,42396,42393,3
2021-01-07,1200054,202101,42396,42396,0
2021-01-07,1200104,202101,42396,42396,0
2021-01-07,1200138,202101,42396,42396,0
2021-01-07,1200179,202101,42396,42396,0
2021-01-07,1200203,202101,42398,42396,2
2021-01-07,1200252,202101,42398,42398,0
2021-01-07,1200302,202101,42399,42398,1
2021-01-07,1200385,202101,42400,42399,1
2021-01-07,1200807,202101,42400,42400,0
2021-01-07,1200393,202101,42400,42400,0
2021-01-07,1200401,202101,42484,42400,84
2021-01-07,1200435,202101,42484,42484,0
2021-01-07,1200500,202101,42484,42484,0
2021-01-07,1200450,202101,42484,42484,0
2021-01-07,1200609,202101,42484,42484,0
2021-01-07,1200708,202101,42493,42484,9
2021-01-07,1200427,202101,42493,42493,0
2021-01-07,1200336,202101,42493,42493,0
2021-01-07,1200351,202101,42493,42493,0
2021-01-08,1200393,202101,42494,42493,1
2021-01-08,1200401,202101,42620,42494,126
2021-01-08,1200427,202101,42622,42620,2
2021-01-08,1200435,202101,42622,42622,0
2021-01-08,1200252,202101,42637,42622,15
2021-01-08,1200450,202101,42638,42637,1
2021-01-08,1200609,202101,42641,42638,3
2021-01-08,1200708,202101,42667,42641,26
2021-01-08,1200807,202101,42676,42667,9
2021-01-08,1200500,202101,42721,42676,45
2021-01-08,1200336,202101,42720,42721,-1
2021-01-08,1200328,202101,42720,42720,0
2021-01-08,1200351,202101,42723,42720,3
2021-01-08,1200203,202101,42757,42723,34
2021-01-08,1200344,202101,42766,42757,9
2021-01-08,1200302,202101,42778,42766,12
2021-01-08,1200179,202101,42778,42778,0
2021-01-08,1200138,202101,42778,42778,0
2021-01-08,1200104,202101,42803,42778,25
2021-01-08,1200054,202101,42803,42803,0
2021-01-08,1200013,202101,42805,42803,2
2021-01-08,1200385,202101,42829,42805,24
2021-01-09,1200609,202101,42829,42829,0
2021-01-09,1200807,202101,42837,42829,8
2021-01-09,1200328,202101,42837,42837,0
2021-01-09,1200344,202101,42842,42837,5
2021-01-09,1200351,202101,42842,42842,0
2021-01-09,1200336,202101,42843,42842,1
2021-01-09,1200385,202101,42853,42843,10
2021-01-09,1200252,202101,42860,42853,7
2021-01-09,1200401,202101,42872,42860,12
2021-01-09,1200435,202101,42872,42872,0
2021-01-09,1200393,202101,42872,42872,0
2021-01-09,1200427,202101,42871,42872,-1
2021-01-09,1200450,202101,42873,42871,2
2021-01-09,1200302,202101,42873,42873,0
2021-01-09,1200203,202101,42876,42873,3
2021-01-09,1200179,202101,42878,42876,2
2021-01-09,1200138,202101,42878,42878,0
2021-01-09,1200104,202101,42910,42878,32
2021-01-09,1200054,202101,42910,42910,0
2021-01-09,1200013,202101,42910,42910,0
2021-01-09,1200708,202101,42919,42910,9
2021-01-09,1200500,202101,42923,42919,4
2021-01-10,1200336,202102,42923,42923,0
2021-01-10,1200351,202102,42923,42923,0
2021-01-10,1200344,202102,42923,42923,0
2021-01-10,1200328,202102,42923,42923,0
2021-01-10,1200385,202102,42939,42923,16
2021-01-10,1200252,202102,42939,42939,0
2021-01-10,1200203,202102,42940,42939,1
2021-01-10,1200179,202102,42946,42940,6
2021-01-10,1200401,202102,43094,42946,148
2021-01-10,1200302,202102,43115,43094,21
2021-01-10,1200393,202102,43115,43115,0
2021-01-10,1200807,202102,43123,43115,8
2021-01-10,1200609,202102,43123,43123,0
2021-01-10,1200013,202102,43123,43123,0
2021-01-10,1200054,202102,43123,43123,0
2021-01-10,1200104,202102,43125,43123,2
2021-01-10,1200435,202102,43125,43125,0
2021-01-10,1200708,202102,43128,43125,3
2021-01-10,1200138,202102,43129,43128,1
2021-01-10,1200500,202102,43136,43129,7
2021-01-10,1200450,202102,43142,43136,6
2021-01-10,1200427,202102,43142,43142,0
2021-01-11,1200450,202102,43142,43142,0
2021-01-11,1200344,202102,43144,43142,2
2021-01-11,1200435,202102,43144,43144,0
2021-01-11,1200708,202102,43166,43144,22
2021-01-11,1200427,202102,43168,43166,2
2021-01-11,1200609,202102,43168,43168,0
2021-01-11,1200500,202102,43205,43168,37
2021-01-11,1200336,202102,43204,43205,-1
2021-01-11,1200351,202102,43205,43204,1
2021-01-11,1200013,202102,43205,43205,0
2021-01-11,1200401,202102,43310,43205,105
2021-01-11,1200328,202102,43310,43310,0
2021-01-11,1200252,202102,43317,43310,7
2021-01-11,1200203,202102,43320,43317,3
2021-01-11,1200179,202102,43320,43320,0
2021-01-11,1200138,202102,43320,43320,0
2021-01-11,1200807,202102,43323,43320,3
2021-01-11,1200104,202102,43332,43323,9
2021-01-11,1200054,202102,43332,43332,0
2021-01-11,1200393,202102,43332,43332,0
2021-01-11,1200385,202102,43360,43332,28
2021-01-11,1200302,202102,43361,43360,1
2021-01-12,1200401,202102,43443,43361,82
2021-01-12,1200344,202102,43443,43443,0
2021-01-12,1200435,202102,43443,43443,0
2021-01-12,1200500,202102,43443,43443,0
2021-01-12,1200393,202102,43443,43443,0
2021-01-12,1200609,202102,43443,43443,0
2021-01-12,1200708,202102,43443,43443,0
2021-01-12,1200351,202102,43443,43443,0
2021-01-12,1200450,202102,43443,43443,0
2021-01-12,1200385,202102,43443,43443,0
2021-01-12,1200427,202102,43443,43443,0
2021-01-12,1200807,202102,43443,43443,0
2021-01-12,1200013,202102,43443,43443,0
2021-01-12,1200054,202102,43443,43443,0
2021-01-12,1200104,202102,43443,43443,0
2021-01-12,1200138,202102,43443,43443,0
2021-01-12,1200336,202102,43443,43443,0
2021-01-12,1200203,202102,43447,43443,4
2021-01-12,1200252,202102,43447,43447,0
2021-01-12,1200328,202102,43447,43447,0
2021-01-12,1200302,202102,43447,43447,0
2021-01-12,1200179,202102,43447,43447,0
2021-01-13,1200450,202102,43459,43447,12
2021-01-13,1200609,202102,43463,43459,4
2021-01-13,1200336,202102,43465,43463,2
2021-01-13,1200203,202102,43474,43465,9
2021-01-13,1200252,202102,43480,43474,6
2021-01-13,1200302,202102,43504,43480,24
2021-01-13,1200328,202102,43504,43504,0
2021-01-13,1200344,202102,43509,43504,5
2021-01-13,1200351,202102,43510,43509,1
2021-01-13,1200385,202102,43546,43510,36
2021-01-13,1200708,202102,43574,43546,28
2021-01-13,1200393,202102,43574,43574,0
2021-01-13,1200401,202102,43751,43574,177
2021-01-13,1200427,202102,43753,43751,2
2021-01-13,1200435,202102,43758,43753,5
2021-01-13,1200500,202102,43785,43758,27
2021-01-13,1200807,202102,43791,43785,6
2021-01-13,1200054,202102,43792,43791,1
2021-01-13,1200013,202102,43794,43792,2
2021-01-13,1200104,202102,43795,43794,1
2021-01-13,1200138,202102,43796,43795,1
2021-01-13,1200179,202102,43800,43796,4
2021-01-14,1200344,202102,43802,43800,2
2021-01-14,1200328,202102,43802,43802,0
2021-01-14,1200302,202102,43802,43802,0
2021-01-14,1200252,202102,43815,43802,13
2021-01-14,1200500,202102,43840,43815,25
2021-01-14,1200179,202102,43840,43840,0
2021-01-14,1200138,202102,43846,43840,6
2021-01-14,1200351,202102,43847,43846,1
2021-01-14,1200336,202102,43847,43847,0
2021-01-14,1200203,202102,43873,43847,26
2021-01-14,1200054,202102,43881,43873,8
2021-01-14,1200385,202102,43892,43881,11
2021-01-14,1200807,202102,43893,43892,1
2021-01-14,1200708,202102,43917,43893,24
2021-01-14,1200609,202102,43939,43917,22
2021-01-14,1200450,202102,43945,43939,6
2021-01-14,1200393,202102,43945,43945,0
2021-01-14,1200435,202102,43946,43945,1
2021-01-14,1200104,202102,43966,43946,20
2021-01-14,1200013,202102,43970,43966,4
2021-01-14,1200401,202102,44078,43970,108
2021-01-14,1200427,202102,44083,44078,5
2021-01-15,1200302,202102,44097,44083,14
2021-01-15,1200252,202102,44103,44097,6
2021-01-15,1200203,202102,44107,44103,4
2021-01-15,1200179,202102,44110,44107,3
2021-01-15,1200344,202102,44110,44110,0
2021-01-15,1200104,202102,44110,44110,0
2021-01-15,1200054,202102,44110,44110,0
2021-01-15,1200013,202102,44114,44110,4
2021-01-15,1200328,202102,44114,44114,0
2021-01-15,1200138,202102,44115,44114,1
2021-01-15,1200336,202102,44115,44115,0
2021-01-15,1200351,202102,44115,44115,0
2021-01-15,1200807,202102,44122,44115,7
2021-01-15,1200401,202102,44165,44122,43
2021-01-15,1200708,202102,44165,44165,0
2021-01-15,1200609,202102,44165,44165,0
2021-01-15,1200450,202102,44166,44165,1
2021-01-15,1200385,202102,44168,44166,2
2021-01-15,1200435,202102,44168,44168,0
2021-01-15,1200427,202102,44168,44168,0
2021-01-15,1200393,202102,44168,44168,0
2021-01-15,1200500,202102,44171,44168,3
2021-01-16,1200302,202102,44181,44171,10
2021-01-16,1200609,202102,44329,44181,148
2021-01-16,1200450,202102,44334,44329,5
2021-01-16,1200500,202102,44356,44334,22
2021-01-16,1200435,202102,44358,44356,2
2021-01-16,1200427,202102,44361,44358,3
2021-01-16,1200401,202102,44414,44361,53
2021-01-16,1200393,202102,44414,44414,0
2021-01-16,1200807,202102,44422,44414,8
2021-01-16,1200351,202102,44422,44422,0
2021-01-16,1200708,202102,44488,44422,66
2021-01-16,1200138,202102,44492,44488,4
2021-01-16,1200203,202102,44523,44492,31
2021-01-16,1200328,202102,44523,44523,0
2021-01-16,1200252,202102,44526,44523,3
2021-01-16,1200179,202102,44527,44526,1
2021-01-16,1200336,202102,44540,44527,13
2021-01-16,1200104,202102,44557,44540,17
2021-01-16,1200054,202102,44599,44557,42
2021-01-16,1200013,202102,44607,44599,8
2021-01-16,1200344,202102,44610,44607,3
2021-01-16,1200385,202102,44636,44610,26
2021-01-17,1200385,202103,44636,44636,0
2021-01-17,1200203,202103,44636,44636,0
2021-01-17,1200708,202103,44635,44636,-1
2021-01-17,1200450,202103,44635,44635,0
2021-01-17,1200500,202103,44635,44635,0
2021-01-17,1200435,202103,44635,44635,0
2021-01-17,1200427,202103,44635,44635,0
2021-01-17,1200401,202103,44727,44635,92
2021-01-17,1200393,202103,44727,44727,0
2021-01-17,1200807,202103,44726,44727,-1
2021-01-17,1200336,202103,44726,44726,0
2021-01-17,1200351,202103,44726,44726,0
2021-01-17,1200344,202103,44726,44726,0
2021-01-17,1200054,202103,44726,44726,0
2021-01-17,1200104,202103,44741,44726,15
2021-01-17,1200138,202103,44739,44741,-2
2021-01-17,1200179,202103,44739,44739,0
2021-01-17,1200013,202103,44737,44739,-2
2021-01-17,1200252,202103,44779,44737,42
2021-01-17,1200302,202103,44781,44779,2
2021-01-17,1200328,202103,44781,44781,0
2021-01-17,1200609,202103,44782,44781,1
2021-01-18,1200344,202103,44782,44782,0
2021-01-18,1200013,202103,44783,44782,1
2021-01-18,1200054,202103,44783,44783,0
2021-01-18,1200104,202103,44783,44783,0
2021-01-18,1200138,202103,44785,44783,2
2021-01-18,1200179,202103,44785,44785,0
2021-01-18,1200203,202103,44785,44785,0
2021-01-18,1200302,202103,44785,44785,0
2021-01-18,1200328,202103,44785,44785,0
2021-01-18,1200385,202103,44785,44785,0
2021-01-18,1200351,202103,44785,44785,0
2021-01-18,1200807,202103,44787,44785,2
2021-01-18,1200252,202103,44787,44787,0
2021-01-18,1200427,202103,44787,44787,0
2021-01-18,1200708,202103,44787,44787,0
2021-01-18,1200609,202103,44787,44787,0
2021-01-18,1200336,202103,44788,44787,1
2021-01-18,1200500,202103,44788,44788,0
2021-01-18,1200435,202103,44788,44788,0
2021-01-18,1200401,202103,44790,44788,2
2021-01-18,1200393,202103,44790,44790,0
2021-01-18,1200450,202103,44790,44790,0
2021-01-19,1200054,202103,44791,44790,1
2021-01-19,1200609,202103,44887,44791,96
2021-01-19,1200450,202103,44890,44887,3
2021-01-19,1200500,202103,44938,44890,48
2021-01-19,1200435,202103,44940,44938,2
2021-01-19,1200427,202103,44941,44940,1
2021-01-19,1200401,202103,45063,44941,122
2021-01-19,1200393,202103,45063,45063,0
2021-01-19,1200807,202103,45064,45063,1
2021-01-19,1200336,202103,45066,45064,2
2021-01-19,1200708,202103,45115,45066,49
2021-01-19,1200351,202103,45115,45115,0
2021-01-19,1200252,202103,45115,45115,0
2021-01-19,1200344,202103,45120,45115,5
2021-01-19,1200328,202103,45120,45120,0
2021-01-19,1200302,202103,45134,45120,14
2021-01-19,1200179,202103,45135,45134,1
2021-01-19,1200385,202103,45162,45135,27
2021-01-19,1200138,202103,45162,45162,0
2021-01-19,1200104,202103,45163,45162,1
2021-01-19,1200013,202103,45166,45163,3
2021-01-19,1200203,202103,45223,45166,57
2021-01-20,1200427,202103,45223,45223,0
2021-01-20,1200302,202103,45223,45223,0
2021-01-20,1200328,202103,45223,45223,0
2021-01-20,1200344,202103,45224,45223,1
2021-01-20,1200351,202103,45224,45224,0
2021-01-20,1200336,202103,45224,45224,0
2021-01-20,1200609,202103,45292,45224,68
2021-01-20,1200252,202103,45294,45292,2
2021-01-20,1200393,202103,45296,45294,2
2021-01-20,1200401,202103,45359,45296,63
2021-01-20,1200385,202103,45361,45359,2
2021-01-20,1200435,202103,45366,45361,5
2021-01-20,1200450,202103,45368,45366,2
2021-01-20,1200807,202103,45368,45368,0
2021-01-20,1200203,202103,45380,45368,12
2021-01-20,1200179,202103,45380,45380,0
2021-01-20,1200138,202103,45380,45380,0
2021-01-20,1200104,202103,45410,45380,30
2021-01-20,1200054,202103,45408,45410,-2
2021-01-20,1200013,202103,45411,45408,3
2021-01-20,1200708,202103,45430,45411,19
2021-01-20,1200500,202103,45444,45430,14
2021-01-21,1200336,202103,45444,45444,0
2021-01-21,1200351,202103,45446,45444,2
2021-01-21,1200344,202103,45447,45446,1
2021-01-21,1200328,202103,45447,45447,0
2021-01-21,1200138,202103,45448,45447,1
2021-01-21,1200252,202103,45450,45448,2
2021-01-21,1200203,202103,45475,45450,25
2021-01-21,1200179,202103,45475,45475,0
2021-01-21,1200609,202103,45555,45475,80
2021-01-21,1200302,202103,45556,45555,1
2021-01-21,1200385,202103,45571,45556,15
2021-01-21,1200807,202103,45572,45571,1
2021-01-21,1200401,202103,45672,45572,100
2021-01-21,1200054,202103,45672,45672,0
2021-01-21,1200013,202103,45678,45672,6
2021-01-21,1200104,202103,45692,45678,14
2021-01-21,1200708,202103,45711,45692,19
2021-01-21,1200393,202103,45718,45711,7
2021-01-21,1200500,202103,45732,45718,14
2021-01-21,1200435,202103,45737,45732,5
2021-01-21,1200427,202103,45739,45737,2
2021-01-21,1200450,202103,45744,45739,5
2021-01-22,1200435,202103,45748,45744,4
2021-01-22,1200013,202103,45759,45748,11
2021-01-22,1200104,202103,45777,45759,18
2021-01-22,1200138,202103,45779,45777,2
2021-01-22,1200179,202103,45779,45779,0
2021-01-22,1200203,202103,45804,45779,25
2021-01-22,1200252,202103,45813,45804,9
2021-01-22,1200328,202103,45813,45813,0
2021-01-22,1200344,202103,45813,45813,0
2021-01-22,1200351,202103,45813,45813,0
2021-01-22,1200302,202103,45814,45813,1
2021-01-22,1200708,202103,45826,45814,12
2021-01-22,1200336,202103,45829,45826,3
2021-01-22,1200393,202103,45835,45829,6
2021-01-22,1200054,202103,45835,45835,0
2021-01-22,1200401,202103,45852,45835,17
2021-01-22,1200427,202103,45870,45852,18
2021-01-22,1200807,202103,45873,45870,3
2021-01-22,1200500,202103,45891,45873,18
2021-01-22,1200450,202103,45901,45891,10
2021-01-22,1200609,202103,45990,45901,89
2021-01-22,1200385,202103,46002,45990,12
2021-01-23,1200302,202103,46001,46002,-1
2021-01-23,1200013,202103,46009,46001,8
2021-01-23,1200609,202103,46054,46009,45
2021-01-23,1200450,202103,46059,46054,5
2021-01-23,1200054,202103,46063,46059,4
2021-01-23,1200104,202103,46070,46063,7
2021-01-23,1200138,202103,46070,46070,0
2021-01-23,1200179,202103,46070,46070,0
2021-01-23,1200203,202103,46071,46070,1
2021-01-23,1200252,202103,46073,46071,2
2021-01-23,1200328,202103,46073,46073,0
2021-01-23,1200427,202103,46073,46073,0
2021-01-23,1200351,202103,46074,46073,1
2021-01-23,1200336,202103,46088,46074,14
2021-01-23,1200385,202103,46086,46088,-2
2021-01-23,1200807,202103,46086,46086,0
2021-01-23,1200393,202103,46086,46086,0
2021-01-23,1200401,202103,46181,46086,95
2021-01-23,1200500,202103,46210,46181,29
2021-01-23,1200708,202103,46251,46210,41
2021-01-23,1200435,202103,46253,46251,2
2021-01-23,1200344,202103,46254,46253,1
2021-01-24,1200302,202104,46254,46254,0
2021-01-24,1200252,202104,46267,46254,13
2021-01-24,1200203,202104,46268,46267,1
2021-01-24,1200179,202104,46268,46268,0
2021-01-24,1200385,202104,46272,46268,4
2021-01-24,1200104,202104,46295,46272,23
2021-01-24,1200054,202104,46297,46295,2
2021-01-24,1200013,202104,46297,46297,0
2021-01-24,1200328,202104,46297,46297,0
2021-01-24,1200138,202104,46298,46297,1
2021-01-24,1200344,202104,46298,46298,0
2021-01-24,1200401,202104,46430,46298,132
2021-01-24,1200708,202104,46432,46430,2
2021-01-24,1200807,202104,46437,46432,5
2021-01-24,1200393,202104,46437,46437,0
2021-01-24,1200427,202104,46437,46437,0
2021-01-24,1200336,202104,46438,46437,1
2021-01-24,1200500,202104,46442,46438,4
2021-01-24,1200450,202104,46442,46442,0
2021-01-24,1200609,202104,46443,46442,1
2021-01-24,1200435,202104,46443,46443,0
2021-01-24,1200351,202104,46444,46443,1
2021-01-25,1200344,202104,46444,46444,0
2021-01-25,1200328,202104,46444,46444,0
2021-01-25,1200013,202104,46445,46444,1
2021-01-25,1200054,202104,46458,46445,13
2021-01-25,1200104,202104,46458,46458,0
2021-01-25,1200138,202104,46462,46458,4
2021-01-25,1200179,202104,46463,46462,1
2021-01-25,1200203,202104,46464,46463,1
2021-01-25,1200252,202104,46465,46464,1
2021-01-25,1200302,202104,46465,46465,0
2021-01-25,1200385,202104,46471,46465,6
2021-01-25,1200807,202104,46471,46471,0
2021-01-25,1200393,202104,46471,46471,0
2021-01-25,1200401,202104,46526,46471,55
2021-01-25,1200435,202104,46527,46526,1
2021-01-25,1200500,202104,46530,46527,3
2021-01-25,1200450,202104,46538,46530,8
2021-01-25,1200609,202104,46538,46538,0
2021-01-25,1200708,202104,46540,46538,2
2021-01-25,1200427,202104,46540,46540,0
2021-01-25,1200336,202104,46554,46540,14
2021-01-25,1200351,202104,46554,46554,0
2021-01-26,1200393,202104,46554,46554,0
2021-01-26,1200401,202104,46683,46554,129
2021-01-26,1200427,202104,46684,46683,1
2021-01-26,1200435,202104,46684,46684,0
2021-01-26,1200252,202104,46699,46684,15
2021-01-26,1200807,202104,46699,46699,0
2021-01-26,1200450,202104,46702,46699,3
2021-01-26,1200609,202104,46714,46702,12
2021-01-26,1200708,202104,46731,46714,17
2021-01-26,1200500,202104,46733,46731,2
2021-01-26,1200336,202104,46734,46733,1
2021-01-26,1200302,202104,46744,46734,10
2021-01-26,1200351,202104,46743,46744,-1
2021-01-26,1200138,202104,46743,46743,0
2021-01-26,1200344,202104,46743,46743,0
2021-01-26,1200328,202104,46743,46743,0
2021-01-26,1200179,202104,46743,46743,0
2021-01-26,1200203,202104,46753,46743,10
2021-01-26,1200104,202104,46771,46753,18
2021-01-26,1200054,202104,46774,46771,3
2021-01-26,1200385,202104,46789,46774,15
2021-01-26,1200013,202104,46789,46789,0
2021-01-27,1200609,202104,46831,46789,42
2021-01-27,1200807,202104,46839,46831,8
2021-01-27,1200328,202104,46839,46839,0
2021-01-27,1200344,202104,46841,46839,2
2021-01-27,1200351,202104,46842,46841,1
2021-01-27,1200336,202104,46881,46842,39
2021-01-27,1200385,202104,46914,46881,33
2021-01-27,1200393,202104,46919,46914,5
2021-01-27,1200401,202104,47044,46919,125
2021-01-27,1200427,202104,47044,47044,0
2021-01-27,1200252,202104,47046,47044,2
2021-01-27,1200500,202104,47081,47046,35
2021-01-27,1200450,202104,47082,47081,1
2021-01-27,1200302,202104,47088,47082,6
2021-01-27,1200203,202104,47094,47088,6
2021-01-27,1200179,202104,47098,47094,4
2021-01-27,1200138,202104,47098,47098,0
2021-01-27,1200104,202104,47108,47098,10
2021-01-27,1200054,202104,47110,47108,2
2021-01-27,1200013,202104,47112,47110,2
2021-01-27,1200708,202104,47129,47112,17
2021-01-27,1200435,202104,47134,47129,5
2021-01-28,1200393,202104,47151,47134,17
2021-01-28,1200401,202104,47287,47151,136
2021-01-28,1200138,202104,47287,47287,0
2021-01-28,1200435,202104,47287,47287,0
2021-01-28,1200708,202104,47295,47287,8
2021-01-28,1200203,202104,47319,47295,24
2021-01-28,1200450,202104,47319,47319,0
2021-01-28,1200609,202104,47321,47319,2
2021-01-28,1200500,202104,47352,47321,31
2021-01-28,1200385,202104,47366,47352,14
2021-01-28,1200427,202104,47366,47366,0
2021-01-28,1200351,202104,47368,47366,2
2021-01-28,1200336,202104,47405,47368,37
2021-01-28,1200013,202104,47418,47405,13
2021-01-28,1200054,202104,47444,47418,26
2021-01-28,1200104,202104,47457,47444,13
2021-01-28,1200807,202104,47457,47457,0
2021-01-28,1200252,202104,47465,47457,8
2021-01-28,1200302,202104,47475,47465,10
2021-01-28,1200328,202104,47475,47475,0
2021-01-28,1200179,202104,47475,47475,0
2021-01-28,1200344,202104,47476,47475,1
2021-01-29,1200336,202104,47494,47476,18
2021-01-29,1200708,202104,47508,47494,14
2021-01-29,1200609,202104,47602,47508,94
2021-01-29,1200450,202104,47607,47602,5
2021-01-29,1200500,202104,47638,47607,31
2021-01-29,1200435,202104,47644,47638,6
2021-01-29,1200427,202104,47650,47644,6
2021-01-29,1200401,202104,47827,47650,177
2021-01-29,1200393,202104,47841,47827,14
2021-01-29,1200385,202104,47861,47841,20
2021-01-29,1200807,202104,47864,47861,3
2021-01-29,1200328,202104,47864,47864,0
2021-01-29,1200344,202104,47864,47864,0
2021-01-29,1200013,202104,47868,47864,4
2021-01-29,1200054,202104,47904,47868,36
2021-01-29,1200104,202104,47913,47904,9
2021-01-29,1200351,202104,47914,47913,1
2021-01-29,1200179,202104,47914,47914,0
2021-01-29,1200203,202104,47945,47914,31
2021-01-29,1200252,202104,47949,47945,4
2021-01-29,1200302,202104,47950,47949,1
2021-01-29,1200138,202104,47951,47950,1
2021-01-30,1200385,202104,47958,47951,7
2021-01-30,1200302,202104,47981,47958,23
2021-01-30,1200609,202104,48077,47981,96
2021-01-30,1200450,202104,48080,48077,3
2021-01-30,1200500,202104,48088,48080,8
2021-01-30,1200435,202104,48095,48088,7
2021-01-30,1200427,202104,48113,48095,18
2021-01-30,1200401,202104,48257,48113,144
2021-01-30,1200393,202104,48258,48257,1
2021-01-30,1200807,202104,48261,48258,3
2021-01-30,1200252,202104,48282,48261,21
2021-01-30,1200336,202104,48309,48282,27
2021-01-30,1200344,202104,48311,48309,2
2021-01-30,1200013,202104,48316,48311,5
2021-01-30,1200054,202104,48316,48316,0
2021-01-30,1200104,202104,48318,48316,2
2021-01-30,1200138,202104,48324,48318,6
2021-01-30,1200351,202104,48324,48324,0
2021-01-30,1200203,202104,48346,48324,22
2021-01-30,1200708,202104,48358,48346,12
2021-01-30,1200328,202104,48358,48358,0
2021-01-30,1200179,202104,48362,48358,4
2021-01-31,1200302,202105,48361,48362,-1
2021-01-31,1200344,202105,48361,48361,0
2021-01-31,1200013,202105,48361,48361,0
2021-01-31,1200054,202105,48362,48361,1
2021-01-31,1200104,202105,48382,48362,20
2021-01-31,1200138,202105,48383,48382,1
2021-01-31,1200179,202105,48384,48383,1
2021-01-31,1200203,202105,48391,48384,7
2021-01-31,1200252,202105,48391,48391,0
2021-01-31,1200328,202105,48391,48391,0
2021-01-31,1200336,202105,48391,48391,0
2021-01-31,1200435,202105,48391,48391,0
2021-01-31,1200385,202105,48401,48391,10
2021-01-31,1200807,202105,48401,48401,0
2021-01-31,1200401,202105,48468,48401,67
2021-01-31,1200427,202105,48468,48468,0
2021-01-31,1200500,202105,48477,48468,9
2021-01-31,1200450,202105,48476,48477,-1
2021-01-31,1200609,202105,48476,48476,0
2021-01-31,1200708,202105,48480,48476,4
2021-01-31,1200393,202105,48480,48480,0
2021-01-31,1200351,202105,48482,48480,2
2021-02-01,1200807,202105,48483,48482,1
2021-02-01,1200393,202105,48482,48483,-1
2021-02-01,1200401,202105,48645,48482,163
2021-02-01,1200427,202105,48649,48645,4
2021-02-01,1200385,202105,48650,48649,1
2021-02-01,1200500,202105,48679,48650,29
2021-02-01,1200450,202105,48681,48679,2
2021-02-01,1200609,202105,48759,48681,78
2021-02-01,1200708,202105,48768,48759,9
2021-02-01,1200435,202105,48768,48768,0
2021-02-01,1200344,202105,48770,48768,2
2021-02-01,1200336,202105,48795,48770,25
2021-02-01,1200138,202105,48795,48795,0
2021-02-01,1200328,202105,48795,48795,0
2021-02-01,1200013,202105,48795,48795,0
2021-02-01,1200054,202105,48792,48795,-3
2021-02-01,1200104,202105,48796,48792,4
2021-02-01,1200351,202105,48797,48796,1
2021-02-01,1200179,202105,48797,48797,0
2021-02-01,1200252,202105,48800,48797,3
2021-02-01,1200302,202105,48799,48800,-1
2021-02-01,1200203,202105,48835,48799,36
2021-02-02,1200807,202105,48838,48835,3
2021-02-02,1200393,202105,48838,48838,0
2021-02-02,1200401,202105,48956,48838,118
2021-02-02,1200427,202105,48956,48956,0
2021-02-02,1200203,202105,48961,48956,5
2021-02-02,1200500,202105,48974,48961,13
2021-02-02,1200450,202105,48975,48974,1
2021-02-02,1200708,202105,48974,48975,-1
2021-02-02,1200385,202105,48993,48974,19
2021-02-02,1200435,202105,48993,48993,0
2021-02-02,1200336,202105,48993,48993,0
2021-02-02,1200351,202105,48993,48993,0
2021-02-02,1200344,202105,48993,48993,0
2021-02-02,1200054,202105,49017,48993,24
2021-02-02,1200104,202105,49025,49017,8
2021-02-02,1200138,202105,49028,49025,3
2021-02-02,1200179,202105,49032,49028,4
2021-02-02,1200013,202105,49032,49032,0
2021-02-02,1200252,202105,49037,49032,5
2021-02-02,1200302,202105,49056,49037,19
2021-02-02,1200328,202105,49056,49056,0
2021-02-02,1200609,202105,49064,49056,8
2021-02-03,1200328,202105,49064,49064,0
2021-02-03,1200013,202105,49065,49064,1
2021-02-03,1200054,202105,49065,49065,0
2021-02-03,1200104,202105,49113,49065,48
2021-02-03,1200138,202105,49113,49113,0
2021-02-03,1200179,202105,49113,49113,0
2021-02-03,1200203,202105,49128,49113,15
2021-02-03,1200252,202105,49146,49128,18
2021-02-03,1200302,202105,49147,49146,1
2021-02-03,1200385,202105,49153,49147,6
2021-02-03,1200344,202105,49156,49153,3
2021-02-03,1200807,202105,49155,49156,-1
2021-02-03,1200336,202105,49211,49155,56
2021-02-03,1200427,202105,49212,49211,1
2021-02-03,1200708,202105,49235,49212,23
2021-02-03,1200609,202105,49347,49235,112
2021-02-03,1200351,202105,49347,49347,0
2021-02-03,1200500,202105,49375,49347,28
2021-02-03,1200435,202105,49376,49375,1
2021-02-03,1200401,202105,49557,49376,181
2021-02-03,1200393,202105,49557,49557,0
2021-02-03,1200450,202105,49562,49557,5
2021-02-04,1200252,202105,49596,49562,34
2021-02-04,1200708,202105,49598,49596,2
2021-02-04,1200609,202105,49630,49598,32
2021-02-04,1200450,202105,49630,49630,0
2021-02-04,1200500,202105,49646,49630,16
2021-02-04,1200435,202105,49650,49646,4
2021-02-04,1200427,202105,49650,49650,0
2021-02-04,1200401,202105,49787,49650,137
2021-02-04,1200393,202105,49792,49787,5
2021-02-04,1200807,202105,49793,49792,1
2021-02-04,1200336,202105,49859,49793,66
2021-02-04,1200138,202105,49860,49859,1
2021-02-04,1200351,202105,49860,49860,0
2021-02-04,1200344,202105,49864,49860,4
2021-02-04,1200328,202105,49864,49864,0
2021-02-04,1200302,202105,49865,49864,1
2021-02-04,1200179,202105,49865,49865,0
2021-02-04,1200203,202105,49908,49865,43
2021-02-04,1200104,202105,49920,49908,12
2021-02-04,1200054,202105,49920,49920,0
2021-02-04,1200013,202105,49954,49920,34
2021-02-04,1200385,202105,49959,49954,5
2021-02-05,1200401,202105,50084,49959,125
2021-02-05,1200302,202105,50107,50084,23
2021-02-05,1200328,202105,50107,50107,0
2021-02-05,1200344,202105,50107,50107,0
2021-02-05,1200351,202105,50107,50107,0
2021-02-05,1200336,202105,50107,50107,0
2021-02-05,1200609,202105,50108,50107,1
2021-02-05,1200252,202105,50109,50108,1
2021-02-05,1200393,202105,50109,50109,0
2021-02-05,1200427,202105,50110,50109,1
2021-02-05,1200385,202105,50122,50110,12
2021-02-05,1200500,202105,50123,50122,1
2021-02-05,1200708,202105,50130,50123,7
2021-02-05,1200013,202105,50135,50130,5
2021-02-05,1200054,202105,50135,50135,0
2021-02-05,1200104,202105,50135,50135,0
2021-02-05,1200435,202105,50135,50135,0
2021-02-05,1200179,202105,50136,50135,1
2021-02-05,1200203,202105,50137,50136,1
2021-02-05,1200807,202105,50138,50137,1
2021-02-05,1200450,202105,50137,50138,-1
2021-02-05,1200138,202105,50137,50137,0
2021-02-06,1200336,202105,50175,50137,38
2021-02-06,1200138,202105,50184,50175,9
2021-02-06,1200179,202105,50184,50184,0
2021-02-06,1200203,202105,50225,50184,41
2021-02-06,1200252,202105,50271,50225,46
2021-02-06,1200302,202105,50272,50271,1
2021-02-06,1200328,202105,50272,50272,0
2021-02-06,1200344,202105,50274,50272,2
2021-02-06,1200351,202105,50275,50274,1
2021-02-06,1200385,202105,50280,50275,5
2021-02-06,1200609,202105,50327,50280,47
2021-02-06,1200393,202105,50327,50327,0
2021-02-06,1200054,202105,50361,50327,34
2021-02-06,1200013,202105,50373,50361,12
2021-02-06,1200104,202105,50402,50373,29
2021-02-06,1200708,202105,50420,50402,18
2021-02-06,1200807,202105,50419,50420,-1
2021-02-06,1200500,202105,50429,50419,10
2021-02-06,1200435,202105,50431,50429,2
2021-02-06,1200427,202105,50436,50431,5
2021-02-06,1200401,202105,50467,50436,31
2021-02-06,1200450,202105,50469,50467,2
2021-02-07,1200351,202106,50469,50469,0
2021-02-07,1200013,202106,50473,50469,4
2021-02-07,1200104,202106,50473,50473,0
2021-02-07,1200138,202106,50473,50473,0
2021-02-07,1200179,202106,50473,50473,0
2021-02-07,1200203,202106,50476,50473,3
2021-02-07,1200252,202106,50476,50476,0
2021-02-07,1200302,202106,50476,50476,0
2021-02-07,1200328,202106,50476,50476,0
2021-02-07,1200344,202106,50476,50476,0
2021-02-07,1200435,202106,50476,50476,0
2021-02-07,1200336,202106,50476,50476,0
2021-02-07,1200609,202106,50476,50476,0
2021-02-07,1200450,202106,50476,50476,0
2021-02-07,1200500,202106,50482,50476,6
2021-02-07,1200385,202106,50483,50482,1
2021-02-07,1200427,202106,50483,50483,0
2021-02-07,1200401,202106,50547,50483,64
2021-02-07,1200054,202106,50547,50547,0
2021-02-07,1200393,202106,50547,50547,0
2021-02-07,1200807,202106,50547,50547,0
2021-02-07,1200708,202106,50561,50547,14
2021-02-08,1200203,202106,50569,50561,8
2021-02-08,1200179,202106,50569,50569,0
2021-02-08,1200138,202106,50573,50569,4
2021-02-08,1200104,202106,50588,50573,15
2021-02-08,1200252,202106,50594,50588,6
2021-02-08,1200450,202106,50595,50594,1
2021-02-08,1200609,202106,50597,50595,2
2021-02-08,1200013,202106,50607,50597,10
2021-02-08,1200054,202106,50607,50607,0
2021-02-08,1200328,202106,50607,50607,0
2021-02-08,1200302,202106,50607,50607,0
2021-02-08,1200351,202106,50607,50607,0
2021-02-08,1200708,202106,50608,50607,1
2021-02-08,1200500,202106,50607,50608,-1
2021-02-08,1200427,202106,50607,50607,0
2021-02-08,1200401,202106,50709,50607,102
2021-02-08,1200435,202106,50709,50709,0
2021-02-08,1200807,202106,50709,50709,0
2021-02-08,1200385,202106,50709,50709,0
2021-02-08,1200336,202106,50709,50709,0
2021-02-08,1200344,202106,50709,50709,0
2021-02-08,1200393,202106,50709,50709,0
2021-02-09,1200328,202106,50716,50709,7
2021-02-09,1200385,202106,50753,50716,37
2021-02-09,1200013,202106,50769,50753,16
2021-02-09,1200054,202106,50799,50769,30
2021-02-09,1200104,202106,50808,50799,9
2021-02-09,1200138,202106,50809,50808,1
2021-02-09,1200179,202106,50809,50809,0
2021-02-09,1200203,202106,50902,50809,93
2021-02-09,1200252,202106,50928,50902,26
2021-02-09,1200302,202106,50928,50928,0
2021-02-09,1200344,202106,50930,50928,2
2021-02-09,1200351,202106,50931,50930,1
2021-02-09,1200708,202106,50941,50931,10
2021-02-09,1200609,202106,51055,50941,114
2021-02-09,1200450,202106,51056,51055,1
2021-02-09,1200500,202106,51094,51056,38
2021-02-09,1200435,202106,51094,51094,0
2021-02-09,1200427,202106,51107,51094,13
2021-02-09,1200401,202106,51217,51107,110
2021-02-09,1200393,202106,51219,51217,2
2021-02-09,1200807,202106,51221,51219,2
2021-02-09,1200336,202106,51284,51221,63
2021-02-10,1200328,202106,51284,51284,0
2021-02-10,1200302,202106,51306,51284,22
2021-02-10,1200252,202106,51315,51306,9
2021-02-10,1200203,202106,51382,51315,67
2021-02-10,1200351,202106,51395,51382,13
2021-02-10,1200138,202106,51398,51395,3
2021-02-10,1200104,202106,51413,51398,15
2021-02-10,1200013,202106,51419,51413,6
2021-02-10,1200344,202106,51425,51419,6
2021-02-10,1200179,202106,51433,51425,8
2021-02-10,1200385,202106,51436,51433,3
2021-02-10,1200336,202106,51436,51436,0
2021-02-10,1200807,202106,51437,51436,1
2021-02-10,1200393,202106,51437,51437,0
2021-02-10,1200401,202106,51549,51437,112
2021-02-10,1200435,202106,51549,51549,0
2021-02-10,1200500,202106,51568,51549,19
2021-02-10,1200450,202106,51570,51568,2
2021-02-10,1200609,202106,51653,51570,83
2021-02-10,1200708,202106,51673,51653,20
2021-02-10,1200427,202106,51678,51673,5
2021-02-10,1200054,202106,51694,51678,16
2021-02-11,1200393,202106,51696,51694,2
2021-02-11,1200401,202106,51869,51696,173
2021-02-11,1200427,202106,51877,51869,8
2021-02-11,1200435,202106,51878,51877,1
2021-02-11,1200807,202106,51882,51878,4
2021-02-11,1200450,202106,51887,51882,5
2021-02-11,1200609,202106,51977,51887,90
2021-02-11,1200708,202106,51988,51977,11
2021-02-11,1200252,202106,51996,51988,8
2021-02-11,1200500,202106,52045,51996,49
2021-02-11,1200336,202106,52045,52045,0
2021-02-11,1200138,202106,52056,52045,11
2021-02-11,1200351,202106,52061,52056,5
2021-02-11,1200344,202106,52065,52061,4
2021-02-11,1200328,202106,52065,52065,0
2021-02-11,1200302,202106,52067,52065,2
2021-02-11,1200179,202106,52068,52067,1
2021-02-11,1200203,202106,52144,52068,76
2021-02-11,1200104,202106,52158,52144,14
2021-02-11,1200054,202106,52159,52158,1
2021-02-11,1200013,202106,52176,52159,17
2021-02-11,1200385,202106,52187,52176,11
2021-02-12,1200401,202106,52362,52187,175
2021-02-12,1200807,202106,52365,52362,3
2021-02-12,1200328,202106,52374,52365,9
2021-02-12,1200344,202106,52374,52374,0
2021-02-12,1200351,202106,52385,52374,11
2021-02-12,1200336,202106,52387,52385,2
2021-02-12,1200385,202106,52386,52387,-1
2021-02-12,1200393,202106,52386,52386,0
2021-02-12,1200252,202106,52387,52386,1
2021-02-12,1200427,202106,52399,52387,12
2021-02-12,1200609,202106,52400,52399,1
2021-02-12,1200500,202106,52423,52400,23
2021-02-12,1200708,202106,52451,52423,28
2021-02-12,1200013,202106,52451,52451,0
2021-02-12,1200054,202106,52460,52451,9
2021-02-12,1200104,202106,52461,52460,1
2021-02-12,1200435,202106,52461,52461,0
2021-02-12,1200179,202106,52461,52461,0
2021-02-12,1200203,202106,52562,52461,101
2021-02-12,1200302,202106,52561,52562,-1
2021-02-12,1200450,202106,52560,52561,-1
2021-02-12,1200138,202106,52563,52560,3
2021-02-13,1200336,202106,52563,52563,0
2021-02-13,1200393,202106,52563,52563,0
2021-02-13,1200401,202106,52704,52563,141
2021-02-13,1200179,202106,52706,52704,2
2021-02-13,1200203,202106,52774,52706,68
2021-02-13,1200252,202106,52801,52774,27
2021-02-13,1200302,202106,52803,52801,2
2021-02-13,1200328,202106,52808,52803,5
2021-02-13,1200344,202106,52809,52808,1
2021-02-13,1200351,202106,52821,52809,12
2021-02-13,1200385,202106,52829,52821,8
2021-02-13,1200807,202106,52831,52829,2
2021-02-13,1200708,202106,52826,52831,-5
2021-02-13,1200054,202106,52835,52826,9
2021-02-13,1200104,202106,52850,52835,15
2021-02-13,1200435,202106,52850,52850,0
2021-02-13,1200427,202106,52866,52850,16
2021-02-13,1200013,202106,52871,52866,5
2021-02-13,1200500,202106,52919,52871,48
2021-02-13,1200450,202106,52930,52919,11
2021-02-13,1200609,202106,52930,52930,0
2021-02-13,1200138,202106,52935,52930,5
2021-02-14,1200013,202107,52936,52935,1
2021-02-14,1200401,202107,53013,52936,77
2021-02-14,1200708,202107,53013,53013,0
2021-02-14,1200609,202107,53013,53013,0
2021-02-14,1200450,202107,53014,53013,1
2021-02-14,1200500,202107,53014,53014,0
2021-02-14,1200427,202107,53014,53014,0
2021-02-14,1200336,202107,53014,53014,0
2021-02-14,1200351,202107,53014,53014,0
2021-02-14,1200344,202107,53014,53014,0
2021-02-14,1200435,202107,53014,53014,0
2021-02-14,1200302,202107,53031,53014,17
2021-02-14,1200385,202107,53031,53031,0
2021-02-14,1200393,202107,53031,53031,0
2021-02-14,1200054,202107,53031,53031,0
2021-02-14,1200104,202107,53032,53031,1
2021-02-14,1200328,202107,53032,53032,0
2021-02-14,1200138,202107,53038,53032,6
2021-02-14,1200179,202107,53038,53038,0
2021-02-14,1200203,202107,53040,53038,2
2021-02-14,1200252,202107,53040,53040,0
2021-02-14,1200807,202107,53042,53040,2
2021-02-15,1200807,202107,53045,53042,3
2021-02-15,1200708,202107,53050,53045,5
2021-02-15,1200609,202107,53046,53050,-4
2021-02-15,1200450,202107,53047,53046,1
2021-02-15,1200500,202107,53062,53047,15
2021-02-15,1200435,202107,53062,53062,0
2021-02-15,1200427,202107,53087,53062,25
2021-02-15,1200401,202107,53255,53087,168
2021-02-15,1200393,202107,53255,53255,0
2021-02-15,1200385,202107,53257,53255,2
2021-02-15,1200344,202107,53262,53257,5
2021-02-15,1200351,202107,53261,53262,-1
2021-02-15,1200013,202107,53271,53261,10
2021-02-15,1200054,202107,53289,53271,18
2021-02-15,1200104,202107,53280,53289,-9
2021-02-15,1200138,202107,53280,53280,0
2021-02-15,1200336,202107,53278,53280,-2
2021-02-15,1200203,202107,53450,53278,172
2021-02-15,1200252,202107,53455,53450,5
2021-02-15,1200328,202107,53470,53455,15
2021-02-15,1200302,202107,53470,53470,0
2021-02-15,1200179,202107,53470,53470,0
2021-02-16,1200393,202107,53470,53470,0
2021-02-16,1200385,202107,53474,53470,4
2021-02-16,1200252,202107,53479,53474,5
2021-02-16,1200302,202107,53478,53479,-1
2021-02-16,1200328,202107,53478,53478,0
2021-02-16,1200344,202107,53478,53478,0
2021-02-16,1200351,202107,53478,53478,0
2021-02-16,1200336,202107,53479,53478,1
2021-02-16,1200807,202107,53478,53479,-1
2021-02-16,1200708,202107,53487,53478,9
2021-02-16,1200203,202107,53500,53487,13
2021-02-16,1200401,202107,53591,53500,91
2021-02-16,1200435,202107,53591,53591,0
2021-02-16,1200500,202107,53593,53591,2
2021-02-16,1200450,202107,53590,53593,-3
2021-02-16,1200609,202107,53591,53590,1
2021-02-16,1200054,202107,53590,53591,-1
2021-02-16,1200013,202107,53594,53590,4
2021-02-16,1200138,202107,53595,53594,1
2021-02-16,1200179,202107,53598,53595,3
2021-02-16,1200104,202107,53605,53598,7
2021-02-16,1200427,202107,53605,53605,0
2021-02-17,1200385,202107,53606,53605,1
2021-02-17,1200013,202107,53619,53606,13
2021-02-17,1200807,202107,53621,53619,2
2021-02-17,1200401,202107,53764,53621,143
2021-02-17,1200708,202107,53771,53764,7
2021-02-17,1200500,202107,53780,53771,9
2021-02-17,1200435,202107,53780,53780,0
2021-02-17,1200450,202107,53784,53780,4
2021-02-17,1200336,202107,53784,53784,0
2021-02-17,1200609,202107,53785,53784,1
2021-02-17,1200351,202107,53786,53785,1
2021-02-17,1200344,202107,53786,53786,0
2021-02-17,1200328,202107,53786,53786,0
2021-02-17,1200393,202107,53787,53786,1
2021-02-17,1200054,202107,53788,53787,1
2021-02-17,1200104,202107,53794,53788,6
2021-02-17,1200138,202107,53797,53794,3
2021-02-17,1200427,202107,53809,53797,12
2021-02-17,1200203,202107,53869,53809,60
2021-02-17,1200252,202107,53873,53869,4
2021-02-17,1200302,202107,53906,53873,33
2021-02-17,1200179,202107,53907,53906,1
2021-02-18,1200401,202107,54091,53907,184
2021-02-18,1200385,202107,54092,54091,1
2021-02-18,1200336,202107,54094,54092,2
2021-02-18,1200708,202107,54100,54094,6
2021-02-18,1200609,202107,54101,54100,1
2021-02-18,1200450,202107,54102,54101,1
2021-02-18,1200500,202107,54107,54102,5
2021-02-18,1200435,202107,54107,54107,0
2021-02-18,1200427,202107,54110,54107,3
2021-02-18,1200393,202107,54110,54110,0
2021-02-18,1200807,202107,54109,54110,-1
2021-02-18,1200013,202107,54111,54109,2
2021-02-18,1200351,202107,54127,54111,16
2021-02-18,1200328,202107,54127,54127,0
2021-02-18,1200302,202107,54132,54127,5
2021-02-18,1200252,202107,54132,54132,0
2021-02-18,1200203,202107,54146,54132,14
2021-02-18,1200179,202107,54145,54146,-1
2021-02-18,1200138,202107,54145,54145,0
2021-02-18,1200104,202107,54145,54145,0
2021-02-18,1200054,202107,54145,54145,0
2021-02-18,1200344,202107,54145,54145,0
2021-02-19,1200807,202107,54148,54145,3
2021-02-19,1200393,202107,54148,54148,0
2021-02-19,1200401,202107,54506,54148,358
2021-02-19,1200427,202107,54506,54506,0
2021-02-19,1200385,202107,54516,54506,10
2021-02-19,1200500,202107,54520,54516,4
2021-02-19,1200450,202107,54531,54520,11
2021-02-19,1200609,202107,54531,54531,0
2021-02-19,1200302,202107,54542,54531,11
2021-02-19,1200435,202107,54542,54542,0
2021-02-19,1200336,202107,54542,54542,0
2021-02-19,1200179,202107,54544,54542,2
2021-02-19,1200344,202107,54545,54544,1
2021-02-19,1200328,202107,54545,54545,0
2021-02-19,1200708,202107,54546,54545,1
2021-02-19,1200138,202107,54554,54546,8
2021-02-19,1200104,202107,54557,54554,3
2021-02-19,1200203,202107,54572,54557,15
2021-02-19,1200054,202107,54573,54572,1
2021-02-19,1200013,202107,54576,54573,3
2021-02-19,1200252,202107,54577,54576,1
2021-02-19,1200351,202107,54577,54577,0
2021-02-20,1200336,202107,54577,54577,0
2021-02-20,1200385,202107,54583,54577,6
2021-02-20,1200807,202107,54587,54583,4
2021-02-20,1200013,202107,54598,54587,11
2021-02-20,1200708,202107,54605,54598,7
2021-02-20,1200401,202107,54653,54605,48
2021-02-20,1200450,202107,54669,54653,16
2021-02-20,1200609,202107,54669,54669,0
2021-02-20,1200351,202107,54670,54669,1
2021-02-20,1200393,202107,54670,54670,0
2021-02-20,1200344,202107,54676,54670,6
2021-02-20,1200427,202107,54679,54676,3
2021-02-20,1200328,202107,54685,54679,6
2021-02-20,1200500,202107,54722,54685,37
2021-02-20,1200054,202107,54728,54722,6
2021-02-20,1200104,202107,54740,54728,12
2021-02-20,1200138,202107,54744,54740,4
2021-02-20,1200435,202107,54744,54744,0
2021-02-20,1200203,202107,54752,54744,8
2021-02-20,1200252,202107,54754,54752,2
2021-02-20,1200302,202107,54755,54754,1
2021-02-20,1200179,202107,54758,54755,3
2021-02-21,1200302,202108,54759,54758,1
2021-02-21,1200344,202108,54759,54759,0
2021-02-21,1200013,202108,54766,54759,7
2021-02-21,1200054,202108,54766,54766,0
2021-02-21,1200104,202108,54766,54766,0
2021-02-21,1200138,202108,54770,54766,4
2021-02-21,1200179,202108,54770,54770,0
2021-02-21,1200203,202108,54772,54770,2
2021-02-21,1200252,202108,54772,54772,0
2021-02-21,1200435,202108,54772,54772,0
2021-02-21,1200427,202108,54772,54772,0
2021-02-21,1200351,202108,54772,54772,0
2021-02-21,1200336,202108,54772,54772,0
2021-02-21,1200385,202108,54773,54772,1
2021-02-21,1200807,202108,54779,54773,6
2021-02-21,1200393,202108,54779,54779,0
2021-02-21,1200401,202108,54798,54779,19
2021-02-21,1200708,202108,54801,54798,3
2021-02-21,1200609,202108,54801,54801,0
2021-02-21,1200450,202108,54801,54801,0
2021-02-21,1200500,202108,54801,54801,0
2021-02-21,1200328,202108,54801,54801,0
2021-02-22,1200609,202108,54801,54801,0
2021-02-22,1200708,202108,54810,54801,9
2021-02-22,1200203,202108,54815,54810,5
2021-02-22,1200179,202108,54815,54815,0
2021-02-22,1200450,202108,54815,54815,0
2021-02-22,1200104,202108,54828,54815,13
2021-02-22,1200054,202108,54828,54828,0
2021-02-22,1200500,202108,54839,54828,11
2021-02-22,1200393,202108,54839,54839,0
2021-02-22,1200138,202108,54839,54839,0
2021-02-22,1200435,202108,54839,54839,0
2021-02-22,1200328,202108,54839,54839,0
2021-02-22,1200427,202108,54839,54839,0
2021-02-22,1200013,202108,54853,54839,14
2021-02-22,1200344,202108,54853,54853,0
2021-02-22,1200351,202108,54853,54853,0
2021-02-22,1200336,202108,54853,54853,0
2021-02-22,1200302,202108,54868,54853,15
2021-02-22,1200807,202108,54870,54868,2
2021-02-22,1200252,202108,54871,54870,1
2021-02-22,1200401,202108,54982,54871,111
2021-02-22,1200385,202108,54984,54982,2
2021-02-23,1200351,202108,54993,54984,9
2021-02-23,1200013,202108,54995,54993,2
2021-02-23,1200054,202108,54997,54995,2
2021-02-23,1200104,202108,54999,54997,2
2021-02-23,1200138,202108,54999,54999,0
2021-02-23,1200179,202108,54999,54999,0
2021-02-23,1200203,202108,55109,54999,110
2021-02-23,1200252,202108,55110,55109,1
2021-02-23,1200344,202108,55122,55110,12
2021-02-23,1200385,202108,55130,55122,8
2021-02-23,1200302,202108,55132,55130,2
2021-02-23,1200807,202108,55135,55132,3
2021-02-23,1200328,202108,55136,55135,1
2021-02-23,1200401,202108,55513,55136,377
2021-02-23,1200708,202108,55518,55513,5
2021-02-23,1200609,202108,55522,55518,4
2021-02-23,1200336,202108,55523,55522,1
2021-02-23,1200500,202108,55567,55523,44
2021-02-23,1200435,202108,55568,55567,1
2021-02-23,1200427,202108,55591,55568,23
2021-02-23,1200393,202108,55591,55591,0
2021-02-23,1200450,202108,55605,55591,14
2021-02-24,1200138,202108,55611,55605,6
2021-02-24,1200609,202108,55612,55611,1
2021-02-24,1200450,202108,55618,55612,6
2021-02-24,1200500,202108,55652,55618,34
2021-02-24,1200435,202108,55652,55652,0
2021-02-24,1200427,202108,55658,55652,6
2021-02-24,1200401,202108,55781,55658,123
2021-02-24,1200393,202108,55781,55781,0
2021-02-24,1200807,202108,55785,55781,4
2021-02-24,1200708,202108,55790,55785,5
2021-02-24,1200351,202108,55792,55790,2
2021-02-24,1200179,202108,55793,55792,1
2021-02-24,1200252,202108,55794,55793,1
2021-02-24,1200328,202108,55797,55794,3
2021-02-24,1200302,202108,55807,55797,10
2021-02-24,1200203,202108,55849,55807,42
2021-02-24,1200336,202108,55849,55849,0
2021-02-24,1200104,202108,55853,55849,4
2021-02-24,1200054,202108,55871,55853,18
2021-02-24,1200013,202108,55873,55871,2
2021-02-24,1200344,202108,55882,55873,9
2021-02-24,1200385,202108,55896,55882,14
2021-02-25,1200336,202108,55896,55896,0
2021-02-25,1200708,202108,55898,55896,2
2021-02-25,1200450,202108,55916,55898,18
2021-02-25,1200500,202108,55939,55916,23
2021-02-25,1200435,202108,55939,55939,0
2021-02-25,1200427,202108,55952,55939,13
2021-02-25,1200401,202108,56125,55952,173
2021-02-25,1200393,202108,56125,56125,0
2021-02-25,1200807,202108,56125,56125,0
2021-02-25,1200385,202108,56126,56125,1
2021-02-25,1200203,202108,56172,56126,46
2021-02-25,1200351,202108,56180,56172,8
2021-02-25,1200328,202108,56182,56180,2
2021-02-25,1200302,202108,56185,56182,3
2021-02-25,1200252,202108,56185,56185,0
2021-02-25,1200609,202108,56187,56185,2
2021-02-25,1200179,202108,56188,56187,1
2021-02-25,1200138,202108,56188,56188,0
2021-02-25,1200104,202108,56196,56188,8
2021-02-25,1200054,202108,56251,56196,55
2021-02-25,1200013,202108,56266,56251,15
2021-02-25,1200344,202108,56272,56266,6
2021-02-26,1200328,202108,56272,56272,0
2021-02-26,1200302,202108,56273,56272,1
2021-02-26,1200252,202108,56284,56273,11
2021-02-26,1200203,202108,56399,56284,115
2021-02-26,1200351,202108,56403,56399,4
2021-02-26,1200138,202108,56421,56403,18
2021-02-26,1200054,202108,56424,56421,3
2021-02-26,1200013,202108,56430,56424,6
2021-02-26,1200344,202108,56432,56430,2
2021-02-26,1200179,202108,56436,56432,4
2021-02-26,1200427,202108,56441,56436,5
2021-02-26,1200336,202108,56441,56441,0
2021-02-26,1200385,202108,56462,56441,21
2021-02-26,1200104,202108,56467,56462,5
2021-02-26,1200708,202108,56487,56467,20
2021-02-26,1200609,202108,56488,56487,1
2021-02-26,1200500,202108,56504,56488,16
2021-02-26,1200450,202108,56513,56504,9
2021-02-26,1200401,202108,56743,56513,230
2021-02-26,1200393,202108,56743,56743,0
2021-02-26,1200807,202108,56746,56743,3
2021-02-26,1200435,202108,56746,56746,0
2021-02-27,1200807,202108,56748,56746,2
2021-02-27,1200708,202108,56759,56748,11
2021-02-27,1200609,202108,56762,56759,3
2021-02-27,1200450,202108,56778,56762,16
2021-02-27,1200500,202108,56826,56778,48
2021-02-27,1200435,202108,56845,56826,19
2021-02-27,1200427,202108,56857,56845,12
2021-02-27,1200401,202108,57131,56857,274
2021-02-27,1200393,202108,57133,57131,2
2021-02-27,1200385,202108,57154,57133,21
2021-02-27,1200336,202108,57171,57154,17
2021-02-27,1200344,202108,57171,57171,0
2021-02-27,1200351,202108,57178,57171,7
2021-02-27,1200054,202108,57202,57178,24
2021-02-27,1200104,202108,57210,57202,8
2021-02-27,1200138,202108,57212,57210,2
2021-02-27,1200013,202108,57223,57212,11
2021-02-27,1200203,202108,57325,57223,102
2021-02-27,1200252,202108,57325,57325,0
2021-02-27,1200302,202108,57351,57325,26
2021-02-27,1200328,202108,57352,57351,1
2021-02-27,1200179,202108,57352,57352,0
2021-02-28,1200393,202109,57352,57352,0
2021-02-28,1200252,202109,57357,57352,5
2021-02-28,1200609,202109,57357,57357,0
2021-02-28,1200336,202109,57357,57357,0
2021-02-28,1200401,202109,57504,57357,147
2021-02-28,1200344,202109,57508,57504,4
2021-02-28,1200328,202109,57508,57508,0
2021-02-28,1200302,202109,57508,57508,0
2021-02-28,1200385,202109,57520,57508,12
2021-02-28,1200351,202109,57520,57520,0
2021-02-28,1200427,202109,57520,57520,0
2021-02-28,1200435,202109,57520,57520,0
2021-02-28,1200500,202109,57521,57520,1
2021-02-28,1200450,202109,57523,57521,2
2021-02-28,1200807,202109,57526,57523,3
2021-02-28,1200203,202109,57530,57526,4
2021-02-28,1200179,202109,57530,57530,0
2021-02-28,1200138,202109,57536,57530,6
2021-02-28,1200104,202109,57537,57536,1
2021-02-28,1200054,202109,57545,57537,8
2021-02-28,1200013,202109,57547,57545,2
2021-02-28,1200708,202109,57549,57547,2
2021-03-01,1200351,202109,57549,57549,0
2021-03-01,1200344,202109,57553,57549,4
2021-03-01,1200328,202109,57553,57553,0
2021-03-01,1200302,202109,57554,57553,1
2021-03-01,1200609,202109,57557,57554,3
2021-03-01,1200203,202109,57560,57557,3
2021-03-01,1200179,202109,57561,57560,1
2021-03-01,1200138,202109,57572,57561,11
2021-03-01,1200336,202109,57572,57572,0
2021-03-01,1200252,202109,57575,57572,3
2021-03-01,1200385,202109,57576,57575,1
2021-03-01,1200807,202109,57582,57576,6
2021-03-01,1200393,202109,57582,57582,0
2021-03-01,1200013,202109,57601,57582,19
2021-03-01,1200104,202109,57606,57601,5
2021-03-01,1200708,202109,57616,57606,10
2021-03-01,1200450,202109,57619,57616,3
2021-03-01,1200054,202109,57619,57619,0
2021-03-01,1200435,202109,57626,57619,7
2021-03-01,1200427,202109,57629,57626,3
2021-03-01,1200401,202109,57897,57629,268
2021-03-01,1200500,202109,57909,57897,12
2021-03-02,1200344,202109,57908,57909,-1
2021-03-02,1200013,202109,57907,57908,-1
2021-03-02,1200104,202109,57907,57907,0
2021-03-02,1200138,202109,57909,57907,2
2021-03-02,1200179,202109,57909,57909,0
2021-03-02,1200203,202109,57908,57909,-1
2021-03-02,1200252,202109,57907,57908,-1
2021-03-02,1200302,202109,57937,57907,30
2021-03-02,1200328,202109,57936,57937,-1
2021-03-02,1200351,202109,57935,57936,-1
2021-03-02,1200435,202109,57935,57935,0
2021-03-02,1200708,202109,57935,57935,0
2021-03-02,1200807,202109,57933,57935,-2
2021-03-02,1200393,202109,57931,57933,-2
2021-03-02,1200054,202109,57931,57931,0
2021-03-02,1200401,202109,58103,57931,172
2021-03-02,1200336,202109,58103,58103,0
2021-03-02,1200385,202109,58101,58103,-2
2021-03-02,1200500,202109,58103,58101,2
2021-03-02,1200450,202109,58100,58103,-3
2021-03-02,1200609,202109,58094,58100,-6
2021-03-02,1200427,202109,58096,58094,2
2021-03-03,1200302,202109,58097,58096,1
2021-03-03,1200013,202109,58109,58097,12
2021-03-03,1200609,202109,58110,58109,1
2021-03-03,1200450,202109,58115,58110,5
2021-03-03,1200054,202109,58133,58115,18
2021-03-03,1200104,202109,58143,58133,10
2021-03-03,1200138,202109,58144,58143,1
2021-03-03,1200179,202109,58145,58144,1
2021-03-03,1200203,202109,58155,58145,10
2021-03-03,1200252,202109,58156,58155,1
2021-03-03,1200328,202109,58158,58156,2
2021-03-03,1200344,202109,58167,58158,9
2021-03-03,1200351,202109,58197,58167,30
2021-03-03,1200708,202109,58210,58197,13
2021-03-03,1200500,202109,58247,58210,37
2021-03-03,1200427,202109,58250,58247,3
2021-03-03,1200401,202109,58462,58250,212
2021-03-03,1200435,202109,58470,58462,8
2021-03-03,1200807,202109,58485,58470,15
2021-03-03,1200385,202109,58500,58485,15
2021-03-03,1200336,202109,58503,58500,3
2021-03-03,1200393,202109,58521,58503,18
2021-03-04,1200328,202109,58520,58521,-1
2021-03-04,1200013,202109,58527,58520,7
2021-03-04,1200054,202109,58529,58527,2
2021-03-04,1200104,202109,58530,58529,1
2021-03-04,1200138,202109,58559,58530,29
2021-03-04,1200179,202109,58558,58559,-1
2021-03-04,1200203,202109,58595,58558,37
2021-03-04,1200252,202109,58596,58595,1
2021-03-04,1200302,202109,58594,58596,-2
2021-03-04,1200344,202109,58597,58594,3
2021-03-04,1200385,202109,58594,58597,-3
2021-03-04,1200708,202109,58608,58594,14
2021-03-04,1200336,202109,58601,58608,-7
2021-03-04,1200807,202109,58614,58601,13
2021-03-04,1200393,202109,58615,58614,1
2021-03-04,1200401,202109,58830,58615,215
2021-03-04,1200351,202109,58831,58830,1
2021-03-04,1200435,202109,58833,58831,2
2021-03-04,1200500,202109,58851,58833,18
2021-03-04,1200450,202109,58861,58851,10
2021-03-04,1200609,202109,58890,58861,29
2021-03-04,1200427,202109,58899,58890,9
2021-03-05,1200328,202109,58899,58899,0
2021-03-05,1200013,202109,58908,58899,9
2021-03-05,1200054,202109,58915,58908,7
2021-03-05,1200104,202109,58923,58915,8
2021-03-05,1200138,202109,58939,58923,16
2021-03-05,1200179,202109,58941,58939,2
2021-03-05,1200203,202109,59053,58941,112
2021-03-05,1200252,202109,59055,59053,2
2021-03-05,1200302,202109,59078,59055,23
2021-03-05,1200336,202109,59079,59078,1
2021-03-05,1200344,202109,59081,59079,2
2021-03-05,1200385,202109,59100,59081,19
2021-03-05,1200500,202109,59150,59100,50
2021-03-05,1200401,202109,59461,59150,311
2021-03-05,1200708,202109,59483,59461,22
2021-03-05,1200609,202109,59502,59483,19
2021-03-05,1200351,202109,59502,59502,0
2021-03-05,1200435,202109,59504,59502,2
2021-03-05,1200427,202109,59504,59504,0
2021-03-05,1200393,202109,59504,59504,0
2021-03-05,1200807,202109,59512,59504,8
2021-03-05,1200450,202109,59515,59512,3
2021-03-06,1200336,202109,59513,59515,-2
2021-03-06,1200609,202109,59535,59513,22
2021-03-06,1200450,202109,59551,59535,16
2021-03-06,1200500,202109,59603,59551,52
2021-03-06,1200435,202109,59610,59603,7
2021-03-06,1200427,202109,59613,59610,3
2021-03-06,1200401,202109,59911,59613,298
2021-03-06,1200393,202109,59911,59911,0
2021-03-06,1200351,202109,59923,59911,12
2021-03-06,1200807,202109,59933,59923,10
2021-03-06,1200708,202109,59936,59933,3
2021-03-06,1200138,202109,59953,59936,17
2021-03-06,1200013,202109,59987,59953,34
2021-03-06,1200054,202109,59990,59987,3
2021-03-06,1200104,202109,60023,59990,33
2021-03-06,1200385,202109,60032,60023,9
2021-03-06,1200179,202109,60034,60032,2
2021-03-06,1200252,202109,60041,60034,7
2021-03-06,1200302,202109,60045,60041,4
2021-03-06,1200328,202109,60046,60045,1
2021-03-06,1200203,202109,60082,60046,36
2021-03-06,1200344,202109,60085,60082,3
2021-03-07,1200252,202110,60085,60085,0
2021-03-07,1200609,202110,60084,60085,-1
2021-03-07,1200336,202110,60084,60084,0
2021-03-07,1200351,202110,60084,60084,0
2021-03-07,1200393,202110,60084,60084,0
2021-03-07,1200328,202110,60083,60084,-1
2021-03-07,1200302,202110,60082,60083,-1
2021-03-07,1200385,202110,60093,60082,11
2021-03-07,1200344,202110,60092,60093,-1
2021-03-07,1200401,202110,60226,60092,134
2021-03-07,1200427,202110,60225,60226,-1
2021-03-07,1200708,202110,60225,60225,0
2021-03-07,1200500,202110,60245,60225,20
2021-03-07,1200450,202110,60246,60245,1
2021-03-07,1200807,202110,60261,60246,15
2021-03-07,1200203,202110,60263,60261,2
2021-03-07,1200179,202110,60272,60263,9
2021-03-07,1200138,202110,60299,60272,27
2021-03-07,1200104,202110,60300,60299,1
2021-03-07,1200054,202110,60299,60300,-1
2021-03-07,1200013,202110,60303,60299,4
2021-03-07,1200435,202110,60303,60303,0
2021-03-08,1200344,202110,60310,60303,7
2021-03-08,1200328,202110,60310,60310,0
2021-03-08,1200302,202110,60343,60310,33
2021-03-08,1200252,202110,60351,60343,8
2021-03-08,1200807,202110,60355,60351,4
2021-03-08,1200179,202110,60355,60355,0
2021-03-08,1200401,202110,60540,60355,185
2021-03-08,1200393,202110,60540,60540,0
2021-03-08,1200351,202110,60561,60540,21
2021-03-08,1200203,202110,60591,60561,30
2021-03-08,1200336,202110,60591,60591,0
2021-03-08,1200450,202110,60595,60591,4
2021-03-08,1200708,202110,60595,60595,0
2021-03-08,1200609,202110,60598,60595,3
2021-03-08,1200500,202110,60619,60598,21
2021-03-08,1200138,202110,60625,60619,6
2021-03-08,1200427,202110,60641,60625,16
2021-03-08,1200435,202110,60641,60641,0
2021-03-08,1200104,202110,60648,60641,7
2021-03-08,1200013,202110,60665,60648,17
2021-03-08,1200054,202110,60669,60665,4
2021-03-08,1200385,202110,60671,60669,2
2021-03-09,1200336,202110,60672,60671,1
2021-03-09,1200427,202110,60671,60672,-1
2021-03-09,1200401,202110,60698,60671,27
2021-03-09,1200435,202110,60698,60698,0
2021-03-09,1200328,202110,60698,60698,0
2021-03-09,1200450,202110,60699,60698,1
2021-03-09,1200609,202110,60705,60699,6
2021-03-09,1200708,202110,60705,60705,0
2021-03-09,1200351,202110,60711,60705,6
2021-03-09,1200500,202110,60711,60711,0
2021-03-09,1200013,202110,60723,60711,12
2021-03-09,1200203,202110,60726,60723,3
2021-03-09,1200385,202110,60726,60726,0
2021-03-09,1200344,202110,60730,60726,4
2021-03-09,1200054,202110,60730,60730,0
2021-03-09,1200104,202110,60731,60730,1
2021-03-09,1200807,202110,60731,60731,0
2021-03-09,1200393,202110,60731,60731,0
2021-03-09,1200179,202110,60732,60731,1
2021-03-09,1200252,202110,60736,60732,4
2021-03-09,1200302,202110,60736,60736,0
2021-03-09,1200138,202110,60736,60736,0
2021-03-10,1200344,202110,60740,60736,4
2021-03-10,1200302,202110,60744,60740,4
2021-03-10,1200013,202110,60743,60744,-1
2021-03-10,1200054,202110,60751,60743,8
2021-03-10,1200104,202110,60751,60751,0
2021-03-10,1200138,202110,60755,60751,4
2021-03-10,1200179,202110,60755,60755,0
2021-03-10,1200203,202110,60775,60755,20
2021-03-10,1200393,202110,60775,60775,0
2021-03-10,1200328,202110,60774,60775,-1
2021-03-10,1200336,202110,60775,60774,1
2021-03-10,1200351,202110,60775,60775,0
2021-03-10,1200500,202110,60797,60775,22
2021-03-10,1200807,202110,60800,60797,3
2021-03-10,1200435,202110,60800,60800,0
2021-03-10,1200401,202110,61120,60800,320
2021-03-10,1200450,202110,61122,61120,2
2021-03-10,1200609,202110,61122,61122,0
2021-03-10,1200708,202110,61122,61122,0
2021-03-10,1200427,202110,61125,61122,3
2021-03-10,1200252,202110,61125,61125,0
2021-03-10,1200385,202110,61136,61125,11
2021-03-11,1200435,202110,61136,61136,0
2021-03-11,1200427,202110,61140,61136,4
2021-03-11,1200500,202110,61161,61140,21
2021-03-11,1200450,202110,61168,61161,7
2021-03-11,1200385,202110,61168,61168,0
2021-03-11,1200054,202110,61173,61168,5
2021-03-11,1200393,202110,61173,61173,0
2021-03-11,1200401,202110,61243,61173,70
2021-03-11,1200609,202110,61252,61243,9
2021-03-11,1200807,202110,61269,61252,17
2021-03-11,1200708,202110,61275,61269,6
2021-03-11,1200104,202110,61280,61275,5
2021-03-11,1200013,202110,61289,61280,9
2021-03-11,1200203,202110,61347,61289,58
2021-03-11,1200138,202110,61388,61347,41
2021-03-11,1200252,202110,61389,61388,1
2021-03-11,1200179,202110,61388,61389,-1
2021-03-11,1200328,202110,61388,61388,0
2021-03-11,1200344,202110,61403,61388,15
2021-03-11,1200351,202110,61409,61403,6
2021-03-11,1200336,202110,61408,61409,-1
2021-03-11,1200302,202110,61409,61408,1
2021-03-12,1200344,202110,61411,61409,2
2021-03-12,1200351,202110,61414,61411,3
2021-03-12,1200013,202110,61414,61414,0
2021-03-12,1200054,202110,61430,61414,16
2021-03-12,1200104,202110,61441,61430,11
2021-03-12,1200138,202110,61459,61441,18
2021-03-12,1200179,202110,61459,61459,0
2021-03-12,1200203,202110,61543,61459,84
2021-03-12,1200302,202110,61544,61543,1
2021-03-12,1200328,202110,61545,61544,1
2021-03-12,1200385,202110,61559,61545,14
2021-03-12,1200336,202110,61560,61559,1
2021-03-12,1200807,202110,61573,61560,13
2021-03-12,1200401,202110,61638,61573,65
2021-03-12,1200708,202110,61645,61638,7
2021-03-12,1200609,202110,61652,61645,7
2021-03-12,1200450,202110,61652,61652,0
2021-03-12,1200252,202110,61654,61652,2
2021-03-12,1200435,202110,61654,61654,0
2021-03-12,1200427,202110,61666,61654,12
2021-03-12,1200393,202110,61666,61666,0
2021-03-12,1200500,202110,61724,61666,58
2021-03-13,1200054,202110,61738,61724,14
2021-03-13,1200609,202110,61749,61738,11
2021-03-13,1200450,202110,61759,61749,10
2021-03-13,1200708,202110,61772,61759,13
2021-03-13,1200435,202110,61773,61772,1
2021-03-13,1200427,202110,61779,61773,6
2021-03-13,1200401,202110,61979,61779,200
2021-03-13,1200393,202110,61979,61979,0
2021-03-13,1200807,202110,61985,61979,6
2021-03-13,1200351,202110,62009,61985,24
2021-03-13,1200500,202110,62058,62009,49
2021-03-13,1200179,202110,62058,62058,0
2021-03-13,1200344,202110,62083,62058,25
2021-03-13,1200013,202110,62114,62083,31
2021-03-13,1200104,202110,62132,62114,18
2021-03-13,1200138,202110,62134,62132,2
2021-03-13,1200385,202110,62156,62134,22
2021-03-13,1200203,202110,62336,62156,180
2021-03-13,1200302,202110,62337,62336,1
2021-03-13,1200328,202110,62337,62337,0
2021-03-13,1200252,202110,62344,62337,7
2021-03-13,1200336,202110,62347,62344,3
2021-03-14,1200807,202111,62362,62347,15
2021-03-14,1200393,202111,62362,62362,0
2021-03-14,1200401,202111,62552,62362,190
2021-03-14,1200427,202111,62552,62552,0
2021-03-14,1200203,202111,62553,62552,1
2021-03-14,1200450,202111,62553,62553,0
2021-03-14,1200708,202111,62557,62553,4
2021-03-14,1200385,202111,62572,62557,15
2021-03-14,1200435,202111,62572,62572,0
2021-03-14,1200336,202111,62572,62572,0
2021-03-14,1200500,202111,62584,62572,12
2021-03-14,1200344,202111,62584,62584,0
2021-03-14,1200328,202111,62584,62584,0
2021-03-14,1200302,202111,62608,62584,24
2021-03-14,1200252,202111,62611,62608,3
2021-03-14,1200609,202111,62621,62611,10
2021-03-14,1200179,202111,62624,62621,3
2021-03-14,1200138,202111,62633,62624,9
2021-03-14,1200104,202111,62634,62633,1
2021-03-14,1200054,202111,62635,62634,1
2021-03-14,1200013,202111,62634,62635,-1
2021-03-14,1200351,202111,62635,62634,1
2021-03-15,1200328,202111,62635,62635,0
2021-03-15,1200302,202111,62638,62635,3
2021-03-15,1200252,202111,62641,62638,3
2021-03-15,1200203,202111,62640,62641,-1
2021-03-15,1200351,202111,62639,62640,-1
2021-03-15,1200138,202111,62673,62639,34
2021-03-15,1200104,202111,62676,62673,3
2021-03-15,1200054,202111,62676,62676,0
2021-03-15,1200344,202111,62678,62676,2
2021-03-15,1200179,202111,62683,62678,5
2021-03-15,1200427,202111,62683,62683,0
2021-03-15,1200393,202111,62683,62683,0
2021-03-15,1200385,202111,62688,62683,5
2021-03-15,1200807,202111,62688,62688,0
2021-03-15,1200401,202111,62927,62688,239
2021-03-15,1200500,202111,62928,62927,1
2021-03-15,1200450,202111,62931,62928,3
2021-03-15,1200609,202111,62932,62931,1
2021-03-15,1200708,202111,62934,62932,2
2021-03-15,1200013,202111,62955,62934,21
2021-03-15,1200435,202111,62955,62955,0
2021-03-15,1200336,202111,62955,62955,0
2021-03-16,1200401,202111,63078,62955,123
2021-03-16,1200807,202111,63079,63078,1
2021-03-16,1200393,202111,63079,63079,0
2021-03-16,1200427,202111,63085,63079,6
2021-03-16,1200385,202111,63081,63085,-4
2021-03-16,1200500,202111,63186,63081,105
2021-03-16,1200450,202111,63195,63186,9
2021-03-16,1200609,202111,63196,63195,1
2021-03-16,1200708,202111,63201,63196,5
2021-03-16,1200435,202111,63201,63201,0
2021-03-16,1200336,202111,63203,63201,2
2021-03-16,1200179,202111,63205,63203,2
2021-03-16,1200351,202111,63239,63205,34
2021-03-16,1200328,202111,63239,63239,0
2021-03-16,1200302,202111,63285,63239,46
2021-03-16,1200252,202111,63285,63285,0
2021-03-16,1200203,202111,63352,63285,67
2021-03-16,1200344,202111,63360,63352,8
2021-03-16,1200138,202111,63359,63360,-1
2021-03-16,1200104,202111,63360,63359,1
2021-03-16,1200054,202111,63366,63360,6
2021-03-16,1200013,202111,63393,63366,27
2021-03-17,1200393,202111,63401,63393,8
2021-03-17,1200385,202111,63407,63401,6
2021-03-17,1200302,202111,63408,63407,1
2021-03-17,1200328,202111,63408,63408,0
2021-03-17,1200344,202111,63419,63408,11
2021-03-17,1200351,202111,63425,63419,6
2021-03-17,1200336,202111,63426,63425,1
2021-03-17,1200609,202111,63452,63426,26
2021-03-17,1200252,202111,63453,63452,1
2021-03-17,1200401,202111,63520,63453,67
2021-03-17,1200427,202111,63535,63520,15
2021-03-17,1200708,202111,63550,63535,15
2021-03-17,1200500,202111,63594,63550,44
2021-03-17,1200450,202111,63595,63594,1
2021-03-17,1200807,202111,63614,63595,19
2021-03-17,1200203,202111,63704,63614,90
2021-03-17,1200179,202111,63704,63704,0
2021-03-17,1200138,202111,63713,63704,9
2021-03-17,1200104,202111,63729,63713,16
2021-03-17,1200054,202111,63729,63729,0
2021-03-17,1200013,202111,63731,63729,2
2021-03-17,1200435,202111,63736,63731,5
2021-03-18,1200351,202111,63752,63736,16
2021-03-18,1200344,202111,63773,63752,21
2021-03-18,1200328,202111,63773,63773,0
2021-03-18,1200302,202111,63778,63773,5
2021-03-18,1200336,202111,63779,63778,1
2021-03-18,1200203,202111,63833,63779,54
2021-03-18,1200179,202111,63833,63833,0
2021-03-18,1200138,202111,63848,63833,15
2021-03-18,1200609,202111,63875,63848,27
2021-03-18,1200252,202111,63881,63875,6
2021-03-18,1200385,202111,63882,63881,1
2021-03-18,1200054,202111,63886,63882,4
2021-03-18,1200393,202111,63888,63886,2
2021-03-18,1200401,202111,64120,63888,232
2021-03-18,1200427,202111,64122,64120,2
2021-03-18,1200435,202111,64123,64122,1
2021-03-18,1200500,202111,64150,64123,27
2021-03-18,1200450,202111,64156,64150,6
2021-03-18,1200708,202111,64177,64156,21
2021-03-18,1200104,202111,64197,64177,20
2021-03-18,1200013,202111,64238,64197,41
2021-03-18,1200807,202111,64249,64238,11
2021-03-19,1200328,202111,64249,64249,0
2021-03-19,1200302,202111,64256,64249,7
2021-03-19,1200252,202111,64259,64256,3
2021-03-19,1200203,202111,64284,64259,25
2021-03-19,1200435,202111,64285,64284,1
2021-03-19,1200138,202111,64301,64285,16
2021-03-19,1200104,202111,64309,64301,8
2021-03-19,1200013,202111,64322,64309,13
2021-03-19,1200344,202111,64348,64322,26
2021-03-19,1200179,202111,64350,64348,2
2021-03-19,1200351,202111,64356,64350,6
2021-03-19,1200807,202111,64368,64356,12
2021-03-19,1200708,202111,64367,64368,-1
2021-03-19,1200393,202111,64367,64367,0
2021-03-19,1200054,202111,64395,64367,28
2021-03-19,1200401,202111,64781,64395,386
2021-03-19,1200427,202111,64782,64781,1
2021-03-19,1200336,202111,64782,64782,0
2021-03-19,1200500,202111,64834,64782,52
2021-03-19,1200450,202111,64842,64834,8
2021-03-19,1200609,202111,64870,64842,28
2021-03-19,1200385,202111,64893,64870,23
2021-03-20,1200302,202111,64909,64893,16
2021-03-20,1200609,202111,64922,64909,13
2021-03-20,1200450,202111,64938,64922,16
2021-03-20,1200054,202111,64961,64938,23
2021-03-20,1200104,202111,64975,64961,14
2021-03-20,1200138,202111,64990,64975,15
2021-03-20,1200179,202111,64989,64990,-1
2021-03-20,1200203,202111,64997,64989,8
2021-03-20,1200252,202111,65003,64997,6
2021-03-20,1200013,202111,65028,65003,25
2021-03-20,1200328,202111,65034,65028,6
2021-03-20,1200351,202111,65041,65034,7
2021-03-20,1200336,202111,65041,65041,0
2021-03-20,1200385,202111,65041,65041,0
2021-03-20,1200807,202111,65053,65041,12
2021-03-20,1200393,202111,65057,65053,4
2021-03-20,1200401,202111,65205,65057,148
2021-03-20,1200427,202111,65207,65205,2
2021-03-20,1200500,202111,65266,65207,59
2021-03-20,1200708,202111,65276,65266,10
2021-03-20,1200435,202111,65275,65276,-1
2021-03-20,1200344,202111,65290,65275,15
2021-03-21,1200302,202112,65310,65290,20
2021-03-21,1200252,202112,65310,65310,0
2021-03-21,1200203,202112,65310,65310,0
2021-03-21,1200179,202112,65308,65310,-2
2021-03-21,1200328,202112,65308,65308,0
2021-03-21,1200104,202112,65305,65308,-3
2021-03-21,1200054,202112,65304,65305,-1
2021-03-21,1200013,202112,65305,65304,1
2021-03-21,1200385,202112,65320,65305,15
2021-03-21,1200138,202112,65326,65320,6
2021-03-21,1200344,202112,65326,65326,0
2021-03-21,1200336,202112,65326,65326,0
2021-03-21,1200708,202112,65322,65326,-4
2021-03-21,1200807,202112,65326,65322,4
2021-03-21,1200393,202112,65325,65326,-1
2021-03-21,1200401,202112,65431,65325,106
2021-03-21,1200427,202112,65431,65431,0
2021-03-21,1200351,202112,65431,65431,0
2021-03-21,1200500,202112,65461,65431,30
2021-03-21,1200450,202112,65457,65461,-4
2021-03-21,1200609,202112,65461,65457,4
2021-03-21,1200435,202112,65461,65461,0
2021-03-22,1200351,202112,65475,65461,14
2021-03-22,1200013,202112,65491,65475,16
2021-03-22,1200104,202112,65500,65491,9
2021-03-22,1200138,202112,65504,65500,4
2021-03-22,1200179,202112,65528,65504,24
2021-03-22,1200203,202112,65614,65528,86
2021-03-22,1200252,202112,65624,65614,10
2021-03-22,1200302,202112,65627,65624,3
2021-03-22,1200344,202112,65630,65627,3
2021-03-22,1200427,202112,65636,65630,6
2021-03-22,1200328,202112,65640,65636,4
2021-03-22,1200385,202112,65643,65640,3
2021-03-22,1200500,202112,65680,65643,37
2021-03-22,1200054,202112,65699,65680,19
2021-03-22,1200708,202112,65701,65699,2
2021-03-22,1200609,202112,65711,65701,10
2021-03-22,1200336,202112,65712,65711,1
2021-03-22,1200435,202112,65712,65712,0
2021-03-22,1200401,202112,65959,65712,247
2021-03-22,1200393,202112,65959,65959,0
2021-03-22,1200807,202112,65968,65959,9
2021-03-22,1200450,202112,65974,65968,6
2021-03-23,1200385,202112,65975,65974,1
2021-03-23,1200708,202112,65975,65975,0
2021-03-23,1200609,202112,65975,65975,0
2021-03-23,1200450,202112,65977,65975,2
2021-03-23,1200500,202112,65993,65977,16
2021-03-23,1200435,202112,65995,65993,2
2021-03-23,1200427,202112,65995,65995,0
2021-03-23,1200401,202112,66254,65995,259
2021-03-23,1200393,202112,66254,66254,0
2021-03-23,1200807,202112,66256,66254,2
2021-03-23,1200336,202112,66256,66256,0
2021-03-23,1200351,202112,66256,66256,0
2021-03-23,1200344,202112,66257,66256,1
2021-03-23,1200328,202112,66257,66257,0
2021-03-23,1200302,202112,66301,66257,44
2021-03-23,1200252,202112,66301,66301,0
2021-03-23,1200179,202112,66305,66301,4
2021-03-23,1200013,202112,66305,66305,0
2021-03-23,1200138,202112,66306,66305,1
2021-03-23,1200104,202112,66306,66306,0
2021-03-23,1200054,202112,66306,66306,0
2021-03-23,1200203,202112,66305,66306,-1
2021-03-24,1200427,202112,66309,66305,4
2021-03-24,1200807,202112,66336,66309,27
2021-03-24,1200328,202112,66342,66336,6
2021-03-24,1200344,202112,66350,66342,8
2021-03-24,1200351,202112,66357,66350,7
2021-03-24,1200336,202112,66358,66357,1
2021-03-24,1200385,202112,66362,66358,4
2021-03-24,1200393,202112,66367,66362,5
2021-03-24,1200252,202112,66381,66367,14
2021-03-24,1200401,202112,66559,66381,178
2021-03-24,1200609,202112,66578,66559,19
2021-03-24,1200435,202112,66589,66578,11
2021-03-24,1200450,202112,66589,66589,0
2021-03-24,1200302,202112,66609,66589,20
2021-03-24,1200203,202112,66676,66609,67
2021-03-24,1200179,202112,66675,66676,-1
2021-03-24,1200138,202112,66676,66675,1
2021-03-24,1200104,202112,66697,66676,21
2021-03-24,1200054,202112,66699,66697,2
2021-03-24,1200013,202112,66753,66699,54
2021-03-24,1200708,202112,66753,66753,0
2021-03-24,1200500,202112,66759,66753,6
2021-03-25,1200351,202112,66768,66759,9
2021-03-25,1200344,202112,66802,66768,34
2021-03-25,1200328,202112,66804,66802,2
2021-03-25,1200302,202112,66854,66804,50
2021-03-25,1200393,202112,66865,66854,11
2021-03-25,1200203,202112,66902,66865,37
2021-03-25,1200179,202112,66903,66902,1
2021-03-25,1200401,202112,67093,66903,190
2021-03-25,1200336,202112,67095,67093,2
2021-03-25,1200252,202112,67106,67095,11
2021-03-25,1200385,202112,67111,67106,5
2021-03-25,1200807,202112,67119,67111,8
2021-03-25,1200708,202112,67122,67119,3
2021-03-25,1200054,202112,67122,67122,0
2021-03-25,1200104,202112,67123,67122,1
2021-03-25,1200435,202112,67137,67123,14
2021-03-25,1200427,202112,67138,67137,1
2021-03-25,1200013,202112,67187,67138,49
2021-03-25,1200500,202112,67256,67187,69
2021-03-25,1200450,202112,67261,67256,5
2021-03-25,1200609,202112,67295,67261,34
2021-03-25,1200138,202112,67307,67295,12
2021-03-26,1200351,202112,67309,67307,2
2021-03-26,1200450,202112,67313,67309,4
2021-03-26,1200401,202112,67525,67313,212
2021-03-26,1200435,202112,67544,67525,19
2021-03-26,1200708,202112,67550,67544,6
2021-03-26,1200427,202112,67550,67550,0
2021-03-26,1200609,202112,67595,67550,45
2021-03-26,1200500,202112,67646,67595,51
2021-03-26,1200336,202112,67649,67646,3
2021-03-26,1200013,202112,67658,67649,9
2021-03-26,1200344,202112,67675,67658,17
2021-03-26,1200385,202112,67686,67675,11
2021-03-26,1200302,202112,67689,67686,3
2021-03-26,1200252,202112,67697,67689,8
2021-03-26,1200203,202112,67724,67697,27
2021-03-26,1200179,202112,67737,67724,13
2021-03-26,1200138,202112,67743,67737,6
2021-03-26,1200807,202112,67761,67743,18
2021-03-26,1200104,202112,67785,67761,24
2021-03-26,1200054,202112,67790,67785,5
2021-03-26,1200393,202112,67791,67790,1
2021-03-26,1200328,202112,67792,67791,1
2021-03-27,1200401,202112,68035,67792,243
2021-03-27,1200427,202112,68047,68035,12
2021-03-27,1200435,202112,68073,68047,26
2021-03-27,1200500,202112,68152,68073,79
2021-03-27,1200393,202112,68156,68152,4
2021-03-27,1200609,202112,68419,68156,263
2021-03-27,1200708,202112,68432,68419,13
2021-03-27,1200351,202112,68433,68432,1
2021-03-27,1200344,202112,68454,68433,21
2021-03-27,1200450,202112,68464,68454,10
2021-03-27,1200807,202112,68473,68464,9
2021-03-27,1200385,202112,68480,68473,7
2021-03-27,1200336,202112,68482,68480,2
2021-03-27,1200302,202112,68493,68482,11
2021-03-27,1200328,202112,68496,68493,3
2021-03-27,1200252,202112,68500,68496,4
2021-03-27,1200203,202112,68552,68500,52
2021-03-27,1200179,202112,68554,68552,2
2021-03-27,1200138,202112,68559,68554,5
2021-03-27,1200104,202112,68570,68559,11
2021-03-27,1200054,202112,68572,68570,2
2021-03-27,1200013,202112,68590,68572,18
2021-03-28,1200385,202113,68598,68590,8
2021-03-28,1200351,202113,68598,68598,0
2021-03-28,1200344,202113,68596,68598,-2
2021-03-28,1200328,202113,68595,68596,-1
2021-03-28,1200609,202113,68602,68595,7
2021-03-28,1200252,202113,68602,68602,0
2021-03-28,1200203,202113,68602,68602,0
2021-03-28,1200336,202113,68602,68602,0
2021-03-28,1200450,202113,68598,68602,-4
2021-03-28,1200302,202113,68597,68598,-1
2021-03-28,1200708,202113,68597,68597,0
2021-03-28,1200393,202113,68597,68597,0
2021-03-28,1200401,202113,68707,68597,110
2021-03-28,1200138,202113,68721,68707,14
2021-03-28,1200104,202113,68721,68721,0
2021-03-28,1200013,202113,68731,68721,10
2021-03-28,1200054,202113,68731,68731,0
2021-03-28,1200179,202113,68734,68731,3
2021-03-28,1200500,202113,68734,68734,0
2021-03-28,1200435,202113,68734,68734,0
2021-03-28,1200427,202113,68734,68734,0
2021-03-28,1200807,202113,68757,68734,23
2021-03-29,1200336,202113,68757,68757,0
2021-03-29,1200351,202113,68757,68757,0
2021-03-29,1200138,202113,68758,68757,1
2021-03-29,1200179,202113,68760,68758,2
2021-03-29,1200203,202113,68760,68760,0
2021-03-29,1200252,202113,68766,68760,6
2021-03-29,1200302,202113,68805,68766,39
2021-03-29,1200328,202113,68805,68805,0
2021-03-29,1200344,202113,68805,68805,0
2021-03-29,1200054,202113,68806,68805,1
2021-03-29,1200500,202113,68806,68806,0
2021-03-29,1200807,202113,68809,68806,3
2021-03-29,1200427,202113,68809,68809,0
2021-03-29,1200401,202113,68905,68809,96
2021-03-29,1200013,202113,68905,68905,0
2021-03-29,1200104,202113,68918,68905,13
2021-03-29,1200385,202113,68919,68918,1
2021-03-29,1200393,202113,68919,68919,0
2021-03-29,1200450,202113,68920,68919,1
2021-03-29,1200609,202113,68920,68920,0
2021-03-29,1200708,202113,68920,68920,0
2021-03-29,1200435,202113,68920,68920,0
2021-03-30,1200328,202113,68920,68920,0
2021-03-30,1200344,202113,68921,68920,1
2021-03-30,1200013,202113,68921,68921,0
2021-03-30,1200054,202113,68921,68921,0
2021-03-30,1200104,202113,68922,68921,1
2021-03-30,1200138,202113,68922,68922,0
2021-03-30,1200179,202113,68922,68922,0
2021-03-30,1200203,202113,68925,68922,3
2021-03-30,1200252,202113,68924,68925,-1
2021-03-30,1200302,202113,68923,68924,-1
2021-03-30,1200336,202113,68923,68923,0
2021-03-30,1200351,202113,68924,68923,1
2021-03-30,1200807,202113,68923,68924,-1
2021-03-30,1200401,202113,69028,68923,105
2021-03-30,1200708,202113,69030,69028,2
2021-03-30,1200609,202113,69031,69030,1
2021-03-30,1200450,202113,69031,69031,0
2021-03-30,1200385,202113,69029,69031,-2
2021-03-30,1200435,202113,69029,69029,0
2021-03-30,1200427,202113,69042,69029,13
2021-03-30,1200393,202113,69043,69042,1
2021-03-30,1200500,202113,69118,69043,75
2021-03-31,1200302,202113,69134,69118,16
2021-03-31,1200609,202113,69216,69134,82
2021-03-31,1200450,202113,69223,69216,7
2021-03-31,1200500,202113,69263,69223,40
2021-03-31,1200435,202113,69315,69263,52
2021-03-31,1200427,202113,69317,69315,2
2021-03-31,1200401,202113,69537,69317,220
2021-03-31,1200393,202113,69537,69537,0
2021-03-31,1200807,202113,69547,69537,10
2021-03-31,1200351,202113,69547,69547,0
2021-03-31,1200708,202113,69552,69547,5
2021-03-31,1200138,202113,69563,69552,11
2021-03-31,1200203,202113,69603,69563,40
2021-03-31,1200328,202113,69610,69603,7
2021-03-31,1200252,202113,69614,69610,4
2021-03-31,1200179,202113,69618,69614,4
2021-03-31,1200336,202113,69619,69618,1
2021-03-31,1200104,202113,69633,69619,14
2021-03-31,1200054,202113,69635,69633,2
2021-03-31,1200013,202113,69657,69635,22
2021-03-31,1200344,202113,69659,69657,2
2021-03-31,1200385,202113,69672,69659,13
2021-04-01,1200385,202113,69687,69672,15
2021-04-01,1200708,202113,69695,69687,8
2021-04-01,1200450,202113,69706,69695,11
2021-04-01,1200500,202113,69735,69706,29
2021-04-01,1200435,202113,69740,69735,5
2021-04-01,1200427,202113,69742,69740,2
2021-04-01,1200401,202113,69863,69742,121
2021-04-01,1200393,202113,69863,69863,0
2021-04-01,1200807,202113,69872,69863,9
2021-04-01,1200336,202113,69872,69872,0
2021-04-01,1200203,202113,69904,69872,32
2021-04-01,1200344,202113,69904,69904,0
2021-04-01,1200013,202113,69916,69904,12
2021-04-01,1200054,202113,69925,69916,9
2021-04-01,1200104,202113,69925,69925,0
2021-04-01,1200138,202113,69941,69925,16
2021-04-01,1200351,202113,69942,69941,1
2021-04-01,1200609,202113,70001,69942,59
2021-04-01,1200252,202113,70002,70001,1
2021-04-01,1200302,202113,70002,70002,0
2021-04-01,1200328,202113,70003,70002,1
2021-04-01,1200179,202113,70003,70003,0
2021-04-02,1200385,202113,70014,70003,11
2021-04-02,1200013,202113,70024,70014,10
2021-04-02,1200054,202113,70035,70024,11
2021-04-02,1200104,202113,70038,70035,3
2021-04-02,1200138,202113,70037,70038,-1
2021-04-02,1200179,202113,70039,70037,2
2021-04-02,1200203,202113,70067,70039,28
2021-04-02,1200302,202113,70111,70067,44
2021-04-02,1200328,202113,70117,70111,6
2021-04-02,1200344,202113,70118,70117,1
2021-04-02,1200351,202113,70118,70118,0
2021-04-02,1200336,202113,70122,70118,4
2021-04-02,1200393,202113,70122,70122,0
2021-04-02,1200401,202113,70359,70122,237
2021-04-02,1200435,202113,70379,70359,20
2021-04-02,1200500,202113,70457,70379,78
2021-04-02,1200450,202113,70459,70457,2
2021-04-02,1200609,202113,70802,70459,343
2021-04-02,1200708,202113,70817,70802,15
2021-04-02,1200427,202113,70832,70817,15
2021-04-02,1200252,202113,70840,70832,8
2021-04-02,1200807,202113,70866,70840,26
2021-04-03,1200393,202113,70866,70866,0
2021-04-03,1200401,202113,71003,70866,137
2021-04-03,1200427,202113,71002,71003,-1
2021-04-03,1200435,202113,71002,71002,0
2021-04-03,1200807,202113,71003,71002,1
2021-04-03,1200450,202113,71005,71003,2
2021-04-03,1200609,202113,70997,71005,-8
2021-04-03,1200708,202113,70996,70997,-1
2021-04-03,1200500,202113,71024,70996,28
2021-04-03,1200054,202113,71024,71024,0
2021-04-03,1200336,202113,71024,71024,0
2021-04-03,1200179,202113,71040,71024,16
2021-04-03,1200344,202113,71040,71040,0
2021-04-03,1200328,202113,71040,71040,0
2021-04-03,1200302,202113,71043,71040,3
2021-04-03,1200203,202113,71045,71043,2
2021-04-03,1200252,202113,71047,71045,2
2021-04-03,1200138,202113,71052,71047,5
2021-04-03,1200104,202113,71076,71052,24
2021-04-03,1200013,202113,71076,71076,0
2021-04-03,1200351,202113,71076,71076,0
2021-04-03,1200385,202113,71077,71076,1
2021-04-04,1200401,202114,71142,71077,65
2021-04-04,1200385,202114,71148,71142,6
2021-04-04,1200302,202114,71147,71148,-1
2021-04-04,1200328,202114,71147,71147,0
2021-04-04,1200344,202114,71147,71147,0
2021-04-04,1200351,202114,71147,71147,0
2021-04-04,1200336,202114,71147,71147,0
2021-04-04,1200609,202114,71152,71147,5
2021-04-04,1200252,202114,71152,71152,0
2021-04-04,1200393,202114,71152,71152,0
2021-04-04,1200427,202114,71152,71152,0
2021-04-04,1200435,202114,71152,71152,0
2021-04-04,1200500,202114,71162,71152,10
2021-04-04,1200450,202114,71161,71162,-1
2021-04-04,1200807,202114,71169,71161,8
2021-04-04,1200203,202114,71170,71169,1
2021-04-04,1200179,202114,71170,71170,0
2021-04-04,1200138,202114,71172,71170,2
2021-04-04,1200104,202114,71172,71172,0
2021-04-04,1200054,202114,71172,71172,0
2021-04-04,1200013,202114,71172,71172,0
2021-04-04,1200708,202114,71172,71172,0
2021-04-05,1200351,202114,71171,71172,-1
2021-04-05,1200344,202114,71171,71171,0
2021-04-05,1200328,202114,71171,71171,0
2021-04-05,1200302,202114,71170,71171,-1
2021-04-05,1200609,202114,71171,71170,1
2021-04-05,1200203,202114,71172,71171,1
2021-04-05,1200179,202114,71180,71172,8
2021-04-05,1200138,202114,71181,71180,1
2021-04-05,1200336,202114,71181,71181,0
2021-04-05,1200252,202114,71183,71181,2
2021-04-05,1200385,202114,71189,71183,6
2021-04-05,1200807,202114,71188,71189,-1
2021-04-05,1200393,202114,71188,71188,0
2021-04-05,1200401,202114,71304,71188,116
2021-04-05,1200427,202114,71320,71304,16
2021-04-05,1200435,202114,71321,71320,1
2021-04-05,1200500,202114,71344,71321,23
2021-04-05,1200450,202114,71344,71344,0
2021-04-05,1200708,202114,71344,71344,0
2021-04-05,1200104,202114,71344,71344,0
2021-04-05,1200013,202114,71345,71344,1
2021-04-05,1200054,202114,71345,71345,0
2021-04-06,1200328,202114,71345,71345,0
2021-04-06,1200302,202114,71346,71345,1
2021-04-06,1200252,202114,71345,71346,-1
2021-04-06,1200203,202114,71351,71345,6
2021-04-06,1200435,202114,71357,71351,6
2021-04-06,1200138,202114,71358,71357,1
2021-04-06,1200104,202114,71383,71358,25
2021-04-06,1200013,202114,71384,71383,1
2021-04-06,1200344,202114,71384,71384,0
2021-04-06,1200179,202114,71385,71384,1
2021-04-06,1200351,202114,71385,71385,0
2021-04-06,1200336,202114,71386,71385,1
2021-04-06,1200708,202114,71386,71386,0
2021-04-06,1200393,202114,71386,71386,0
2021-04-06,1200054,202114,71386,71386,0
2021-04-06,1200401,202114,71403,71386,17
2021-04-06,1200427,202114,71403,71403,0
2021-04-06,1200807,202114,71403,71403,0
2021-04-06,1200500,202114,71414,71403,11
2021-04-06,1200450,202114,71415,71414,1
2021-04-06,1200609,202114,71434,71415,19
2021-04-06,1200385,202114,71435,71434,1
2021-04-07,1200302,202114,71440,71435,5
2021-04-07,1200609,202114,71546,71440,106
2021-04-07,1200450,202114,71549,71546,3
2021-04-07,1200054,202114,71549,71549,0
2021-04-07,1200104,202114,71558,71549,9
2021-04-07,1200138,202114,71572,71558,14
2021-04-07,1200179,202114,71573,71572,1
2021-04-07,1200203,202114,71610,71573,37
2021-04-07,1200252,202114,71611,71610,1
2021-04-07,1200328,202114,71611,71611,0
2021-04-07,1200013,202114,71620,71611,9
2021-04-07,1200351,202114,71622,71620,2
2021-04-07,1200435,202114,71643,71622,21
2021-04-07,1200708,202114,71649,71643,6
2021-04-07,1200500,202114,71670,71649,21
2021-04-07,1200427,202114,71671,71670,1
2021-04-07,1200344,202114,71679,71671,8
2021-04-07,1200393,202114,71679,71679,0
2021-04-07,1200807,202114,71708,71679,29
2021-04-07,1200385,202114,71715,71708,7
2021-04-07,1200336,202114,71716,71715,1
2021-04-07,1200401,202114,71895,71716,179
2021-04-08,1200328,202114,71895,71895,0
2021-04-08,1200385,202114,71895,71895,0
2021-04-08,1200013,202114,71895,71895,0
2021-04-08,1200054,202114,71906,71895,11
2021-04-08,1200104,202114,71914,71906,8
2021-04-08,1200138,202114,71921,71914,7
2021-04-08,1200179,202114,71931,71921,10
2021-04-08,1200203,202114,71955,71931,24
2021-04-08,1200252,202114,71966,71955,11
2021-04-08,1200302,202114,71994,71966,28
2021-04-08,1200344,202114,71994,71994,0
2021-04-08,1200351,202114,72005,71994,11
2021-04-08,1200708,202114,72009,72005,4
2021-04-08,1200807,202114,72024,72009,15
2021-04-08,1200393,202114,72024,72024,0
2021-04-08,1200401,202114,72207,72024,183
2021-04-08,1200427,202114,72219,72207,12
2021-04-08,1200336,202114,72220,72219,1
2021-04-08,1200500,202114,72294,72220,74
2021-04-08,1200450,202114,72302,72294,8
2021-04-08,1200609,202114,72396,72302,94
2021-04-08,1200435,202114,72418,72396,22
2021-04-09,1200328,202114,72426,72418,8
2021-04-09,1200013,202114,72437,72426,11
2021-04-09,1200054,202114,72441,72437,4
2021-04-09,1200104,202114,72445,72441,4
2021-04-09,1200138,202114,72446,72445,1
2021-04-09,1200179,202114,72457,72446,11
2021-04-09,1200203,202114,72465,72457,8
2021-04-09,1200252,202114,72467,72465,2
2021-04-09,1200302,202114,72477,72467,10
2021-04-09,1200385,202114,72494,72477,17
2021-04-09,1200344,202114,72496,72494,2
2021-04-09,1200807,202114,72509,72496,13
2021-04-09,1200336,202114,72510,72509,1
2021-04-09,1200427,202114,72516,72510,6
2021-04-09,1200708,202114,72533,72516,17
2021-04-09,1200609,202114,72654,72533,121
2021-04-09,1200351,202114,72668,72654,14
2021-04-09,1200500,202114,72706,72668,38
2021-04-09,1200435,202114,72708,72706,2
2021-04-09,1200401,202114,72891,72708,183
2021-04-09,1200393,202114,72909,72891,18
2021-04-09,1200450,202114,72912,72909,3
2021-04-10,1200252,202114,72922,72912,10
2021-04-10,1200708,202114,72922,72922,0
2021-04-10,1200609,202114,73014,72922,92
2021-04-10,1200450,202114,73015,73014,1
2021-04-10,1200500,202114,73062,73015,47
2021-04-10,1200435,202114,73069,73062,7
2021-04-10,1200427,202114,73077,73069,8
2021-04-10,1200401,202114,73152,73077,75
2021-04-10,1200393,202114,73177,73152,25
2021-04-10,1200336,202114,73177,73177,0
2021-04-10,1200807,202114,73183,73177,6
2021-04-10,1200351,202114,73190,73183,7
2021-04-10,1200203,202114,73196,73190,6
2021-04-10,1200344,202114,73200,73196,4
2021-04-10,1200328,202114,73203,73200,3
2021-04-10,1200302,202114,73241,73203,38
2021-04-10,1200138,202114,73241,73241,0
2021-04-10,1200385,202114,73243,73241,2
2021-04-10,1200104,202114,73266,73243,23
2021-04-10,1200054,202114,73272,73266,6
2021-04-10,1200013,202114,73289,73272,17
2021-04-10,1200179,202114,73290,73289,1
2021-04-11,1200427,202115,73291,73290,1
2021-04-11,1200807,202115,73301,73291,10
2021-04-11,1200328,202115,73303,73301,2
2021-04-11,1200344,202115,73304,73303,1
2021-04-11,1200351,202115,73304,73304,0
2021-04-11,1200336,202115,73304,73304,0
2021-04-11,1200385,202115,73307,73304,3
2021-04-11,1200393,202115,73307,73307,0
2021-04-11,1200252,202115,73310,73307,3
2021-04-11,1200401,202115,73392,73310,82
2021-04-11,1200609,202115,73401,73392,9
2021-04-11,1200435,202115,73401,73401,0
2021-04-11,1200450,202115,73405,73401,4
2021-04-11,1200302,202115,73407,73405,2
2021-04-11,1200203,202115,73407,73407,0
2021-04-11,1200179,202115,73411,73407,4
2021-04-11,1200138,202115,73417,73411,6
2021-04-11,1200104,202115,73417,73417,0
2021-04-11,1200054,202115,73417,73417,0
2021-04-11,1200013,202115,73415,73417,-2
2021-04-11,1200708,202115,73418,73415,3
2021-04-11,1200500,202115,73440,73418,22
2021-04-12,1200401,202115,73532,73440,92
2021-04-12,1200427,202115,73532,73532,0
2021-04-12,1200435,202115,73532,73532,0
2021-04-12,1200500,202115,73531,73532,-1
2021-04-12,1200138,202115,73532,73531,1
2021-04-12,1200450,202115,73535,73532,3
2021-04-12,1200609,202115,73538,73535,3
2021-04-12,1200708,202115,73540,73538,2
2021-04-12,1200393,202115,73540,73540,0
2021-04-12,1200203,202115,73540,73540,0
2021-04-12,1200385,202115,73540,73540,0
2021-04-12,1200344,202115,73541,73540,1
2021-04-12,1200336,202115,73541,73541,0
2021-04-12,1200054,202115,73541,73541,0
2021-04-12,1200104,202115,73572,73541,31
2021-04-12,1200179,202115,73579,73572,7
2021-04-12,1200252,202115,73584,73579,5
2021-04-12,1200013,202115,73591,73584,7
2021-04-12,1200328,202115,73591,73591,0
2021-04-12,1200807,202115,73591,73591,0
2021-04-12,1200351,202115,73591,73591,0
2021-04-12,1200302,202115,73628,73591,37
2021-04-13,1200807,202115,73634,73628,6
2021-04-13,1200336,202115,73634,73634,0
2021-04-13,1200708,202115,73636,73634,2
2021-04-13,1200609,202115,73720,73636,84
2021-04-13,1200450,202115,73719,73720,-1
2021-04-13,1200500,202115,73738,73719,19
2021-04-13,1200435,202115,73738,73738,0
2021-04-13,1200427,202115,73750,73738,12
2021-04-13,1200401,202115,73969,73750,219
2021-04-13,1200393,202115,73970,73969,1
2021-04-13,1200385,202115,73978,73970,8
2021-04-13,1200013,202115,73981,73978,3
2021-04-13,1200344,202115,73981,73981,0
2021-04-13,1200328,202115,73981,73981,0
2021-04-13,1200302,202115,73981,73981,0
2021-04-13,1200252,202115,73984,73981,3
2021-04-13,1200203,202115,74004,73984,20
2021-04-13,1200179,202115,74004,74004,0
2021-04-13,1200138,202115,74008,74004,4
2021-04-13,1200104,202115,74014,74008,6
2021-04-13,1200054,202115,74014,74014,0
2021-04-13,1200351,202115,74022,74014,8
2021-04-14,1200393,202115,74025,74022,3
2021-04-14,1200401,202115,74174,74025,149
2021-04-14,1200427,202115,74185,74174,11
2021-04-14,1200435,202115,74193,74185,8
2021-04-14,1200807,202115,74202,74193,9
2021-04-14,1200450,202115,74223,74202,21
2021-04-14,1200609,202115,74408,74223,185
2021-04-14,1200302,202115,74410,74408,2
2021-04-14,1200252,202115,74414,74410,4
2021-04-14,1200500,202115,74445,74414,31
2021-04-14,1200385,202115,74445,74445,0
2021-04-14,1200336,202115,74446,74445,1
2021-04-14,1200351,202115,74454,74446,8
2021-04-14,1200344,202115,74458,74454,4
2021-04-14,1200328,202115,74462,74458,4
2021-04-14,1200708,202115,74470,74462,8
2021-04-14,1200203,202115,74507,74470,37
2021-04-14,1200179,202115,74507,74507,0
2021-04-14,1200138,202115,74519,74507,12
2021-04-14,1200104,202115,74540,74519,21
2021-04-14,1200054,202115,74548,74540,8
2021-04-14,1200013,202115,74548,74548,0
2021-04-15,1200302,202115,74549,74548,1
2021-04-15,1200252,202115,74551,74549,2
2021-04-15,1200203,202115,74552,74551,1
2021-04-15,1200179,202115,74567,74552,15
2021-04-15,1200344,202115,74567,74567,0
2021-04-15,1200104,202115,74580,74567,13
2021-04-15,1200054,202115,74581,74580,1
2021-04-15,1200013,202115,74594,74581,13
2021-04-15,1200328,202115,74594,74594,0
2021-04-15,1200138,202115,74604,74594,10
2021-04-15,1200336,202115,74604,74604,0
2021-04-15,1200351,202115,74604,74604,0
2021-04-15,1200385,202115,74615,74604,11
2021-04-15,1200393,202115,74615,74615,0
2021-04-15,1200708,202115,74616,74615,1
2021-04-15,1200609,202115,74613,74616,-3
2021-04-15,1200450,202115,74616,74613,3
2021-04-15,1200435,202115,74616,74616,0
2021-04-15,1200427,202115,74616,74616,0
2021-04-15,1200401,202115,74669,74616,53
2021-04-15,1200807,202115,74679,74669,10
2021-04-15,1200500,202115,74679,74679,0
2021-04-16,1200385,202115,74680,74679,1
2021-04-16,1200609,202115,74710,74680,30
2021-04-16,1200450,202115,74717,74710,7
2021-04-16,1200708,202115,74730,74717,13
2021-04-16,1200435,202115,74762,74730,32
2021-04-16,1200427,202115,74771,74762,9
2021-04-16,1200401,202115,74889,74771,118
2021-04-16,1200393,202115,74898,74889,9
2021-04-16,1200807,202115,74906,74898,8
2021-04-16,1200344,202115,74908,74906,2
2021-04-16,1200500,202115,74978,74908,70
2021-04-16,1200138,202115,74983,74978,5
2021-04-16,1200203,202115,74987,74983,4
2021-04-16,1200302,202115,75033,74987,46
2021-04-16,1200252,202115,75039,75033,6
2021-04-16,1200179,202115,75043,75039,4
2021-04-16,1200336,202115,75043,75043,0
2021-04-16,1200104,202115,75046,75043,3
2021-04-16,1200054,202115,75054,75046,8
2021-04-16,1200013,202115,75056,75054,2
2021-04-16,1200328,202115,75062,75056,6
2021-04-16,1200351,202115,75062,75062,0
2021-04-17,1200385,202115,75063,75062,1
2021-04-17,1200203,202115,75076,75063,13
2021-04-17,1200708,202115,75080,75076,4
2021-04-17,1200450,202115,75099,75080,19
2021-04-17,1200500,202115,75114,75099,15
2021-04-17,1200435,202115,75143,75114,29
2021-04-17,1200427,202115,75146,75143,3
2021-04-17,1200401,202115,75233,75146,87
2021-04-17,1200393,202115,75234,75233,1
2021-04-17,1200807,202115,75235,75234,1
2021-04-17,1200336,202115,75236,75235,1
2021-04-17,1200351,202115,75242,75236,6
2021-04-17,1200344,202115,75252,75242,10
2021-04-17,1200054,202115,75252,75252,0
2021-04-17,1200104,202115,75285,75252,33
2021-04-17,1200138,202115,75293,75285,8
2021-04-17,1200179,202115,75300,75293,7
2021-04-17,1200013,202115,75310,75300,10
2021-04-17,1200252,202115,75318,75310,8
2021-04-17,1200302,202115,75319,75318,1
2021-04-17,1200328,202115,75321,75319,2
2021-04-17,1200609,202115,75349,75321,28
2021-04-18,1200328,202116,75349,75349,0
2021-04-18,1200013,202116,75352,75349,3
2021-04-18,1200054,202116,75352,75352,0
2021-04-18,1200344,202116,75353,75352,1
2021-04-18,1200138,202116,75356,75353,3
2021-04-18,1200179,202116,75356,75356,0
2021-04-18,1200203,202116,75355,75356,-1
2021-04-18,1200252,202116,75355,75355,0
2021-04-18,1200302,202116,75356,75355,1
2021-04-18,1200385,202116,75361,75356,5
2021-04-18,1200104,202116,75360,75361,-1
2021-04-18,1200807,202116,75372,75360,12
2021-04-18,1200393,202116,75372,75372,0
2021-04-18,1200401,202116,75383,75372,11
2021-04-18,1200435,202116,75383,75383,0
2021-04-18,1200500,202116,75421,75383,38
2021-04-18,1200450,202116,75417,75421,-4
2021-04-18,1200609,202116,75418,75417,1
2021-04-18,1200708,202116,75420,75418,2
2021-04-18,1200427,202116,75420,75420,0
2021-04-18,1200336,202116,75420,75420,0
2021-04-18,1200351,202116,75420,75420,0
2021-04-19,1200807,202116,75421,75420,1
2021-04-19,1200393,202116,75422,75421,1
2021-04-19,1200401,202116,75466,75422,44
2021-04-19,1200427,202116,75470,75466,4
2021-04-19,1200708,202116,75477,75470,7
2021-04-19,1200450,202116,75484,75477,7
2021-04-19,1200609,202116,75496,75484,12
2021-04-19,1200252,202116,75505,75496,9
2021-04-19,1200435,202116,75513,75505,8
2021-04-19,1200336,202116,75513,75513,0
2021-04-19,1200500,202116,75525,75513,12
2021-04-19,1200351,202116,75525,75525,0
2021-04-19,1200013,202116,75534,75525,9
2021-04-19,1200054,202116,75539,75534,5
2021-04-19,1200104,202116,75559,75539,20
2021-04-19,1200385,202116,75559,75559,0
2021-04-19,1200179,202116,75563,75559,4
2021-04-19,1200302,202116,75596,75563,33
2021-04-19,1200328,202116,75596,75596,0
2021-04-19,1200344,202116,75599,75596,3
2021-04-19,1200203,202116,75612,75599,13
2021-04-19,1200138,202116,75614,75612,2
2021-04-20,1200393,202116,75614,75614,0
2021-04-20,1200252,202116,75615,75614,1
2021-04-20,1200609,202116,75616,75615,1
2021-04-20,1200336,202116,75616,75616,0
2021-04-20,1200385,202116,75623,75616,7
2021-04-20,1200344,202116,75623,75623,0
2021-04-20,1200328,202116,75623,75623,0
2021-04-20,1200302,202116,75625,75623,2
2021-04-20,1200401,202116,75649,75625,24
2021-04-20,1200351,202116,75649,75649,0
2021-04-20,1200427,202116,75649,75649,0
2021-04-20,1200807,202116,75649,75649,0
2021-04-20,1200500,202116,75651,75649,2
2021-04-20,1200450,202116,75650,75651,-1
2021-04-20,1200203,202116,75650,75650,0
2021-04-20,1200179,202116,75650,75650,0
2021-04-20,1200138,202116,75649,75650,-1
2021-04-20,1200104,202116,75654,75649,5
2021-04-20,1200054,202116,75655,75654,1
2021-04-20,1200013,202116,75655,75655,0
2021-04-20,1200708,202116,75655,75655,0
2021-04-20,1200435,202116,75655,75655,0
2021-04-21,1200328,202116,75656,75655,1
2021-04-21,1200351,202116,75664,75656,8
2021-04-21,1200344,202116,75664,75664,0
2021-04-21,1200302,202116,75671,75664,7
2021-04-21,1200336,202116,75671,75671,0
2021-04-21,1200203,202116,75693,75671,22
2021-04-21,1200179,202116,75701,75693,8
2021-04-21,1200138,202116,75707,75701,6
2021-04-21,1200609,202116,75734,75707,27
2021-04-21,1200252,202116,75735,75734,1
2021-04-21,1200385,202116,75735,75735,0
2021-04-21,1200807,202116,75748,75735,13
2021-04-21,1200393,202116,75748,75748,0
2021-04-21,1200013,202116,75762,75748,14
2021-04-21,1200104,202116,75761,75762,-1
2021-04-21,1200708,202116,75766,75761,5
2021-04-21,1200450,202116,75767,75766,1
2021-04-21,1200054,202116,75778,75767,11
2021-04-21,1200435,202116,75779,75778,1
2021-04-21,1200427,202116,75785,75779,6
2021-04-21,1200401,202116,75869,75785,84
2021-04-21,1200500,202116,75894,75869,25
2021-04-22,1200328,202116,75895,75894,1
2021-04-22,1200435,202116,75907,75895,12
2021-04-22,1200013,202116,75912,75907,5
2021-04-22,1200104,202116,75945,75912,33
2021-04-22,1200138,202116,75946,75945,1
2021-04-22,1200179,202116,75949,75946,3
2021-04-22,1200203,202116,75956,75949,7
2021-04-22,1200252,202116,75969,75956,13
2021-04-22,1200302,202116,75973,75969,4
2021-04-22,1200344,202116,75980,75973,7
2021-04-22,1200351,202116,75988,75980,8
2021-04-22,1200807,202116,75989,75988,1
2021-04-22,1200708,202116,76001,75989,12
2021-04-22,1200609,202116,76012,76001,11
2021-04-22,1200450,202116,76017,76012,5
2021-04-22,1200500,202116,76061,76017,44
2021-04-22,1200385,202116,76070,76061,9
2021-04-22,1200427,202116,76071,76070,1
2021-04-22,1200401,202116,76212,76071,141
2021-04-22,1200054,202116,76224,76212,12
2021-04-22,1200393,202116,76224,76224,0
2021-04-22,1200336,202116,76227,76224,3
2021-04-23,1200252,202116,76230,76227,3
2021-04-23,1200203,202116,76229,76230,-1
2021-04-23,1200179,202116,76233,76229,4
2021-04-23,1200138,202116,76233,76233,0
2021-04-23,1200302,202116,76269,76233,36
2021-04-23,1200054,202116,76281,76269,12
2021-04-23,1200450,202116,76281,76281,0
2021-04-23,1200609,202116,76318,76281,37
2021-04-23,1200013,202116,76318,76318,0
2021-04-23,1200104,202116,76341,76318,23
2021-04-23,1200328,202116,76342,76341,1
2021-04-23,1200344,202116,76342,76342,0
2021-04-23,1200351,202116,76343,76342,1
2021-04-23,1200336,202116,76342,76343,-1
2021-04-23,1200385,202116,76342,76342,0
2021-04-23,1200807,202116,76342,76342,0
2021-04-23,1200393,202116,76344,76342,2
2021-04-23,1200401,202116,76370,76344,26
2021-04-23,1200427,202116,76370,76370,0
2021-04-23,1200500,202116,76387,76370,17
2021-04-23,1200708,202116,76390,76387,3
2021-04-23,1200435,202116,76391,76390,1
2021-04-24,1200302,202116,76392,76391,1
2021-04-24,1200252,202116,76393,76392,1
2021-04-24,1200203,202116,76409,76393,16
2021-04-24,1200179,202116,76410,76409,1
2021-04-24,1200385,202116,76416,76410,6
2021-04-24,1200104,202116,76416,76416,0
2021-04-24,1200054,202116,76425,76416,9
2021-04-24,1200013,202116,76443,76425,18
2021-04-24,1200328,202116,76442,76443,-1
2021-04-24,1200138,202116,76448,76442,6
2021-04-24,1200344,202116,76448,76448,0
2021-04-24,1200351,202116,76454,76448,6
2021-04-24,1200708,202116,76460,76454,6
2021-04-24,1200807,202116,76468,76460,8
2021-04-24,1200393,202116,76468,76468,0
2021-04-24,1200401,202116,76563,76468,95
2021-04-24,1200427,202116,76565,76563,2
2021-04-24,1200336,202116,76567,76565,2
2021-04-24,1200500,202116,76606,76567,39
2021-04-24,1200450,202116,76616,76606,10
2021-04-24,1200609,202116,76614,76616,-2
2021-04-24,1200435,202116,76618,76614,4
2021-04-25,1200344,202117,76618,76618,0
2021-04-25,1200013,202117,76622,76618,4
2021-04-25,1200054,202117,76622,76622,0
2021-04-25,1200104,202117,76622,76622,0
2021-04-25,1200138,202117,76624,76622,2
2021-04-25,1200179,202117,76625,76624,1
2021-04-25,1200203,202117,76626,76625,1
2021-04-25,1200302,202117,76631,76626,5
2021-04-25,1200328,202117,76631,76631,0
2021-04-25,1200385,202117,76631,76631,0
2021-04-25,1200351,202117,76631,76631,0
2021-04-25,1200807,202117,76631,76631,0
2021-04-25,1200252,202117,76631,76631,0
2021-04-25,1200427,202117,76631,76631,0
2021-04-25,1200708,202117,76636,76631,5
2021-04-25,1200609,202117,76643,76636,7
2021-04-25,1200336,202117,76643,76643,0
2021-04-25,1200500,202117,76663,76643,20
2021-04-25,1200435,202117,76663,76663,0
2021-04-25,1200401,202117,76760,76663,97
2021-04-25,1200393,202117,76760,76760,0
2021-04-25,1200450,202117,76762,76760,2
2021-04-26,1200054,202117,76762,76762,0
2021-04-26,1200807,202117,76764,76762,2
2021-04-26,1200708,202117,76765,76764,1
2021-04-26,1200609,202117,76767,76765,2
2021-04-26,1200450,202117,76769,76767,2
2021-04-26,1200500,202117,76773,76769,4
2021-04-26,1200435,202117,76773,76773,0
2021-04-26,1200427,202117,76773,76773,0
2021-04-26,1200401,202117,76913,76773,140
2021-04-26,1200393,202117,76914,76913,1
2021-04-26,1200336,202117,76914,76914,0
2021-04-26,1200179,202117,76918,76914,4
2021-04-26,1200351,202117,76918,76918,0
2021-04-26,1200344,202117,76918,76918,0
2021-04-26,1200328,202117,76918,76918,0
2021-04-26,1200302,202117,76942,76918,24
2021-04-26,1200203,202117,76941,76942,-1
2021-04-26,1200252,202117,76957,76941,16
2021-04-26,1200138,202117,76955,76957,-2
2021-04-26,1200104,202117,76985,76955,30
2021-04-26,1200013,202117,76985,76985,0
2021-04-26,1200385,202117,76986,76985,1
2021-04-27,1200401,202117,77067,76986,81
2021-04-27,1200807,202117,77067,77067,0
2021-04-27,1200328,202117,77070,77067,3
2021-04-27,1200344,202117,77070,77070,0
2021-04-27,1200351,202117,77072,77070,2
2021-04-27,1200336,202117,77072,77072,0
2021-04-27,1200385,202117,77079,77072,7
2021-04-27,1200393,202117,77078,77079,-1
2021-04-27,1200252,202117,77077,77078,-1
2021-04-27,1200427,202117,77088,77077,11
2021-04-27,1200609,202117,77090,77088,2
2021-04-27,1200500,202117,77117,77090,27
2021-04-27,1200708,202117,77130,77117,13
2021-04-27,1200013,202117,77133,77130,3
2021-04-27,1200054,202117,77133,77133,0
2021-04-27,1200104,202117,77134,77133,1
2021-04-27,1200435,202117,77134,77134,0
2021-04-27,1200179,202117,77133,77134,-1
2021-04-27,1200203,202117,77153,77133,20
2021-04-27,1200302,202117,77156,77153,3
2021-04-27,1200450,202117,77160,77156,4
2021-04-27,1200138,202117,77161,77160,1
2021-04-28,1200336,202117,77162,77161,1
2021-04-28,1200401,202117,77203,77162,41
2021-04-28,1200179,202117,77208,77203,5
2021-04-28,1200203,202117,77232,77208,24
2021-04-28,1200252,202117,77235,77232,3
2021-04-28,1200302,202117,77237,77235,2
2021-04-28,1200328,202117,77239,77237,2
2021-04-28,1200344,202117,77239,77239,0
2021-04-28,1200351,202117,77241,77239,2
2021-04-28,1200385,202117,77242,77241,1
2021-04-28,1200393,202117,77242,77242,0
2021-04-28,1200708,202117,77251,77242,9
2021-04-28,1200013,202117,77253,77251,2
2021-04-28,1200054,202117,77263,77253,10
2021-04-28,1200104,202117,77265,77263,2
2021-04-28,1200435,202117,77272,77265,7
2021-04-28,1200807,202117,77275,77272,3
2021-04-28,1200138,202117,77275,77275,0
2021-04-28,1200500,202117,77280,77275,5
2021-04-28,1200450,202117,77281,77280,1
2021-04-28,1200609,202117,77308,77281,27
2021-04-28,1200427,202117,77313,77308,5
2021-04-29,1200344,202117,77317,77313,4
2021-04-29,1200401,202117,77367,77317,50
2021-04-29,1200708,202117,77373,77367,6
2021-04-29,1200609,202117,77377,77373,4
2021-04-29,1200450,202117,77391,77377,14
2021-04-29,1200500,202117,77413,77391,22
2021-04-29,1200427,202117,77414,77413,1
2021-04-29,1200336,202117,77415,77414,1
2021-04-29,1200351,202117,77419,77415,4
2021-04-29,1200013,202117,77442,77419,23
2021-04-29,1200435,202117,77442,77442,0
2021-04-29,1200328,202117,77442,77442,0
2021-04-29,1200252,202117,77449,77442,7
2021-04-29,1200203,202117,77474,77449,25
2021-04-29,1200179,202117,77475,77474,1
2021-04-29,1200138,202117,77479,77475,4
2021-04-29,1200807,202117,77483,77479,4
2021-04-29,1200104,202117,77502,77483,19
2021-04-29,1200054,202117,77511,77502,9
2021-04-29,1200393,202117,77513,77511,2
2021-04-29,1200385,202117,77524,77513,11
2021-04-29,1200302,202117,77550,77524,26
2021-04-30,1200401,202117,77664,77550,114
2021-04-30,1200427,202117,77669,77664,5
2021-04-30,1200435,202117,77669,77669,0
2021-04-30,1200500,202117,77692,77669,23
2021-04-30,1200393,202117,77692,77692,0
2021-04-30,1200609,202117,77709,77692,17
2021-04-30,1200708,202117,77724,77709,15
2021-04-30,1200344,202117,77725,77724,1
2021-04-30,1200450,202117,77728,77725,3
2021-04-30,1200807,202117,77730,77728,2
2021-04-30,1200385,202117,77735,77730,5
2021-04-30,1200013,202117,77735,77735,0
2021-04-30,1200351,202117,77740,77735,5
2021-04-30,1200302,202117,77751,77740,11
2021-04-30,1200328,202117,77751,77751,0
2021-04-30,1200252,202117,77753,77751,2
2021-04-30,1200203,202117,77763,77753,10
2021-04-30,1200179,202117,77765,77763,2
2021-04-30,1200138,202117,77767,77765,2
2021-04-30,1200104,202117,77774,77767,7
2021-04-30,1200054,202117,77817,77774,43
2021-04-30,1200336,202117,77818,77817,1
2021-05-01,1200336,202117,77818,77818,0
2021-05-01,1200351,202117,77831,77818,13
2021-05-01,1200344,202117,77831,77831,0
2021-05-01,1200328,202117,77834,77831,3
2021-05-01,1200401,202117,77910,77834,76
2021-05-01,1200252,202117,77914,77910,4
2021-05-01,1200203,202117,77928,77914,14
2021-05-01,1200500,202117,77936,77928,8
2021-05-01,1200385,202117,77954,77936,18
2021-05-01,1200302,202117,77955,77954,1
2021-05-01,1200807,202117,77959,77955,4
2021-05-01,1200708,202117,77966,77959,7
2021-05-01,1200427,202117,77971,77966,5
2021-05-01,1200435,202117,77974,77971,3
2021-05-01,1200609,202117,77977,77974,3
2021-05-01,1200450,202117,77977,77977,0
2021-05-01,1200054,202117,78002,77977,25
2021-05-01,1200013,202117,78004,78002,2
2021-05-01,1200138,202117,78004,78004,0
2021-05-01,1200179,202117,78015,78004,11
2021-05-01,1200104,202117,78031,78015,16
2021-05-01,1200393,202117,78031,78031,0
2021-05-02,1200013,202118,78032,78031,1
2021-05-02,1200807,202118,78033,78032,1
2021-05-02,1200385,202118,78034,78033,1
2021-05-02,1200435,202118,78034,78034,0
2021-05-02,1200328,202118,78034,78034,0
2021-05-02,1200450,202118,78035,78034,1
2021-05-02,1200609,202118,78035,78035,0
2021-05-02,1200708,202118,78041,78035,6
2021-05-02,1200336,202118,78042,78041,1
2021-05-02,1200500,202118,78051,78042,9
2021-05-02,1200351,202118,78051,78051,0
2021-05-02,1200401,202118,78115,78051,64
2021-05-02,1200393,202118,78115,78115,0
2021-05-02,1200344,202118,78116,78115,1
2021-05-02,1200054,202118,78117,78116,1
2021-05-02,1200104,202118,78137,78117,20
2021-05-02,1200138,202118,78141,78137,4
2021-05-02,1200427,202118,78141,78141,0
2021-05-02,1200203,202118,78142,78141,1
2021-05-02,1200252,202118,78144,78142,2
2021-05-02,1200302,202118,78167,78144,23
2021-05-02,1200179,202118,78167,78167,0
2021-05-03,1200344,202118,78168,78167,1
2021-05-03,1200427,202118,78176,78168,8
2021-05-03,1200013,202118,78178,78176,2
2021-05-03,1200054,202118,78177,78178,-1
2021-05-03,1200104,202118,78178,78177,1
2021-05-03,1200138,202118,78178,78178,0
2021-05-03,1200179,202118,78183,78178,5
2021-05-03,1200203,202118,78183,78183,0
2021-05-03,1200252,202118,78193,78183,10
2021-05-03,1200328,202118,78193,78193,0
2021-05-03,1200385,202118,78195,78193,2
2021-05-03,1200351,202118,78212,78195,17
2021-05-03,1200336,202118,78211,78212,-1
2021-05-03,1200401,202118,78301,78211,90
2021-05-03,1200708,202118,78306,78301,5
2021-05-03,1200609,202118,78306,78306,0
2021-05-03,1200450,202118,78308,78306,2
2021-05-03,1200500,202118,78326,78308,18
2021-05-03,1200393,202118,78327,78326,1
2021-05-03,1200435,202118,78334,78327,7
2021-05-03,1200302,202118,78340,78334,6
2021-05-03,1200807,202118,78340,78340,0
2021-05-04,1200450,202118,78340,78340,0
2021-05-04,1200500,202118,78342,78340,2
2021-05-04,1200609,202118,78343,78342,1
2021-05-04,1200708,202118,78343,78343,0
2021-05-04,1200807,202118,78343,78343,0
2021-05-04,1200054,202118,78344,78343,1
2021-05-04,1200427,202118,78348,78344,4
2021-05-04,1200435,202118,78348,78348,0
2021-05-04,1200138,202118,78349,78348,1
2021-05-04,1200401,202118,78404,78349,55
2021-05-04,1200104,202118,78404,78404,0
2021-05-04,1200393,202118,78422,78404,18
2021-05-04,1200013,202118,78423,78422,1
2021-05-04,1200302,202118,78426,78423,3
2021-05-04,1200203,202118,78446,78426,20
2021-05-04,1200328,202118,78446,78446,0
2021-05-04,1200252,202118,78446,78446,0
2021-05-04,1200351,202118,78452,78446,6
2021-05-04,1200336,202118,78452,78452,0
2021-05-04,1200385,202118,78454,78452,2
2021-05-04,1200179,202118,78455,78454,1
2021-05-04,1200344,202118,78455,78455,0
2021-05-05,1200344,202118,78455,78455,0
2021-05-05,1200351,202118,78455,78455,0
2021-05-05,1200013,202118,78459,78455,4
2021-05-05,1200054,202118,78459,78459,0
2021-05-05,1200104,202118,78477,78459,18
2021-05-05,1200138,202118,78479,78477,2
2021-05-05,1200179,202118,78486,78479,7
2021-05-05,1200203,202118,78486,78486,0
2021-05-05,1200252,202118,78490,78486,4
2021-05-05,1200328,202118,78490,78490,0
2021-05-05,1200385,202118,78494,78490,4
2021-05-05,1200336,202118,78494,78494,0
2021-05-05,1200807,202118,78498,78494,4
2021-05-05,1200401,202118,78589,78498,91
2021-05-05,1200708,202118,78592,78589,3
2021-05-05,1200609,202118,78607,78592,15
2021-05-05,1200450,202118,78610,78607,3
2021-05-05,1200302,202118,78611,78610,1
2021-05-05,1200435,202118,78611,78611,0
2021-05-05,1200427,202118,78613,78611,2
2021-05-05,1200393,202118,78612,78613,-1
2021-05-05,1200500,202118,78625,78612,13
2021-05-06,1200104,202118,78637,78625,12
2021-05-06,1200609,202118,78645,78637,8
2021-05-06,1200450,202118,78647,78645,2
2021-05-06,1200708,202118,78653,78647,6
2021-05-06,1200435,202118,78685,78653,32
2021-05-06,1200427,202118,78690,78685,5
2021-05-06,1200401,202118,78751,78690,61
2021-05-06,1200393,202118,78754,78751,3
2021-05-06,1200807,202118,78754,78754,0
2021-05-06,1200351,202118,78761,78754,7
2021-05-06,1200500,202118,78780,78761,19
2021-05-06,1200179,202118,78789,78780,9
2021-05-06,1200344,202118,78792,78789,3
2021-05-06,1200013,202118,78795,78792,3
2021-05-06,1200054,202118,78803,78795,8
2021-05-06,1200138,202118,78810,78803,7
2021-05-06,1200385,202118,78818,78810,8
2021-05-06,1200203,202118,78828,78818,10
2021-05-06,1200302,202118,78873,78828,45
2021-05-06,1200328,202118,78873,78873,0
2021-05-06,1200252,202118,78876,78873,3
2021-05-06,1200336,202118,78904,78876,28
2021-05-07,1200807,202118,78907,78904,3
2021-05-07,1200393,202118,78907,78907,0
2021-05-07,1200401,202118,78963,78907,56
2021-05-07,1200427,202118,78964,78963,1
2021-05-07,1200203,202118,78967,78964,3
2021-05-07,1200450,202118,78970,78967,3
2021-05-07,1200708,202118,78971,78970,1
2021-05-07,1200385,202118,78973,78971,2
2021-05-07,1200435,202118,78994,78973,21
2021-05-07,1200336,202118,79043,78994,49
2021-05-07,1200500,202118,79048,79043,5
2021-05-07,1200344,202118,79048,79048,0
2021-05-07,1200328,202118,79048,79048,0
2021-05-07,1200302,202118,79054,79048,6
2021-05-07,1200252,202118,79062,79054,8
2021-05-07,1200609,202118,79065,79062,3
2021-05-07,1200179,202118,79066,79065,1
2021-05-07,1200138,202118,79071,79066,5
2021-05-07,1200104,202118,79087,79071,16
2021-05-07,1200054,202118,79101,79087,14
2021-05-07,1200013,202118,79114,79101,13
2021-05-07,1200351,202118,79115,79114,1
2021-05-08,1200328,202118,79116,79115,1
2021-05-08,1200302,202118,79118,79116,2
2021-05-08,1200252,202118,79118,79118,0
2021-05-08,1200203,202118,79128,79118,10
2021-05-08,1200351,202118,79128,79128,0
2021-05-08,1200138,202118,79134,79128,6
2021-05-08,1200104,202118,79140,79134,6
2021-05-08,1200013,202118,79141,79140,1
2021-05-08,1200344,202118,79141,79141,0
2021-05-08,1200179,202118,79144,79141,3
2021-05-08,1200427,202118,79148,79144,4
2021-05-08,1200393,202118,79148,79148,0
2021-05-08,1200385,202118,79155,79148,7
2021-05-08,1200807,202118,79158,79155,3
2021-05-08,1200401,202118,79228,79158,70
2021-05-08,1200435,202118,79230,79228,2
2021-05-08,1200450,202118,79231,79230,1
2021-05-08,1200609,202118,79244,79231,13
2021-05-08,1200708,202118,79260,79244,16
2021-05-08,1200054,202118,79261,79260,1
2021-05-08,1200500,202118,79280,79261,19
2021-05-08,1200336,202118,79291,79280,11
2021-05-09,1200401,202119,79308,79291,17
2021-05-09,1200807,202119,79309,79308,1
2021-05-09,1200393,202119,79309,79309,0
2021-05-09,1200427,202119,79309,79309,0
2021-05-09,1200385,202119,79309,79309,0
2021-05-09,1200500,202119,79314,79309,5
2021-05-09,1200450,202119,79314,79314,0
2021-05-09,1200609,202119,79314,79314,0
2021-05-09,1200708,202119,79323,79314,9
2021-05-09,1200435,202119,79323,79323,0
2021-05-09,1200336,202119,79323,79323,0
2021-05-09,1200179,202119,79324,79323,1
2021-05-09,1200351,202119,79324,79324,0
2021-05-09,1200328,202119,79324,79324,0
2021-05-09,1200302,202119,79355,79324,31
2021-05-09,1200252,202119,79355,79355,0
2021-05-09,1200203,202119,79355,79355,0
2021-05-09,1200344,202119,79355,79355,0
2021-05-09,1200138,202119,79357,79355,2
2021-05-09,1200104,202119,79365,79357,8
2021-05-09,1200054,202119,79365,79365,0
2021-05-09,1200013,202119,79366,79365,1
2021-05-10,1200393,202119,79366,79366,0
2021-05-10,1200385,202119,79365,79366,-1
2021-05-10,1200302,202119,79367,79365,2
2021-05-10,1200328,202119,79367,79367,0
2021-05-10,1200344,202119,79368,79367,1
2021-05-10,1200351,202119,79371,79368,3
2021-05-10,1200336,202119,79391,79371,20
2021-05-10,1200609,202119,79397,79391,6
2021-05-10,1200252,202119,79402,79397,5
2021-05-10,1200401,202119,79459,79402,57
2021-05-10,1200427,202119,79460,79459,1
2021-05-10,1200708,202119,79466,79460,6
2021-05-10,1200500,202119,79469,79466,3
2021-05-10,1200450,202119,79469,79469,0
2021-05-10,1200807,202119,79469,79469,0
2021-05-10,1200203,202119,79474,79469,5
2021-05-10,1200179,202119,79475,79474,1
2021-05-10,1200138,202119,79475,79475,0
2021-05-10,1200104,202119,79480,79475,5
2021-05-10,1200054,202119,79479,79480,-1
2021-05-10,1200013,202119,79480,79479,1
2021-05-10,1200435,202119,79491,79480,11
2021-05-11,1200351,202119,79491,79491,0
2021-05-11,1200344,202119,79491,79491,0
2021-05-11,1200328,202119,79491,79491,0
2021-05-11,1200302,202119,79491,79491,0
2021-05-11,1200336,202119,79491,79491,0
2021-05-11,1200203,202119,79490,79491,-1
2021-05-11,1200179,202119,79490,79490,0
2021-05-11,1200138,202119,79490,79490,0
2021-05-11,1200609,202119,79490,79490,0
2021-05-11,1200252,202119,79490,79490,0
2021-05-11,1200385,202119,79492,79490,2
2021-05-11,1200054,202119,79493,79492,1
2021-05-11,1200393,202119,79493,79493,0
2021-05-11,1200401,202119,79525,79493,32
2021-05-11,1200427,202119,79525,79525,0
2021-05-11,1200435,202119,79525,79525,0
2021-05-11,1200500,202119,79525,79525,0
2021-05-11,1200450,202119,79525,79525,0
2021-05-11,1200708,202119,79525,79525,0
2021-05-11,1200104,202119,79525,79525,0
2021-05-11,1200013,202119,79525,79525,0
2021-05-11,1200807,202119,79525,79525,0
2021-05-12,1200328,202119,79525,79525,0
2021-05-12,1200302,202119,79530,79525,5
2021-05-12,1200252,202119,79544,79530,14
2021-05-12,1200203,202119,79567,79544,23
2021-05-12,1200435,202119,79571,79567,4
2021-05-12,1200138,202119,79571,79571,0
2021-05-12,1200104,202119,79586,79571,15
2021-05-12,1200013,202119,79590,79586,4
2021-05-12,1200344,202119,79590,79590,0
2021-05-12,1200179,202119,79595,79590,5
2021-05-12,1200351,202119,79598,79595,3
2021-05-12,1200807,202119,79603,79598,5
2021-05-12,1200708,202119,79610,79603,7
2021-05-12,1200393,202119,79610,79610,0
2021-05-12,1200054,202119,79610,79610,0
2021-05-12,1200401,202119,79650,79610,40
2021-05-12,1200427,202119,79650,79650,0
2021-05-12,1200336,202119,79699,79650,49
2021-05-12,1200500,202119,79716,79699,17
2021-05-12,1200450,202119,79718,79716,2
2021-05-12,1200609,202119,79730,79718,12
2021-05-12,1200385,202119,79733,79730,3
2021-05-13,1200302,202119,79766,79733,33
2021-05-13,1200609,202119,79776,79766,10
2021-05-13,1200450,202119,79777,79776,1
2021-05-13,1200054,202119,79776,79777,-1
2021-05-13,1200104,202119,79785,79776,9
2021-05-13,1200138,202119,79794,79785,9
2021-05-13,1200179,202119,79797,79794,3
2021-05-13,1200203,202119,79811,79797,14
2021-05-13,1200252,202119,79812,79811,1
2021-05-13,1200013,202119,79811,79812,-1
2021-05-13,1200328,202119,79819,79811,8
2021-05-13,1200351,202119,79820,79819,1
2021-05-13,1200336,202119,79839,79820,19
2021-05-13,1200385,202119,79845,79839,6
2021-05-13,1200807,202119,79851,79845,6
2021-05-13,1200393,202119,79851,79851,0
2021-05-13,1200401,202119,79933,79851,82
2021-05-13,1200427,202119,79938,79933,5
2021-05-13,1200500,202119,79945,79938,7
2021-05-13,1200708,202119,79961,79945,16
2021-05-13,1200435,202119,79965,79961,4
2021-05-13,1200344,202119,79970,79965,5
2021-05-14,1200302,202119,79972,79970,2
2021-05-14,1200252,202119,79975,79972,3
2021-05-14,1200203,202119,79992,79975,17
2021-05-14,1200179,202119,79995,79992,3
2021-05-14,1200328,202119,79997,79995,2
2021-05-14,1200104,202119,80024,79997,27
2021-05-14,1200054,202119,80038,80024,14
2021-05-14,1200013,202119,80044,80038,6
2021-05-14,1200385,202119,80046,80044,2
2021-05-14,1200138,202119,80046,80046,0
2021-05-14,1200344,202119,80047,80046,1
2021-05-14,1200336,202119,80071,80047,24
2021-05-14,1200708,202119,80073,80071,2
2021-05-14,1200807,202119,80076,80073,3
2021-05-14,1200393,202119,80079,80076,3
2021-05-14,1200401,202119,80142,80079,63
2021-05-14,1200427,202119,80148,80142,6
2021-05-14,1200351,202119,80164,80148,16
2021-05-14,1200500,202119,80171,80164,7
2021-05-14,1200450,202119,80173,80171,2
2021-05-14,1200609,202119,80192,80173,19
2021-05-14,1200435,202119,80192,80192,0
2021-05-15,1200351,202119,80212,80192,20
2021-05-15,1200013,202119,80214,80212,2
2021-05-15,1200054,202119,80215,80214,1
2021-05-15,1200104,202119,80227,80215,12
2021-05-15,1200138,202119,80229,80227,2
2021-05-15,1200179,202119,80231,80229,2
2021-05-15,1200203,202119,80231,80231,0
2021-05-15,1200302,202119,80231,80231,0
2021-05-15,1200344,202119,80231,80231,0
2021-05-15,1200385,202119,80234,80231,3
2021-05-15,1200328,202119,80234,80234,0
2021-05-15,1200807,202119,80246,80234,12
2021-05-15,1200252,202119,80260,80246,14
2021-05-15,1200427,202119,80263,80260,3
2021-05-15,1200708,202119,80267,80263,4
2021-05-15,1200609,202119,80268,80267,1
2021-05-15,1200336,202119,80286,80268,18
2021-05-15,1200500,202119,80287,80286,1
2021-05-15,1200435,202119,80294,80287,7
2021-05-15,1200401,202119,80351,80294,57
2021-05-15,1200393,202119,80351,80351,0
2021-05-15,1200450,202119,80353,80351,2
2021-05-16,1200054,202120,80354,80353,1
2021-05-16,1200708,202120,80355,80354,1
2021-05-16,1200609,202120,80364,80355,9
2021-05-16,1200450,202120,80366,80364,2
2021-05-16,1200500,202120,80370,80366,4
2021-05-16,1200435,202120,80370,80370,0
2021-05-16,1200427,202120,80370,80370,0
2021-05-16,1200401,202120,80395,80370,25
2021-05-16,1200393,202120,80395,80395,0
2021-05-16,1200807,202120,80395,80395,0
2021-05-16,1200336,202120,80395,80395,0
2021-05-16,1200351,202120,80395,80395,0
2021-05-16,1200252,202120,80395,80395,0
2021-05-16,1200344,202120,80395,80395,0
2021-05-16,1200328,202120,80395,80395,0
2021-05-16,1200302,202120,80396,80395,1
2021-05-16,1200179,202120,80397,80396,1
2021-05-16,1200385,202120,80397,80397,0
2021-05-16,1200138,202120,80397,80397,0
2021-05-16,1200104,202120,80411,80397,14
2021-05-16,1200013,202120,80414,80411,3
2021-05-16,1200203,202120,80414,80414,0
2021-05-17,1200427,202120,80414,80414,0
2021-05-17,1200807,202120,80414,80414,0
2021-05-17,1200328,202120,80414,80414,0
2021-05-17,1200344,202120,80414,80414,0
2021-05-17,1200351,202120,80420,80414,6
2021-05-17,1200336,202120,80435,80420,15
2021-05-17,1200385,202120,80438,80435,3
2021-05-17,1200393,202120,80438,80438,0
2021-05-17,1200252,202120,80443,80438,5
2021-05-17,1200401,202120,80498,80443,55
2021-05-17,1200609,202120,80499,80498,1
2021-05-17,1200435,202120,80499,80499,0
2021-05-17,1200450,202120,80501,80499,2
2021-05-17,1200302,202120,80548,80501,47
2021-05-17,1200203,202120,80562,80548,14
2021-05-17,1200179,202120,80563,80562,1
2021-05-17,1200138,202120,80563,80563,0
2021-05-17,1200104,202120,80569,80563,6
2021-05-17,1200054,202120,80569,80569,0
2021-05-17,1200013,202120,80570,80569,1
2021-05-17,1200708,202120,80571,80570,1
2021-05-17,1200500,202120,80576,80571,5
2021-05-18,1200401,202120,80605,80576,29
2021-05-18,1200427,202120,80605,80605,0
2021-05-18,1200435,202120,80605,80605,0
2021-05-18,1200500,202120,80605,80605,0
2021-05-18,1200138,202120,80605,80605,0
2021-05-18,1200450,202120,80604,80605,-1
2021-05-18,1200609,202120,80604,80604,0
2021-05-18,1200708,202120,80604,80604,0
2021-05-18,1200393,202120,80604,80604,0
2021-05-18,1200203,202120,80604,80604,0
2021-05-18,1200807,202120,80604,80604,0
2021-05-18,1200385,202120,80605,80604,1
2021-05-18,1200336,202120,80605,80605,0
2021-05-18,1200054,202120,80605,80605,0
2021-05-18,1200104,202120,80605,80605,0
2021-05-18,1200179,202120,80605,80605,0
2021-05-18,1200252,202120,80605,80605,0
2021-05-18,1200013,202120,80605,80605,0
2021-05-18,1200328,202120,80605,80605,0
2021-05-18,1200344,202120,80605,80605,0
2021-05-18,1200351,202120,80605,80605,0
2021-05-18,1200302,202120,80605,80605,0
2021-05-19,1200807,202120,80611,80605,6
2021-05-19,1200336,202120,80611,80611,0
2021-05-19,1200708,202120,80611,80611,0
2021-05-19,1200609,202120,80625,80611,14
2021-05-19,1200450,202120,80625,80625,0
2021-05-19,1200500,202120,80628,80625,3
2021-05-19,1200435,202120,80628,80628,0
2021-05-19,1200427,202120,80628,80628,0
2021-05-19,1200401,202120,80698,80628,70
2021-05-19,1200393,202120,80698,80698,0
2021-05-19,1200385,202120,80700,80698,2
2021-05-19,1200013,202120,80700,80700,0
2021-05-19,1200344,202120,80700,80700,0
2021-05-19,1200328,202120,80700,80700,0
2021-05-19,1200302,202120,80700,80700,0
2021-05-19,1200252,202120,80699,80700,-1
2021-05-19,1200203,202120,80700,80699,1
2021-05-19,1200179,202120,80701,80700,1
2021-05-19,1200138,202120,80702,80701,1
2021-05-19,1200104,202120,80702,80702,0
2021-05-19,1200054,202120,80703,80702,1
2021-05-19,1200351,202120,80703,80703,0
2021-05-20,1200393,202120,80703,80703,0
2021-05-20,1200401,202120,80747,80703,44
2021-05-20,1200427,202120,80747,80747,0
2021-05-20,1200435,202120,80747,80747,0
2021-05-20,1200807,202120,80754,80747,7
2021-05-20,1200450,202120,80758,80754,4
2021-05-20,1200609,202120,80768,80758,10
2021-05-20,1200302,202120,80785,80768,17
2021-05-20,1200252,202120,80790,80785,5
2021-05-20,1200500,202120,80790,80790,0
2021-05-20,1200385,202120,80791,80790,1
2021-05-20,1200336,202120,80791,80791,0
2021-05-20,1200351,202120,80791,80791,0
2021-05-20,1200344,202120,80791,80791,0
2021-05-20,1200328,202120,80791,80791,0
2021-05-20,1200708,202120,80791,80791,0
2021-05-20,1200203,202120,80792,80791,1
2021-05-20,1200179,202120,80794,80792,2
2021-05-20,1200138,202120,80796,80794,2
2021-05-20,1200104,202120,80812,80796,16
2021-05-20,1200054,202120,80812,80812,0
2021-05-20,1200013,202120,80812,80812,0
2021-05-21,1200302,202120,80825,80812,13
2021-05-21,1200252,202120,80832,80825,7
2021-05-21,1200203,202120,80862,80832,30
2021-05-21,1200179,202120,80868,80862,6
2021-05-21,1200344,202120,80868,80868,0
2021-05-21,1200104,202120,80895,80868,27
2021-05-21,1200054,202120,80935,80895,40
2021-05-21,1200013,202120,80935,80935,0
2021-05-21,1200328,202120,80935,80935,0
2021-05-21,1200138,202120,80935,80935,0
2021-05-21,1200336,202120,81004,80935,69
2021-05-21,1200351,202120,81020,81004,16
2021-05-21,1200385,202120,81049,81020,29
2021-05-21,1200393,202120,81052,81049,3
2021-05-21,1200708,202120,81081,81052,29
2021-05-21,1200609,202120,81088,81081,7
2021-05-21,1200450,202120,81089,81088,1
2021-05-21,1200435,202120,81093,81089,4
2021-05-21,1200427,202120,81102,81093,9
2021-05-21,1200401,202120,81225,81102,123
2021-05-21,1200807,202120,81229,81225,4
2021-05-21,1200500,202120,81250,81229,21
2021-05-22,1200385,202120,81250,81250,0
2021-05-22,1200609,202120,81253,81250,3
2021-05-22,1200450,202120,81260,81253,7
2021-05-22,1200500,202120,81260,81260,0
2021-05-22,1200435,202120,81261,81260,1
2021-05-22,1200427,202120,81261,81261,0
2021-05-22,1200401,202120,81320,81261,59
2021-05-22,1200393,202120,81320,81320,0
2021-05-22,1200807,202120,81324,81320,4
2021-05-22,1200344,202120,81324,81324,0
2021-05-22,1200708,202120,81324,81324,0
2021-05-22,1200138,202120,81324,81324,0
2021-05-22,1200203,202120,81325,81324,1
2021-05-22,1200302,202120,81326,81325,1
2021-05-22,1200252,202120,81328,81326,2
2021-05-22,1200179,202120,81331,81328,3
2021-05-22,1200336,202120,81348,81331,17
2021-05-22,1200104,202120,81350,81348,2
2021-05-22,1200054,202120,81358,81350,8
2021-05-22,1200013,202120,81360,81358,2
2021-05-22,1200328,202120,81360,81360,0
2021-05-22,1200351,202120,81363,81360,3
2021-05-23,1200385,202121,81364,81363,1
2021-05-23,1200203,202121,81364,81364,0
2021-05-23,1200708,202121,81371,81364,7
2021-05-23,1200450,202121,81373,81371,2
2021-05-23,1200500,202121,81388,81373,15
2021-05-23,1200435,202121,81388,81388,0
2021-05-23,1200427,202121,81388,81388,0
2021-05-23,1200401,202121,81423,81388,35
2021-05-23,1200393,202121,81423,81423,0
2021-05-23,1200807,202121,81429,81423,6
2021-05-23,1200336,202121,81429,81429,0
2021-05-23,1200351,202121,81428,81429,-1
2021-05-23,1200344,202121,81428,81428,0
2021-05-23,1200054,202121,81428,81428,0
2021-05-23,1200104,202121,81428,81428,0
2021-05-23,1200138,202121,81430,81428,2
2021-05-23,1200179,202121,81429,81430,-1
2021-05-23,1200013,202121,81430,81429,1
2021-05-23,1200252,202121,81430,81430,0
2021-05-23,1200302,202121,81429,81430,-1
2021-05-23,1200328,202121,81429,81429,0
2021-05-23,1200609,202121,81428,81429,-1
2021-05-24,1200328,202121,81428,81428,0
2021-05-24,1200013,202121,81427,81428,-1
2021-05-24,1200054,202121,81434,81427,7
2021-05-24,1200104,202121,81448,81434,14
2021-05-24,1200138,202121,81448,81448,0
2021-05-24,1200179,202121,81448,81448,0
2021-05-24,1200203,202121,81448,81448,0
2021-05-24,1200252,202121,81452,81448,4
2021-05-24,1200302,202121,81479,81452,27
2021-05-24,1200385,202121,81479,81479,0
2021-05-24,1200344,202121,81479,81479,0
2021-05-24,1200807,202121,81480,81479,1
2021-05-24,1200336,202121,81480,81480,0
2021-05-24,1200427,202121,81480,81480,0
2021-05-24,1200708,202121,81481,81480,1
2021-05-24,1200609,202121,81488,81481,7
2021-05-24,1200351,202121,81488,81488,0
2021-05-24,1200500,202121,81491,81488,3
2021-05-24,1200435,202121,81491,81491,0
2021-05-24,1200401,202121,81518,81491,27
2021-05-24,1200393,202121,81518,81518,0
2021-05-24,1200450,202121,81520,81518,2
2021-05-25,1200252,202121,81523,81520,3
2021-05-25,1200609,202121,81521,81523,-2
2021-05-25,1200450,202121,81521,81521,0
2021-05-25,1200500,202121,81526,81521,5
2021-05-25,1200435,202121,81530,81526,4
2021-05-25,1200427,202121,81534,81530,4
2021-05-25,1200401,202121,81608,81534,74
2021-05-25,1200393,202121,81609,81608,1
2021-05-25,1200807,202121,81609,81609,0
2021-05-25,1200336,202121,81638,81609,29
2021-05-25,1200708,202121,81639,81638,1
2021-05-25,1200351,202121,81641,81639,2
2021-05-25,1200203,202121,81652,81641,11
2021-05-25,1200344,202121,81653,81652,1
2021-05-25,1200328,202121,81656,81653,3
2021-05-25,1200302,202121,81657,81656,1
2021-05-25,1200138,202121,81657,81657,0
2021-05-25,1200385,202121,81661,81657,4
2021-05-25,1200104,202121,81662,81661,1
2021-05-25,1200054,202121,81662,81662,0
2021-05-25,1200013,202121,81666,81662,4
2021-05-25,1200179,202121,81666,81666,0
2021-05-26,1200427,202121,81667,81666,1
2021-05-26,1200302,202121,81670,81667,3
2021-05-26,1200328,202121,81670,81670,0
2021-05-26,1200344,202121,81670,81670,0
2021-05-26,1200351,202121,81671,81670,1
2021-05-26,1200336,202121,81698,81671,27
2021-05-26,1200609,202121,81704,81698,6
2021-05-26,1200252,202121,81710,81704,6
2021-05-26,1200393,202121,81710,81710,0
2021-05-26,1200401,202121,81775,81710,65
2021-05-26,1200385,202121,81795,81775,20
2021-05-26,1200435,202121,81797,81795,2
2021-05-26,1200450,202121,81800,81797,3
2021-05-26,1200807,202121,81809,81800,9
2021-05-26,1200203,202121,81834,81809,25
2021-05-26,1200179,202121,81836,81834,2
2021-05-26,1200138,202121,81837,81836,1
2021-05-26,1200104,202121,81852,81837,15
2021-05-26,1200054,202121,81853,81852,1
2021-05-26,1200013,202121,81855,81853,2
2021-05-26,1200708,202121,81856,81855,1
2021-05-26,1200500,202121,81865,81856,9
2021-05-27,1200344,202121,81865,81865,0
2021-05-27,1200328,202121,81874,81865,9
2021-05-27,1200302,202121,81900,81874,26
2021-05-27,1200252,202121,81901,81900,1
2021-05-27,1200351,202121,81903,81901,2
2021-05-27,1200179,202121,81908,81903,5
2021-05-27,1200138,202121,81908,81908,0
2021-05-27,1200609,202121,81909,81908,1
2021-05-27,1200203,202121,81920,81909,11
2021-05-27,1200336,202121,81926,81920,6
2021-05-27,1200385,202121,81931,81926,5
2021-05-27,1200807,202121,81938,81931,7
2021-05-27,1200013,202121,81938,81938,0
2021-05-27,1200104,202121,81939,81938,1
2021-05-27,1200708,202121,81946,81939,7
2021-05-27,1200450,202121,81951,81946,5
2021-05-27,1200054,202121,81951,81951,0
2021-05-27,1200435,202121,81951,81951,0
2021-05-27,1200427,202121,81958,81951,7
2021-05-27,1200401,202121,81993,81958,35
2021-05-27,1200393,202121,81993,81993,0
2021-05-27,1200500,202121,81995,81993,2
2021-05-28,1200344,202121,81999,81995,4
2021-05-28,1200435,202121,82000,81999,1
2021-05-28,1200013,202121,82003,82000,3
2021-05-28,1200104,202121,82018,82003,15
2021-05-28,1200138,202121,82021,82018,3
2021-05-28,1200179,202121,82023,82021,2
2021-05-28,1200203,202121,82026,82023,3
2021-05-28,1200252,202121,82032,82026,6
2021-05-28,1200302,202121,82034,82032,2
2021-05-28,1200328,202121,82044,82034,10
2021-05-28,1200351,202121,82044,82044,0
2021-05-28,1200336,202121,82053,82044,9
2021-05-28,1200708,202121,82054,82053,1
2021-05-28,1200609,202121,82061,82054,7
2021-05-28,1200450,202121,82064,82061,3
2021-05-28,1200500,202121,82069,82064,5
2021-05-28,1200385,202121,82078,82069,9
2021-05-28,1200427,202121,82078,82078,0
2021-05-28,1200401,202121,82145,82078,67
2021-05-28,1200054,202121,82162,82145,17
2021-05-28,1200393,202121,82163,82162,1
2021-05-28,1200807,202121,82164,82163,1
2021-05-29,1200252,202121,82164,82164,0
2021-05-29,1200203,202121,82164,82164,0
2021-05-29,1200179,202121,82168,82164,4
2021-05-29,1200138,202121,82170,82168,2
2021-05-29,1200013,202121,82170,82170,0
2021-05-29,1200054,202121,82171,82170,1
2021-05-29,1200450,202121,82173,82171,2
2021-05-29,1200609,202121,82173,82173,0
2021-05-29,1200302,202121,82176,82173,3
2021-05-29,1200104,202121,82178,82176,2
2021-05-29,1200328,202121,82178,82178,0
2021-05-29,1200344,202121,82178,82178,0
2021-05-29,1200351,202121,82178,82178,0
2021-05-29,1200336,202121,82178,82178,0
2021-05-29,1200385,202121,82180,82178,2
2021-05-29,1200807,202121,82192,82180,12
2021-05-29,1200393,202121,82192,82192,0
2021-05-29,1200401,202121,82218,82192,26
2021-05-29,1200427,202121,82219,82218,1
2021-05-29,1200500,202121,82220,82219,1
2021-05-29,1200708,202121,82222,82220,2
2021-05-29,1200435,202121,82222,82222,0
2021-05-30,1200302,202122,82222,82222,0
2021-05-30,1200252,202122,82226,82222,4
2021-05-30,1200203,202122,82237,82226,11
2021-05-30,1200179,202122,82237,82237,0
2021-05-30,1200385,202122,82248,82237,11
2021-05-30,1200104,202122,82256,82248,8
2021-05-30,1200054,202122,82265,82256,9
2021-05-30,1200013,202122,82278,82265,13
2021-05-30,1200328,202122,82332,82278,54
2021-05-30,1200138,202122,82333,82332,1
2021-05-30,1200344,202122,82335,82333,2
2021-05-30,1200351,202122,82342,82335,7
2021-05-30,1200708,202122,82341,82342,-1
2021-05-30,1200807,202122,82340,82341,-1
2021-05-30,1200393,202122,82343,82340,3
2021-05-30,1200401,202122,82436,82343,93
2021-05-30,1200427,202122,82437,82436,1
2021-05-30,1200336,202122,82479,82437,42
2021-05-30,1200500,202122,82485,82479,6
2021-05-30,1200450,202122,82487,82485,2
2021-05-30,1200609,202122,82488,82487,1
2021-05-30,1200435,202122,82493,82488,5
2021-05-31,1200328,202122,82493,82493,0
2021-05-31,1200013,202122,82492,82493,-1
2021-05-31,1200054,202122,82492,82492,0
2021-05-31,1200104,202122,82492,82492,0
2021-05-31,1200138,202122,82493,82492,1
2021-05-31,1200179,202122,82493,82493,0
2021-05-31,1200203,202122,82493,82493,0
2021-05-31,1200252,202122,82495,82493,2
2021-05-31,1200302,202122,82512,82495,17
2021-05-31,1200385,202122,82512,82512,0
2021-05-31,1200344,202122,82512,82512,0
2021-05-31,1200807,202122,82512,82512,0
2021-05-31,1200336,202122,82512,82512,0
2021-05-31,1200427,202122,82512,82512,0
2021-05-31,1200708,202122,82512,82512,0
2021-05-31,1200609,202122,82513,82512,1
2021-05-31,1200351,202122,82513,82513,0
2021-05-31,1200500,202122,82513,82513,0
2021-05-31,1200435,202122,82513,82513,0
2021-05-31,1200401,202122,82538,82513,25
2021-05-31,1200393,202122,82538,82538,0
2021-05-31,1200450,202122,82539,82538,1
2021-06-01,1200252,202122,82539,82539,0
2021-06-01,1200807,202122,82540,82539,1
2021-06-01,1200708,202122,82540,82540,0
2021-06-01,1200609,202122,82541,82540,1
2021-06-01,1200450,202122,82542,82541,1
2021-06-01,1200500,202122,82547,82542,5
2021-06-01,1200435,202122,82548,82547,1
2021-06-01,1200427,202122,82549,82548,1
2021-06-01,1200401,202122,82577,82549,28
2021-06-01,1200393,202122,82577,82577,0
2021-06-01,1200336,202122,82577,82577,0
2021-06-01,1200138,202122,82578,82577,1
2021-06-01,1200351,202122,82578,82578,0
2021-06-01,1200344,202122,82578,82578,0
2021-06-01,1200328,202122,82581,82578,3
2021-06-01,1200302,202122,82581,82581,0
2021-06-01,1200179,202122,82581,82581,0
2021-06-01,1200203,202122,82583,82581,2
2021-06-01,1200104,202122,82583,82583,0
2021-06-01,1200054,202122,82583,82583,0
2021-06-01,1200013,202122,82587,82583,4
2021-06-01,1200385,202122,82596,82587,9
2021-06-02,1200401,202122,82655,82596,59
2021-06-02,1200807,202122,82655,82655,0
2021-06-02,1200328,202122,82680,82655,25
2021-06-02,1200344,202122,82683,82680,3
2021-06-02,1200351,202122,82683,82683,0
2021-06-02,1200336,202122,82683,82683,0
2021-06-02,1200385,202122,82713,82683,30
2021-06-02,1200393,202122,82713,82713,0
2021-06-02,1200252,202122,82715,82713,2
2021-06-02,1200427,202122,82716,82715,1
2021-06-02,1200609,202122,82717,82716,1
2021-06-02,1200500,202122,82722,82717,5
2021-06-02,1200708,202122,82723,82722,1
2021-06-02,1200013,202122,82734,82723,11
2021-06-02,1200054,202122,82738,82734,4
2021-06-02,1200104,202122,82749,82738,11
2021-06-02,1200435,202122,82750,82749,1
2021-06-02,1200179,202122,82752,82750,2
2021-06-02,1200203,202122,82764,82752,12
2021-06-02,1200302,202122,82764,82764,0
2021-06-02,1200450,202122,82768,82764,4
2021-06-02,1200138,202122,82768,82768,0
2021-06-03,1200336,202122,82811,82768,43
2021-06-03,1200401,202122,82865,82811,54
2021-06-03,1200179,202122,82866,82865,1
2021-06-03,1200203,202122,82867,82866,1
2021-06-03,1200252,202122,82876,82867,9
2021-06-03,1200302,202122,82882,82876,6
2021-06-03,1200328,202122,82884,82882,2
2021-06-03,1200344,202122,82884,82884,0
2021-06-03,1200351,202122,82884,82884,0
2021-06-03,1200385,202122,82912,82884,28
2021-06-03,1200393,202122,82913,82912,1
2021-06-03,1200708,202122,82916,82913,3
2021-06-03,1200013,202122,82919,82916,3
2021-06-03,1200054,202122,82920,82919,1
2021-06-03,1200104,202122,82929,82920,9
2021-06-03,1200435,202122,82937,82929,8
2021-06-03,1200807,202122,82943,82937,6
2021-06-03,1200138,202122,82943,82943,0
2021-06-03,1200500,202122,82945,82943,2
2021-06-03,1200450,202122,82948,82945,3
2021-06-03,1200609,202122,82949,82948,1
2021-06-03,1200427,202122,82952,82949,3
2021-06-04,1200344,202122,82952,82952,0
2021-06-04,1200401,202122,82989,82952,37
2021-06-04,1200435,202122,82994,82989,5
2021-06-04,1200708,202122,82998,82994,4
2021-06-04,1200427,202122,83002,82998,4
2021-06-04,1200609,202122,83007,83002,5
2021-06-04,1200500,202122,83016,83007,9
2021-06-04,1200336,202122,83077,83016,61
2021-06-04,1200351,202122,83079,83077,2
2021-06-04,1200013,202122,83095,83079,16
2021-06-04,1200450,202122,83098,83095,3
2021-06-04,1200328,202122,83103,83098,5
2021-06-04,1200252,202122,83105,83103,2
2021-06-04,1200203,202122,83122,83105,17
2021-06-04,1200179,202122,83122,83122,0
2021-06-04,1200138,202122,83124,83122,2
2021-06-04,1200807,202122,83124,83124,0
2021-06-04,1200104,202122,83124,83124,0
2021-06-04,1200054,202122,83128,83124,4
2021-06-04,1200393,202122,83128,83128,0
2021-06-04,1200385,202122,83132,83128,4
2021-06-04,1200302,202122,83138,83132,6
2021-06-05,1200401,202122,83202,83138,64
2021-06-05,1200427,202122,83202,83202,0
2021-06-05,1200435,202122,83202,83202,0
2021-06-05,1200500,202122,83208,83202,6
2021-06-05,1200344,202122,83208,83208,0
2021-06-05,1200609,202122,83207,83208,-1
2021-06-05,1200708,202122,83211,83207,4
2021-06-05,1200351,202122,83220,83211,9
2021-06-05,1200393,202122,83220,83220,0
2021-06-05,1200450,202122,83219,83220,-1
2021-06-05,1200807,202122,83222,83219,3
2021-06-05,1200385,202122,83220,83222,-2
2021-06-05,1200336,202122,83220,83220,0
2021-06-05,1200054,202122,83221,83220,1
2021-06-05,1200104,202122,83235,83221,14
2021-06-05,1200138,202122,83235,83235,0
2021-06-05,1200179,202122,83236,83235,1
2021-06-05,1200013,202122,83240,83236,4
2021-06-05,1200252,202122,83248,83240,8
2021-06-05,1200328,202122,83250,83248,2
2021-06-05,1200302,202122,83250,83250,0
2021-06-05,1200203,202122,83255,83250,5
2021-06-06,1200385,202123,83257,83255,2
2021-06-06,1200609,202123,83258,83257,1
2021-06-06,1200336,202123,83265,83258,7
2021-06-06,1200203,202123,83266,83265,1
2021-06-06,1200252,202123,83266,83266,0
2021-06-06,1200302,202123,83265,83266,-1
2021-06-06,1200328,202123,83274,83265,9
2021-06-06,1200344,202123,83274,83274,0
2021-06-06,1200351,202123,83273,83274,-1
2021-06-06,1200450,202123,83273,83273,0
2021-06-06,1200708,202123,83273,83273,0
2021-06-06,1200179,202123,83274,83273,1
2021-06-06,1200401,202123,83303,83274,29
2021-06-06,1200427,202123,83303,83303,0
2021-06-06,1200435,202123,83303,83303,0
2021-06-06,1200500,202123,83303,83303,0
2021-06-06,1200807,202123,83308,83303,5
2021-06-06,1200054,202123,83323,83308,15
2021-06-06,1200013,202123,83321,83323,-2
2021-06-06,1200104,202123,83321,83321,0
2021-06-06,1200138,202123,83321,83321,0
2021-06-06,1200393,202123,83321,83321,0
2021-06-07,1200344,202123,83321,83321,0
2021-06-07,1200328,202123,83321,83321,0
2021-06-07,1200302,202123,83321,83321,0
2021-06-07,1200252,202123,83325,83321,4
2021-06-07,1200336,202123,83325,83325,0
2021-06-07,1200179,202123,83325,83325,0
2021-06-07,1200138,202123,83325,83325,0
2021-06-07,1200351,202123,83325,83325,0
2021-06-07,1200500,202123,83325,83325,0
2021-06-07,1200203,202123,83325,83325,0
2021-06-07,1200054,202123,83325,83325,0
2021-06-07,1200427,202123,83325,83325,0
2021-06-07,1200807,202123,83326,83325,1
2021-06-07,1200708,202123,83326,83326,0
2021-06-07,1200609,202123,83326,83326,0
2021-06-07,1200450,202123,83326,83326,0
2021-06-07,1200393,202123,83326,83326,0
2021-06-07,1200435,202123,83326,83326,0
2021-06-07,1200104,202123,83329,83326,3
2021-06-07,1200013,202123,83335,83329,6
2021-06-07,1200401,202123,83365,83335,30
2021-06-07,1200385,202123,83365,83365,0
2021-06-08,1200302,202123,83367,83365,2
2021-06-08,1200252,202123,83368,83367,1
2021-06-08,1200203,202123,83369,83368,1
2021-06-08,1200179,202123,83370,83369,1
2021-06-08,1200344,202123,83370,83370,0
2021-06-08,1200104,202123,83371,83370,1
2021-06-08,1200054,202123,83370,83371,-1
2021-06-08,1200013,202123,83370,83370,0
2021-06-08,1200328,202123,83377,83370,7
2021-06-08,1200138,202123,83377,83377,0
2021-06-08,1200336,202123,83385,83377,8
2021-06-08,1200385,202123,83385,83385,0
2021-06-08,1200807,202123,83387,83385,2
2021-06-08,1200401,202123,83423,83387,36
2021-06-08,1200708,202123,83423,83423,0
2021-06-08,1200609,202123,83423,83423,0
2021-06-08,1200450,202123,83423,83423,0
2021-06-08,1200351,202123,83423,83423,0
2021-06-08,1200435,202123,83423,83423,0
2021-06-08,1200427,202123,83423,83423,0
2021-06-08,1200393,202123,83423,83423,0
2021-06-08,1200500,202123,83424,83423,1
2021-06-09,1200302,202123,83424,83424,0
2021-06-09,1200609,202123,83424,83424,0
2021-06-09,1200450,202123,83424,83424,0
2021-06-09,1200500,202123,83424,83424,0
2021-06-09,1200435,202123,83424,83424,0
2021-06-09,1200427,202123,83424,83424,0
2021-06-09,1200401,202123,83443,83424,19
2021-06-09,1200393,202123,83443,83443,0
2021-06-09,1200807,202123,83444,83443,1
2021-06-09,1200708,202123,83445,83444,1
2021-06-09,1200351,202123,83445,83445,0
2021-06-09,1200138,202123,83447,83445,2
2021-06-09,1200344,202123,83447,83447,0
2021-06-09,1200013,202123,83450,83447,3
2021-06-09,1200054,202123,83450,83450,0
2021-06-09,1200104,202123,83478,83450,28
2021-06-09,1200385,202123,83478,83478,0
2021-06-09,1200179,202123,83479,83478,1
2021-06-09,1200252,202123,83488,83479,9
2021-06-09,1200328,202123,83488,83488,0
2021-06-09,1200203,202123,83488,83488,0
2021-06-09,1200336,202123,83488,83488,0
2021-06-10,1200807,202123,83492,83488,4
2021-06-10,1200393,202123,83494,83492,2
2021-06-10,1200401,202123,83531,83494,37
2021-06-10,1200427,202123,83543,83531,12
2021-06-10,1200385,202123,83569,83543,26
2021-06-10,1200500,202123,83582,83569,13
2021-06-10,1200450,202123,83578,83582,-4
2021-06-10,1200708,202123,83580,83578,2
2021-06-10,1200203,202123,83600,83580,20
2021-06-10,1200435,202123,83616,83600,16
2021-06-10,1200336,202123,83645,83616,29
2021-06-10,1200013,202123,83636,83645,-9
2021-06-10,1200344,202123,83633,83636,-3
2021-06-10,1200054,202123,83646,83633,13
2021-06-10,1200104,202123,83624,83646,-22
2021-06-10,1200138,202123,83626,83624,2
2021-06-10,1200179,202123,83626,83626,0
2021-06-10,1200351,202123,83623,83626,-3
2021-06-10,1200252,202123,83622,83623,-1
2021-06-10,1200302,202123,83659,83622,37
2021-06-10,1200328,202123,83715,83659,56
2021-06-10,1200609,202123,83680,83715,-35
2021-06-11,1200351,202123,83682,83680,2
2021-06-11,1200013,202123,83699,83682,17
2021-06-11,1200054,202123,83719,83699,20
2021-06-11,1200104,202123,83721,83719,2
2021-06-11,1200138,202123,83724,83721,3
2021-06-11,1200179,202123,83728,83724,4
2021-06-11,1200203,202123,83746,83728,18
2021-06-11,1200302,202123,83748,83746,2
2021-06-11,1200344,202123,83748,83748,0
2021-06-11,1200385,202123,83759,83748,11
2021-06-11,1200328,202123,83820,83759,61
2021-06-11,1200807,202123,83827,83820,7
2021-06-11,1200252,202123,83827,83827,0
2021-06-11,1200427,202123,83851,83827,24
2021-06-11,1200708,202123,83860,83851,9
2021-06-11,1200609,202123,83860,83860,0
2021-06-11,1200336,202123,83980,83860,120
2021-06-11,1200500,202123,83993,83980,13
2021-06-11,1200435,202123,83998,83993,5
2021-06-11,1200401,202123,84053,83998,55
2021-06-11,1200393,202123,84053,84053,0
2021-06-11,1200450,202123,84054,84053,1
2021-06-12,1200054,202123,84054,84054,0
2021-06-12,1200609,202123,84058,84054,4
2021-06-12,1200450,202123,84059,84058,1
2021-06-12,1200500,202123,84058,84059,-1
2021-06-12,1200435,202123,84058,84058,0
2021-06-12,1200427,202123,84058,84058,0
2021-06-12,1200401,202123,84088,84058,30
2021-06-12,1200393,202123,84088,84088,0
2021-06-12,1200807,202123,84091,84088,3
2021-06-12,1200708,202123,84091,84091,0
2021-06-12,1200336,202123,84091,84091,0
2021-06-12,1200351,202123,84091,84091,0
2021-06-12,1200252,202123,84100,84091,9
2021-06-12,1200344,202123,84100,84100,0
2021-06-12,1200328,202123,84100,84100,0
2021-06-12,1200302,202123,84100,84100,0
2021-06-12,1200179,202123,84099,84100,-1
2021-06-12,1200385,202123,84098,84099,-1
2021-06-12,1200138,202123,84100,84098,2
2021-06-12,1200104,202123,84119,84100,19
2021-06-12,1200013,202123,84119,84119,0
2021-06-12,1200203,202123,84119,84119,0
2021-06-13,1200427,202124,84119,84119,0
2021-06-13,1200302,202124,84132,84119,13
2021-06-13,1200328,202124,84132,84132,0
2021-06-13,1200344,202124,84132,84132,0
2021-06-13,1200351,202124,84132,84132,0
2021-06-13,1200336,202124,84132,84132,0
2021-06-13,1200609,202124,84134,84132,2
2021-06-13,1200252,202124,84135,84134,1
2021-06-13,1200393,202124,84135,84135,0
2021-06-13,1200401,202124,84170,84135,35
2021-06-13,1200385,202124,84171,84170,1
2021-06-13,1200435,202124,84171,84171,0
2021-06-13,1200450,202124,84171,84171,0
2021-06-13,1200807,202124,84176,84171,5
2021-06-13,1200203,202124,84176,84176,0
2021-06-13,1200179,202124,84177,84176,1
2021-06-13,1200138,202124,84177,84177,0
2021-06-13,1200104,202124,84181,84177,4
2021-06-13,1200054,202124,84181,84181,0
2021-06-13,1200013,202124,84183,84181,2
2021-06-13,1200708,202124,84187,84183,4
2021-06-13,1200500,202124,84189,84187,2
2021-06-14,1200351,202124,84193,84189,4
2021-06-14,1200344,202124,84193,84193,0
2021-06-14,1200328,202124,84231,84193,38
2021-06-14,1200302,202124,84230,84231,-1
2021-06-14,1200609,202124,84232,84230,2
2021-06-14,1200203,202124,84249,84232,17
2021-06-14,1200179,202124,84249,84249,0
2021-06-14,1200138,202124,84249,84249,0
2021-06-14,1200336,202124,84264,84249,15
2021-06-14,1200252,202124,84272,84264,8
2021-06-14,1200807,202124,84273,84272,1
2021-06-14,1200427,202124,84278,84273,5
2021-06-14,1200393,202124,84278,84278,0
2021-06-14,1200013,202124,84287,84278,9
2021-06-14,1200104,202124,84297,84287,10
2021-06-14,1200708,202124,84297,84297,0
2021-06-14,1200450,202124,84298,84297,1
2021-06-14,1200054,202124,84309,84298,11
2021-06-14,1200435,202124,84318,84309,9
2021-06-14,1200385,202124,84322,84318,4
2021-06-14,1200401,202124,84345,84322,23
2021-06-14,1200500,202124,84352,84345,7
2021-06-15,1200328,202124,84377,84352,25
2021-06-15,1200435,202124,84384,84377,7
2021-06-15,1200013,202124,84384,84384,0
2021-06-15,1200104,202124,84384,84384,0
2021-06-15,1200138,202124,84384,84384,0
2021-06-15,1200179,202124,84385,84384,1
2021-06-15,1200203,202124,84390,84385,5
2021-06-15,1200252,202124,84390,84390,0
2021-06-15,1200302,202124,84390,84390,0
2021-06-15,1200344,202124,84390,84390,0
2021-06-15,1200351,202124,84396,84390,6
2021-06-15,1200807,202124,84397,84396,1
2021-06-15,1200708,202124,84397,84397,0
2021-06-15,1200609,202124,84397,84397,0
2021-06-15,1200450,202124,84398,84397,1
2021-06-15,1200500,202124,84399,84398,1
2021-06-15,1200385,202124,84399,84399,0
2021-06-15,1200427,202124,84400,84399,1
2021-06-15,1200401,202124,84414,84400,14
2021-06-15,1200054,202124,84414,84414,0
2021-06-15,1200393,202124,84414,84414,0
2021-06-15,1200336,202124,84419,84414,5
2021-06-16,1200252,202124,84420,84419,1
2021-06-16,1200203,202124,84420,84420,0
2021-06-16,1200179,202124,84419,84420,-1
2021-06-16,1200138,202124,84421,84419,2
2021-06-16,1200302,202124,84420,84421,-1
2021-06-16,1200054,202124,84424,84420,4
2021-06-16,1200450,202124,84425,84424,1
2021-06-16,1200609,202124,84425,84425,0
2021-06-16,1200013,202124,84429,84425,4
2021-06-16,1200104,202124,84432,84429,3
2021-06-16,1200328,202124,84435,84432,3
2021-06-16,1200435,202124,84433,84435,-2
2021-06-16,1200351,202124,84434,84433,1
2021-06-16,1200336,202124,84434,84434,0
2021-06-16,1200385,202124,84434,84434,0
2021-06-16,1200807,202124,84446,84434,12
2021-06-16,1200393,202124,84446,84446,0
2021-06-16,1200401,202124,84470,84446,24
2021-06-16,1200427,202124,84470,84470,0
2021-06-16,1200500,202124,84468,84470,-2
2021-06-16,1200708,202124,84465,84468,-3
2021-06-16,1200344,202124,84465,84465,0
2021-06-17,1200302,202124,84464,84465,-1
2021-06-17,1200252,202124,84472,84464,8
2021-06-17,1200203,202124,84481,84472,9
2021-06-17,1200179,202124,84481,84481,0
2021-06-17,1200385,202124,84481,84481,0
2021-06-17,1200104,202124,84489,84481,8
2021-06-17,1200054,202124,84484,84489,-5
2021-06-17,1200013,202124,84484,84484,0
2021-06-17,1200328,202124,84485,84484,1
2021-06-17,1200138,202124,84485,84485,0
2021-06-17,1200344,202124,84485,84485,0
2021-06-17,1200336,202124,84484,84485,-1
2021-06-17,1200708,202124,84484,84484,0
2021-06-17,1200807,202124,84481,84484,-3
2021-06-17,1200393,202124,84481,84481,0
2021-06-17,1200401,202124,84508,84481,27
2021-06-17,1200427,202124,84507,84508,-1
2021-06-17,1200351,202124,84506,84507,-1
2021-06-17,1200500,202124,84504,84506,-2
2021-06-17,1200450,202124,84505,84504,1
2021-06-17,1200609,202124,84505,84505,0
2021-06-17,1200435,202124,84502,84505,-3
2021-06-18,1200328,202124,84503,84502,1
2021-06-18,1200013,202124,84509,84503,6
2021-06-18,1200054,202124,84521,84509,12
2021-06-18,1200104,202124,84534,84521,13
2021-06-18,1200138,202124,84534,84534,0
2021-06-18,1200179,202124,84539,84534,5
2021-06-18,1200203,202124,84556,84539,17
2021-06-18,1200252,202124,84561,84556,5
2021-06-18,1200302,202124,84581,84561,20
2021-06-18,1200344,202124,84581,84581,0
2021-06-18,1200385,202124,84592,84581,11
2021-06-18,1200807,202124,84602,84592,10
2021-06-18,1200393,202124,84602,84602,0
2021-06-18,1200401,202124,84640,84602,38
2021-06-18,1200435,202124,84645,84640,5
2021-06-18,1200500,202124,84649,84645,4
2021-06-18,1200450,202124,84654,84649,5
2021-06-18,1200609,202124,84657,84654,3
2021-06-18,1200708,202124,84657,84657,0
2021-06-18,1200427,202124,84659,84657,2
2021-06-18,1200336,202124,84701,84659,42
2021-06-18,1200351,202124,84702,84701,1
2021-06-19,1200393,202124,84702,84702,0
2021-06-19,1200401,202124,84742,84702,40
2021-06-19,1200427,202124,84744,84742,2
2021-06-19,1200435,202124,84750,84744,6
2021-06-19,1200252,202124,84754,84750,4
2021-06-19,1200450,202124,84755,84754,1
2021-06-19,1200609,202124,84756,84755,1
2021-06-19,1200708,202124,84755,84756,-1
2021-06-19,1200807,202124,84767,84755,12
2021-06-19,1200500,202124,84774,84767,7
2021-06-19,1200336,202124,84788,84774,14
2021-06-19,1200203,202124,84798,84788,10
2021-06-19,1200351,202124,84799,84798,1
2021-06-19,1200344,202124,84799,84799,0
2021-06-19,1200328,202124,84799,84799,0
2021-06-19,1200302,202124,84806,84799,7
2021-06-19,1200179,202124,84806,84806,0
2021-06-19,1200138,202124,84806,84806,0
2021-06-19,1200104,202124,84809,84806,3
2021-06-19,1200054,202124,84822,84809,13
2021-06-19,1200013,202124,84826,84822,4
2021-06-19,1200385,202124,84827,84826,1
2021-06-20,1200609,202125,84827,84827,0
2021-06-20,1200807,202125,84828,84827,1
2021-06-20,1200328,202125,84827,84828,-1
2021-06-20,1200344,202125,84827,84827,0
2021-06-20,1200351,202125,84826,84827,-1
2021-06-20,1200336,202125,84825,84826,-1
2021-06-20,1200385,202125,84825,84825,0
2021-06-20,1200393,202125,84825,84825,0
2021-06-20,1200401,202125,84841,84825,16
2021-06-20,1200427,202125,84841,84841,0
2021-06-20,1200252,202125,84841,84841,0
2021-06-20,1200500,202125,84842,84841,1
2021-06-20,1200708,202125,84846,84842,4
2021-06-20,1200013,202125,84847,84846,1
2021-06-20,1200054,202125,84847,84847,0
2021-06-20,1200104,202125,84847,84847,0
2021-06-20,1200435,202125,84844,84847,-3
2021-06-20,1200179,202125,84844,84844,0
2021-06-20,1200203,202125,84845,84844,1
2021-06-20,1200302,202125,84863,84845,18
2021-06-20,1200450,202125,84864,84863,1
2021-06-20,1200138,202125,84864,84864,0
2021-06-21,1200393,202125,84865,84864,1
2021-06-21,1200708,202125,84866,84865,1
2021-06-21,1200609,202125,84871,84866,5
2021-06-21,1200450,202125,84871,84871,0
2021-06-21,1200203,202125,84872,84871,1
2021-06-21,1200500,202125,84874,84872,2
2021-06-21,1200435,202125,84876,84874,2
2021-06-21,1200427,202125,84876,84876,0
2021-06-21,1200401,202125,84911,84876,35
2021-06-21,1200138,202125,84912,84911,1
2021-06-21,1200807,202125,84912,84912,0
2021-06-21,1200336,202125,84916,84912,4
2021-06-21,1200013,202125,84915,84916,-1
2021-06-21,1200054,202125,84915,84915,0
2021-06-21,1200104,202125,84922,84915,7
2021-06-21,1200179,202125,84922,84922,0
2021-06-21,1200385,202125,84927,84922,5
2021-06-21,1200302,202125,84927,84927,0
2021-06-21,1200328,202125,84927,84927,0
2021-06-21,1200344,202125,84927,84927,0
2021-06-21,1200351,202125,84927,84927,0
2021-06-21,1200252,202125,84933,84927,6
2021-06-22,1200385,202125,84933,84933,0
2021-06-22,1200708,202125,84931,84933,-2
2021-06-22,1200609,202125,84930,84931,-1
2021-06-22,1200450,202125,84929,84930,-1
2021-06-22,1200500,202125,84935,84929,6
2021-06-22,1200435,202125,84934,84935,-1
2021-06-22,1200427,202125,84934,84934,0
2021-06-22,1200401,202125,84948,84934,14
2021-06-22,1200807,202125,84952,84948,4
2021-06-22,1200393,202125,84954,84952,2
2021-06-22,1200336,202125,84953,84954,-1
2021-06-22,1200351,202125,84953,84953,0
2021-06-22,1200328,202125,84951,84953,-2
2021-06-22,1200302,202125,84951,84951,0
2021-06-22,1200252,202125,84954,84951,3
2021-06-22,1200203,202125,84954,84954,0
2021-06-22,1200179,202125,84954,84954,0
2021-06-22,1200138,202125,84954,84954,0
2021-06-22,1200104,202125,84953,84954,-1
2021-06-22,1200054,202125,84954,84953,1
2021-06-22,1200013,202125,84952,84954,-2
2021-06-22,1200344,202125,84952,84952,0
2021-06-23,1200393,202125,84952,84952,0
2021-06-23,1200252,202125,84965,84952,13
2021-06-23,1200401,202125,84981,84965,16
2021-06-23,1200427,202125,84981,84981,0
2021-06-23,1200302,202125,84981,84981,0
2021-06-23,1200500,202125,84981,84981,0
2021-06-23,1200450,202125,84984,84981,3
2021-06-23,1200609,202125,84987,84984,3
2021-06-23,1200807,202125,84989,84987,2
2021-06-23,1200435,202125,84994,84989,5
2021-06-23,1200385,202125,84999,84994,5
2021-06-23,1200328,202125,84999,84999,0
2021-06-23,1200351,202125,84999,84999,0
2021-06-23,1200013,202125,85010,84999,11
2021-06-23,1200054,202125,85017,85010,7
2021-06-23,1200104,202125,85042,85017,25
2021-06-23,1200138,202125,85042,85042,0
2021-06-23,1200336,202125,85050,85042,8
2021-06-23,1200203,202125,85056,85050,6
2021-06-23,1200708,202125,85058,85056,2
2021-06-23,1200344,202125,85058,85058,0
2021-06-23,1200179,202125,85058,85058,0
2021-06-24,1200302,202125,85075,85058,17
2021-06-24,1200344,202125,85075,85075,0
2021-06-24,1200013,202125,85075,85075,0
2021-06-24,1200054,202125,85073,85075,-2
2021-06-24,1200104,202125,85078,85073,5
2021-06-24,1200138,202125,85080,85078,2
2021-06-24,1200179,202125,85083,85080,3
2021-06-24,1200203,202125,85084,85083,1
2021-06-24,1200252,202125,85084,85084,0
2021-06-24,1200328,202125,85084,85084,0
2021-06-24,1200336,202125,85096,85084,12
2021-06-24,1200435,202125,85097,85096,1
2021-06-24,1200385,202125,85099,85097,2
2021-06-24,1200807,202125,85102,85099,3
2021-06-24,1200401,202125,85134,85102,32
2021-06-24,1200427,202125,85134,85134,0
2021-06-24,1200500,202125,85135,85134,1
2021-06-24,1200450,202125,85136,85135,1
2021-06-24,1200609,202125,85145,85136,9
2021-06-24,1200708,202125,85143,85145,-2
2021-06-24,1200393,202125,85143,85143,0
2021-06-24,1200351,202125,85143,85143,0
2021-06-25,1200807,202125,85148,85143,5
2021-06-25,1200393,202125,85148,85148,0
2021-06-25,1200401,202125,85206,85148,58
2021-06-25,1200427,202125,85206,85206,0
2021-06-25,1200385,202125,85207,85206,1
2021-06-25,1200500,202125,85220,85207,13
2021-06-25,1200450,202125,85222,85220,2
2021-06-25,1200609,202125,85239,85222,17
2021-06-25,1200708,202125,85243,85239,4
2021-06-25,1200435,202125,85243,85243,0
2021-06-25,1200344,202125,85243,85243,0
2021-06-25,1200336,202125,85243,85243,0
2021-06-25,1200138,202125,85244,85243,1
2021-06-25,1200328,202125,85244,85244,0
2021-06-25,1200013,202125,85245,85244,1
2021-06-25,1200054,202125,85255,85245,10
2021-06-25,1200104,202125,85264,85255,9
2021-06-25,1200351,202125,85271,85264,7
2021-06-25,1200179,202125,85271,85271,0
2021-06-25,1200252,202125,85282,85271,11
2021-06-25,1200302,202125,85288,85282,6
2021-06-25,1200203,202125,85288,85288,0
2021-06-26,1200807,202125,85291,85288,3
2021-06-26,1200393,202125,85291,85291,0
2021-06-26,1200401,202125,85312,85291,21
2021-06-26,1200427,202125,85314,85312,2
2021-06-26,1200203,202125,85332,85314,18
2021-06-26,1200500,202125,85338,85332,6
2021-06-26,1200450,202125,85339,85338,1
2021-06-26,1200708,202125,85341,85339,2
2021-06-26,1200385,202125,85343,85341,2
2021-06-26,1200435,202125,85347,85343,4
2021-06-26,1200336,202125,85374,85347,27
2021-06-26,1200351,202125,85378,85374,4
2021-06-26,1200344,202125,85379,85378,1
2021-06-26,1200054,202125,85391,85379,12
2021-06-26,1200104,202125,85394,85391,3
2021-06-26,1200138,202125,85394,85394,0
2021-06-26,1200179,202125,85394,85394,0
2021-06-26,1200013,202125,85396,85394,2
2021-06-26,1200252,202125,85397,85396,1
2021-06-26,1200302,202125,85396,85397,-1
2021-06-26,1200328,202125,85396,85396,0
2021-06-26,1200609,202125,85398,85396,2
2021-06-27,1200328,202126,85398,85398,0
2021-06-27,1200013,202126,85429,85398,31
2021-06-27,1200054,202126,85432,85429,3
2021-06-27,1200344,202126,85432,85432,0
2021-06-27,1200138,202126,85432,85432,0
2021-06-27,1200179,202126,85433,85432,1
2021-06-27,1200203,202126,85435,85433,2
2021-06-27,1200252,202126,85435,85435,0
2021-06-27,1200302,202126,85444,85435,9
2021-06-27,1200385,202126,85446,85444,2
2021-06-27,1200104,202126,85446,85446,0
2021-06-27,1200807,202126,85446,85446,0
2021-06-27,1200336,202126,85446,85446,0
2021-06-27,1200427,202126,85448,85446,2
2021-06-27,1200708,202126,85448,85448,0
2021-06-27,1200609,202126,85452,85448,4
2021-06-27,1200351,202126,85452,85452,0
2021-06-27,1200500,202126,85453,85452,1
2021-06-27,1200435,202126,85453,85453,0
2021-06-27,1200401,202126,85478,85453,25
2021-06-27,1200393,202126,85478,85478,0
2021-06-27,1200450,202126,85478,85478,0
2021-06-28,1200252,202126,85484,85478,6
2021-06-28,1200708,202126,85484,85484,0
2021-06-28,1200609,202126,85484,85484,0
2021-06-28,1200450,202126,85484,85484,0
2021-06-28,1200500,202126,85484,85484,0
2021-06-28,1200435,202126,85484,85484,0
2021-06-28,1200427,202126,85484,85484,0
2021-06-28,1200401,202126,85500,85484,16
2021-06-28,1200393,202126,85500,85500,0
2021-06-28,1200807,202126,85500,85500,0
2021-06-28,1200336,202126,85500,85500,0
2021-06-28,1200138,202126,85500,85500,0
2021-06-28,1200351,202126,85500,85500,0
2021-06-28,1200344,202126,85500,85500,0
2021-06-28,1200328,202126,85500,85500,0
2021-06-28,1200302,202126,85499,85500,-1
2021-06-28,1200179,202126,85498,85499,-1
2021-06-28,1200203,202126,85499,85498,1
2021-06-28,1200104,202126,85508,85499,9
2021-06-28,1200054,202126,85508,85508,0
2021-06-28,1200013,202126,85511,85508,3
2021-06-28,1200385,202126,85511,85511,0
2021-06-29,1200401,202126,85536,85511,25
2021-06-29,1200302,202126,85536,85536,0
2021-06-29,1200328,202126,85536,85536,0
2021-06-29,1200385,202126,85536,85536,0
2021-06-29,1200351,202126,85536,85536,0
2021-06-29,1200336,202126,85536,85536,0
2021-06-29,1200609,202126,85536,85536,0
2021-06-29,1200252,202126,85537,85536,1
2021-06-29,1200393,202126,85537,85537,0
2021-06-29,1200427,202126,85537,85537,0
2021-06-29,1200344,202126,85537,85537,0
2021-06-29,1200500,202126,85539,85537,2
2021-06-29,1200450,202126,85539,85539,0
2021-06-29,1200807,202126,85541,85539,2
2021-06-29,1200203,202126,85540,85541,-1
2021-06-29,1200179,202126,85540,85540,0
2021-06-29,1200138,202126,85540,85540,0
2021-06-29,1200104,202126,85541,85540,1
2021-06-29,1200054,202126,85541,85541,0
2021-06-29,1200013,202126,85541,85541,0
2021-06-29,1200708,202126,85541,85541,0
2021-06-29,1200435,202126,85541,85541,0
2021-06-30,1200351,202126,85541,85541,0
2021-06-30,1200344,202126,85541,85541,0
2021-06-30,1200328,202126,85541,85541,0
2021-06-30,1200302,202126,85541,85541,0
2021-06-30,1200609,202126,85543,85541,2
2021-06-30,1200179,202126,85543,85543,0
2021-06-30,1200138,202126,85543,85543,0
2021-06-30,1200336,202126,85543,85543,0
2021-06-30,1200252,202126,85547,85543,4
2021-06-30,1200385,202126,85547,85547,0
2021-06-30,1200203,202126,85547,85547,0
2021-06-30,1200393,202126,85547,85547,0
2021-06-30,1200401,202126,85568,85547,21
2021-06-30,1200427,202126,85568,85568,0
2021-06-30,1200435,202126,85568,85568,0
2021-06-30,1200500,202126,85568,85568,0
2021-06-30,1200450,202126,85568,85568,0
2021-06-30,1200708,202126,85568,85568,0
2021-06-30,1200104,202126,85568,85568,0
2021-06-30,1200013,202126,85568,85568,0
2021-06-30,1200054,202126,85568,85568,0
2021-06-30,1200807,202126,85571,85568,3
2021-07-01,1200328,202126,85571,85571,0
2021-07-01,1200302,202126,85576,85571,5
2021-07-01,1200252,202126,85577,85576,1
2021-07-01,1200203,202126,85609,85577,32
2021-07-01,1200435,202126,85610,85609,1
2021-07-01,1200138,202126,85610,85610,0
2021-07-01,1200104,202126,85622,85610,12
2021-07-01,1200013,202126,85623,85622,1
2021-07-01,1200344,202126,85624,85623,1
2021-07-01,1200179,202126,85624,85624,0
2021-07-01,1200351,202126,85629,85624,5
2021-07-01,1200450,202126,85632,85629,3
2021-07-01,1200708,202126,85635,85632,3
2021-07-01,1200609,202126,85635,85635,0
2021-07-01,1200500,202126,85643,85635,8
2021-07-01,1200385,202126,85648,85643,5
2021-07-01,1200427,202126,85648,85648,0
2021-07-01,1200401,202126,85682,85648,34
2021-07-01,1200054,202126,85670,85682,-12
2021-07-01,1200393,202126,85671,85670,1
2021-07-01,1200807,202126,85674,85671,3
2021-07-01,1200336,202126,85751,85674,77
2021-07-02,1200179,202126,85751,85751,0
2021-07-02,1200252,202126,85753,85751,2
2021-07-02,1200203,202126,85755,85753,2
2021-07-02,1200013,202126,85754,85755,-1
2021-07-02,1200302,202126,85754,85754,0
2021-07-02,1200104,202126,85761,85754,7
2021-07-02,1200054,202126,85762,85761,1
2021-07-02,1200450,202126,85762,85762,0
2021-07-02,1200609,202126,85765,85762,3
2021-07-02,1200138,202126,85765,85765,0
2021-07-02,1200328,202126,85765,85765,0
2021-07-02,1200393,202126,85765,85765,0
2021-07-02,1200351,202126,85766,85765,1
2021-07-02,1200435,202126,85766,85766,0
2021-07-02,1200708,202126,85766,85766,0
2021-07-02,1200500,202126,85770,85766,4
2021-07-02,1200427,202126,85773,85770,3
2021-07-02,1200344,202126,85773,85773,0
2021-07-02,1200807,202126,85774,85773,1
2021-07-02,1200385,202126,85777,85774,3
2021-07-02,1200336,202126,85796,85777,19
2021-07-02,1200401,202126,85812,85796,16
2021-07-03,1200302,202126,85814,85812,2
2021-07-03,1200385,202126,85816,85814,2
2021-07-03,1200013,202126,85828,85816,12
2021-07-03,1200054,202126,85831,85828,3
2021-07-03,1200104,202126,85831,85831,0
2021-07-03,1200138,202126,85831,85831,0
2021-07-03,1200179,202126,85831,85831,0
2021-07-03,1200203,202126,85837,85831,6
2021-07-03,1200252,202126,85841,85837,4
2021-07-03,1200328,202126,85841,85841,0
2021-07-03,1200344,202126,85841,85841,0
2021-07-03,1200336,202126,85867,85841,26
2021-07-03,1200708,202126,85867,85867,0
2021-07-03,1200609,202126,85864,85867,-3
2021-07-03,1200450,202126,85864,85864,0
2021-07-03,1200500,202126,85864,85864,0
2021-07-03,1200435,202126,85864,85864,0
2021-07-03,1200427,202126,85864,85864,0
2021-07-03,1200401,202126,85882,85864,18
2021-07-03,1200393,202126,85882,85882,0
2021-07-03,1200807,202126,85885,85882,3
2021-07-03,1200351,202126,85886,85885,1
2021-07-04,1200302,202127,85889,85886,3
2021-07-04,1200252,202127,85891,85889,2
2021-07-04,1200203,202127,85891,85891,0
2021-07-04,1200179,202127,85891,85891,0
2021-07-04,1200328,202127,85891,85891,0
2021-07-04,1200104,202127,85901,85891,10
2021-07-04,1200054,202127,85901,85901,0
2021-07-04,1200013,202127,85901,85901,0
2021-07-04,1200344,202127,85901,85901,0
2021-07-04,1200138,202127,85901,85901,0
2021-07-04,1200385,202127,85902,85901,1
2021-07-04,1200351,202127,85902,85902,0
2021-07-04,1200807,202127,85905,85902,3
2021-07-04,1200393,202127,85905,85905,0
2021-07-04,1200401,202127,85910,85905,5
2021-07-04,1200435,202127,85910,85910,0
2021-07-04,1200500,202127,85910,85910,0
2021-07-04,1200450,202127,85910,85910,0
2021-07-04,1200609,202127,85910,85910,0
2021-07-04,1200708,202127,85912,85910,2
2021-07-04,1200427,202127,85912,85912,0
2021-07-04,1200336,202127,85912,85912,0
2021-07-05,1200393,202127,85912,85912,0
2021-07-05,1200401,202127,85931,85912,19
2021-07-05,1200427,202127,85934,85931,3
2021-07-05,1200435,202127,85934,85934,0
2021-07-05,1200807,202127,85937,85934,3
2021-07-05,1200450,202127,85937,85937,0
2021-07-05,1200609,202127,85934,85937,-3
2021-07-05,1200708,202127,85934,85934,0
2021-07-05,1200252,202127,85936,85934,2
2021-07-05,1200500,202127,85939,85936,3
2021-07-05,1200336,202127,85972,85939,33
2021-07-05,1200138,202127,85972,85972,0
2021-07-05,1200351,202127,85973,85972,1
2021-07-05,1200344,202127,85973,85973,0
2021-07-05,1200328,202127,85972,85973,-1
2021-07-05,1200302,202127,85979,85972,7
2021-07-05,1200179,202127,85979,85979,0
2021-07-05,1200203,202127,85991,85979,12
2021-07-05,1200104,202127,85991,85991,0
2021-07-05,1200054,202127,85993,85991,2
2021-07-05,1200013,202127,85997,85993,4
2021-07-05,1200385,202127,85998,85997,1
2021-07-06,1200401,202127,86012,85998,14
2021-07-06,1200807,202127,86012,86012,0
2021-07-06,1200328,202127,86012,86012,0
2021-07-06,1200344,202127,86012,86012,0
2021-07-06,1200351,202127,86012,86012,0
2021-07-06,1200336,202127,86012,86012,0
2021-07-06,1200385,202127,86012,86012,0
2021-07-06,1200393,202127,86012,86012,0
2021-07-06,1200252,202127,86012,86012,0
2021-07-06,1200427,202127,86012,86012,0
2021-07-06,1200609,202127,86012,86012,0
2021-07-06,1200500,202127,86012,86012,0
2021-07-06,1200708,202127,86012,86012,0
2021-07-06,1200013,202127,86012,86012,0
2021-07-06,1200054,202127,86012,86012,0
2021-07-06,1200104,202127,86012,86012,0
2021-07-06,1200435,202127,86012,86012,0
2021-07-06,1200179,202127,86012,86012,0
2021-07-06,1200203,202127,86012,86012,0
2021-07-06,1200302,202127,86012,86012,0
2021-07-06,1200450,202127,86012,86012,0
2021-07-06,1200138,202127,86012,86012,0
2021-07-07,1200336,202127,86056,86012,44
2021-07-07,1200393,202127,86056,86056,0
2021-07-07,1200401,202127,86088,86056,32
2021-07-07,1200179,202127,86088,86088,0
2021-07-07,1200203,202127,86095,86088,7
2021-07-07,1200252,202127,86101,86095,6
2021-07-07,1200302,202127,86109,86101,8
2021-07-07,1200328,202127,86109,86109,0
2021-07-07,1200344,202127,86109,86109,0
2021-07-07,1200351,202127,86112,86109,3
2021-07-07,1200385,202127,86114,86112,2
2021-07-07,1200807,202127,86115,86114,1
2021-07-07,1200708,202127,86116,86115,1
2021-07-07,1200054,202127,86118,86116,2
2021-07-07,1200104,202127,86123,86118,5
2021-07-07,1200435,202127,86128,86123,5
2021-07-07,1200427,202127,86131,86128,3
2021-07-07,1200013,202127,86131,86131,0
2021-07-07,1200500,202127,86133,86131,2
2021-07-07,1200450,202127,86136,86133,3
2021-07-07,1200609,202127,86134,86136,-2
2021-07-07,1200138,202127,86135,86134,1
2021-07-08,1200013,202127,86137,86135,2
2021-07-08,1200401,202127,86154,86137,17
2021-07-08,1200708,202127,86154,86154,0
2021-07-08,1200609,202127,86154,86154,0
2021-07-08,1200450,202127,86154,86154,0
2021-07-08,1200500,202127,86157,86154,3
2021-07-08,1200427,202127,86180,86157,23
2021-07-08,1200336,202127,86234,86180,54
2021-07-08,1200351,202127,86238,86234,4
2021-07-08,1200344,202127,86241,86238,3
2021-07-08,1200435,202127,86244,86241,3
2021-07-08,1200302,202127,86287,86244,43
2021-07-08,1200385,202127,86291,86287,4
2021-07-08,1200393,202127,86291,86291,0
2021-07-08,1200054,202127,86295,86291,4
2021-07-08,1200104,202127,86295,86295,0
2021-07-08,1200328,202127,86295,86295,0
2021-07-08,1200138,202127,86295,86295,0
2021-07-08,1200179,202127,86297,86295,2
2021-07-08,1200203,202127,86306,86297,9
2021-07-08,1200252,202127,86307,86306,1
2021-07-08,1200807,202127,86311,86307,4
2021-07-09,1200807,202127,86311,86311,0
2021-07-09,1200708,202127,86312,86311,1
2021-07-09,1200609,202127,86312,86312,0
2021-07-09,1200450,202127,86314,86312,2
2021-07-09,1200500,202127,86318,86314,4
2021-07-09,1200435,202127,86334,86318,16
2021-07-09,1200427,202127,86339,86334,5
2021-07-09,1200401,202127,86357,86339,18
2021-07-09,1200393,202127,86356,86357,-1
2021-07-09,1200385,202127,86356,86356,0
2021-07-09,1200344,202127,86356,86356,0
2021-07-09,1200351,202127,86356,86356,0
2021-07-09,1200013,202127,86368,86356,12
2021-07-09,1200054,202127,86368,86368,0
2021-07-09,1200104,202127,86368,86368,0
2021-07-09,1200138,202127,86368,86368,0
2021-07-09,1200336,202127,86392,86368,24
2021-07-09,1200203,202127,86407,86392,15
2021-07-09,1200252,202127,86415,86407,8
2021-07-09,1200328,202127,86415,86415,0
2021-07-09,1200302,202127,86413,86415,-2
2021-07-09,1200179,202127,86415,86413,2
2021-07-10,1200393,202127,86415,86415,0
2021-07-10,1200385,202127,86416,86415,1
2021-07-10,1200252,202127,86426,86416,10
2021-07-10,1200302,202127,86428,86426,2
2021-07-10,1200328,202127,86428,86428,0
2021-07-10,1200344,202127,86428,86428,0
2021-07-10,1200351,202127,86431,86428,3
2021-07-10,1200336,202127,86433,86431,2
2021-07-10,1200807,202127,86434,86433,1
2021-07-10,1200708,202127,86436,86434,2
2021-07-10,1200203,202127,86437,86436,1
2021-07-10,1200401,202127,86457,86437,20
2021-07-10,1200435,202127,86457,86457,0
2021-07-10,1200500,202127,86457,86457,0
2021-07-10,1200450,202127,86457,86457,0
2021-07-10,1200609,202127,86457,86457,0
2021-07-10,1200054,202127,86457,86457,0
2021-07-10,1200013,202127,86459,86457,2
2021-07-10,1200138,202127,86459,86459,0
2021-07-10,1200179,202127,86460,86459,1
2021-07-10,1200104,202127,86469,86460,9
2021-07-10,1200427,202127,86469,86469,0
2021-07-11,1200013,202128,86469,86469,0
2021-07-11,1200807,202128,86470,86469,1
2021-07-11,1200401,202128,86477,86470,7
2021-07-11,1200500,202128,86481,86477,4
2021-07-11,1200385,202128,86481,86481,0
2021-07-11,1200609,202128,86481,86481,0
2021-07-11,1200708,202128,86483,86481,2
2021-07-11,1200435,202128,86483,86483,0
2021-07-11,1200450,202128,86483,86483,0
2021-07-11,1200336,202128,86476,86483,-7
2021-07-11,1200351,202128,86478,86476,2
2021-07-11,1200427,202128,86478,86478,0
2021-07-11,1200328,202128,86478,86478,0
2021-07-11,1200302,202128,86479,86478,1
2021-07-11,1200252,202128,86481,86479,2
2021-07-11,1200203,202128,86480,86481,-1
2021-07-11,1200179,202128,86480,86480,0
2021-07-11,1200138,202128,86481,86480,1
2021-07-11,1200104,202128,86482,86481,1
2021-07-11,1200054,202128,86482,86482,0
2021-07-11,1200393,202128,86482,86482,0
2021-07-11,1200344,202128,86482,86482,0
2021-07-12,1200427,202128,86482,86482,0
2021-07-12,1200435,202128,86482,86482,0
2021-07-12,1200500,202128,86483,86482,1
2021-07-12,1200450,202128,86483,86483,0
2021-07-12,1200054,202128,86483,86483,0
2021-07-12,1200708,202128,86483,86483,0
2021-07-12,1200336,202128,86483,86483,0
2021-07-12,1200013,202128,86483,86483,0
2021-07-12,1200401,202128,86487,86483,4
2021-07-12,1200609,202128,86487,86487,0
2021-07-12,1200393,202128,86487,86487,0
2021-07-12,1200328,202128,86487,86487,0
2021-07-12,1200385,202128,86487,86487,0
2021-07-12,1200351,202128,86487,86487,0
2021-07-12,1200302,202128,86490,86487,3
2021-07-12,1200252,202128,86493,86490,3
2021-07-12,1200203,202128,86495,86493,2
2021-07-12,1200179,202128,86495,86495,0
2021-07-12,1200138,202128,86495,86495,0
2021-07-12,1200104,202128,86496,86495,1
2021-07-12,1200344,202128,86496,86496,0
2021-07-12,1200807,202128,86496,86496,0
2021-07-13,1200807,202128,86496,86496,0
2021-07-13,1200401,202128,86505,86496,9
2021-07-13,1200708,202128,86505,86505,0
2021-07-13,1200427,202128,86505,86505,0
2021-07-13,1200344,202128,86505,86505,0
2021-07-13,1200500,202128,86505,86505,0
2021-07-13,1200450,202128,86505,86505,0
2021-07-13,1200609,202128,86505,86505,0
2021-07-13,1200385,202128,86505,86505,0
2021-07-13,1200435,202128,86505,86505,0
2021-07-13,1200336,202128,86505,86505,0
2021-07-13,1200393,202128,86505,86505,0
2021-07-13,1200252,202128,86506,86505,1
2021-07-13,1200351,202128,86506,86506,0
2021-07-13,1200054,202128,86506,86506,0
2021-07-13,1200203,202128,86506,86506,0
2021-07-13,1200179,202128,86506,86506,0
2021-07-13,1200013,202128,86506,86506,0
2021-07-13,1200138,202128,86506,86506,0
2021-07-13,1200302,202128,86507,86506,1
2021-07-13,1200328,202128,86507,86507,0
2021-07-13,1200104,202128,86507,86507,0
2021-07-14,1200104,202128,86514,86507,7
2021-07-14,1200336,202128,86514,86514,0
2021-07-14,1200179,202128,86514,86514,0
2021-07-14,1200203,202128,86519,86514,5
2021-07-14,1200252,202128,86522,86519,3
2021-07-14,1200302,202128,86523,86522,1
2021-07-14,1200328,202128,86523,86523,0
2021-07-14,1200344,202128,86523,86523,0
2021-07-14,1200351,202128,86523,86523,0
2021-07-14,1200385,202128,86527,86523,4
2021-07-14,1200708,202128,86527,86527,0
2021-07-14,1200393,202128,86527,86527,0
2021-07-14,1200401,202128,86539,86527,12
2021-07-14,1200450,202128,86540,86539,1
2021-07-14,1200427,202128,86541,86540,1
2021-07-14,1200138,202128,86542,86541,1
2021-07-14,1200054,202128,86550,86542,8
2021-07-14,1200435,202128,86552,86550,2
2021-07-14,1200013,202128,86553,86552,1
2021-07-14,1200500,202128,86556,86553,3
2021-07-14,1200807,202128,86558,86556,2
2021-07-14,1200609,202128,86559,86558,1
2021-07-15,1200252,202128,86566,86559,7
2021-07-15,1200302,202128,86573,86566,7
2021-07-15,1200203,202128,86576,86573,3
2021-07-15,1200179,202128,86577,86576,1
2021-07-15,1200344,202128,86577,86577,0
2021-07-15,1200054,202128,86580,86577,3
2021-07-15,1200013,202128,86580,86580,0
2021-07-15,1200328,202128,86580,86580,0
2021-07-15,1200138,202128,86580,86580,0
2021-07-15,1200336,202128,86589,86580,9
2021-07-15,1200104,202128,86589,86589,0
2021-07-15,1200385,202128,86592,86589,3
2021-07-15,1200401,202128,86605,86592,13
2021-07-15,1200708,202128,86605,86605,0
2021-07-15,1200351,202128,86606,86605,1
2021-07-15,1200609,202128,86605,86606,-1
2021-07-15,1200807,202128,86604,86605,-1
2021-07-15,1200500,202128,86604,86604,0
2021-07-15,1200435,202128,86604,86604,0
2021-07-15,1200427,202128,86609,86604,5
2021-07-15,1200393,202128,86609,86609,0
2021-07-15,1200450,202128,86610,86609,1
2021-07-16,1200328,202128,86610,86610,0
2021-07-16,1200708,202128,86612,86610,2
2021-07-16,1200609,202128,86610,86612,-2
2021-07-16,1200450,202128,86611,86610,1
2021-07-16,1200500,202128,86613,86611,2
2021-07-16,1200435,202128,86614,86613,1
2021-07-16,1200427,202128,86618,86614,4
2021-07-16,1200401,202128,86629,86618,11
2021-07-16,1200393,202128,86629,86629,0
2021-07-16,1200807,202128,86630,86629,1
2021-07-16,1200351,202128,86631,86630,1
2021-07-16,1200336,202128,86631,86631,0
2021-07-16,1200138,202128,86631,86631,0
2021-07-16,1200302,202128,86631,86631,0
2021-07-16,1200252,202128,86632,86631,1
2021-07-16,1200179,202128,86635,86632,3
2021-07-16,1200385,202128,86642,86635,7
2021-07-16,1200203,202128,86649,86642,7
2021-07-16,1200054,202128,86656,86649,7
2021-07-16,1200013,202128,86656,86656,0
2021-07-16,1200344,202128,86656,86656,0
2021-07-16,1200104,202128,86659,86656,3
2021-07-17,1200385,202128,86659,86659,0
2021-07-17,1200708,202128,86659,86659,0
2021-07-17,1200450,202128,86660,86659,1
2021-07-17,1200203,202128,86661,86660,1
2021-07-17,1200435,202128,86661,86661,0
2021-07-17,1200427,202128,86661,86661,0
2021-07-17,1200401,202128,86674,86661,13
2021-07-17,1200393,202128,86674,86674,0
2021-07-17,1200807,202128,86675,86674,1
2021-07-17,1200336,202128,86675,86675,0
2021-07-17,1200500,202128,86675,86675,0
2021-07-17,1200344,202128,86675,86675,0
2021-07-17,1200328,202128,86675,86675,0
2021-07-17,1200302,202128,86675,86675,0
2021-07-17,1200252,202128,86677,86675,2
2021-07-17,1200609,202128,86677,86677,0
2021-07-17,1200179,202128,86679,86677,2
2021-07-17,1200138,202128,86679,86679,0
2021-07-17,1200104,202128,86680,86679,1
2021-07-17,1200054,202128,86680,86680,0
2021-07-17,1200013,202128,86680,86680,0
2021-07-17,1200351,202128,86679,86680,-1
2021-07-18,1200302,202129,86682,86679,3
2021-07-18,1200252,202129,86683,86682,1
2021-07-18,1200203,202129,86682,86683,-1
2021-07-18,1200179,202129,86682,86682,0
2021-07-18,1200344,202129,86682,86682,0
2021-07-18,1200054,202129,86682,86682,0
2021-07-18,1200013,202129,86682,86682,0
2021-07-18,1200328,202129,86682,86682,0
2021-07-18,1200138,202129,86682,86682,0
2021-07-18,1200336,202129,86682,86682,0
2021-07-18,1200104,202129,86682,86682,0
2021-07-18,1200385,202129,86682,86682,0
2021-07-18,1200807,202129,86682,86682,0
2021-07-18,1200393,202129,86682,86682,0
2021-07-18,1200427,202129,86682,86682,0
2021-07-18,1200435,202129,86682,86682,0
2021-07-18,1200450,202129,86683,86682,1
2021-07-18,1200609,202129,86683,86683,0
2021-07-18,1200708,202129,86684,86683,1
2021-07-18,1200401,202129,86694,86684,10
2021-07-18,1200500,202129,86695,86694,1
2021-07-18,1200351,202129,86695,86695,0
2021-07-19,1200393,202129,86695,86695,0
2021-07-19,1200401,202129,86705,86695,10
2021-07-19,1200427,202129,86706,86705,1
2021-07-19,1200435,202129,86706,86706,0
2021-07-19,1200351,202129,86711,86706,5
2021-07-19,1200450,202129,86711,86711,0
2021-07-19,1200609,202129,86710,86711,-1
2021-07-19,1200708,202129,86712,86710,2
2021-07-19,1200807,202129,86712,86712,0
2021-07-19,1200500,202129,86714,86712,2
2021-07-19,1200336,202129,86725,86714,11
2021-07-19,1200054,202129,86723,86725,-2
2021-07-19,1200344,202129,86723,86723,0
2021-07-19,1200013,202129,86723,86723,0
2021-07-19,1200104,202129,86725,86723,2
2021-07-19,1200385,202129,86726,86725,1
2021-07-19,1200179,202129,86727,86726,1
2021-07-19,1200252,202129,86727,86727,0
2021-07-19,1200302,202129,86742,86727,15
2021-07-19,1200328,202129,86742,86742,0
2021-07-19,1200203,202129,86744,86742,2
2021-07-19,1200138,202129,86744,86744,0
2021-07-20,1200385,202129,86744,86744,0
2021-07-20,1200252,202129,86746,86744,2
2021-07-20,1200393,202129,86746,86746,0
2021-07-20,1200336,202129,86746,86746,0
2021-07-20,1200401,202129,86752,86746,6
2021-07-20,1200344,202129,86752,86752,0
2021-07-20,1200328,202129,86752,86752,0
2021-07-20,1200807,202129,86752,86752,0
2021-07-20,1200609,202129,86753,86752,1
2021-07-20,1200351,202129,86753,86753,0
2021-07-20,1200427,202129,86753,86753,0
2021-07-20,1200435,202129,86753,86753,0
2021-07-20,1200500,202129,86755,86753,2
2021-07-20,1200013,202129,86755,86755,0
2021-07-20,1200054,202129,86755,86755,0
2021-07-20,1200104,202129,86757,86755,2
2021-07-20,1200138,202129,86757,86757,0
2021-07-20,1200708,202129,86757,86757,0
2021-07-20,1200203,202129,86758,86757,1
2021-07-20,1200302,202129,86758,86758,0
2021-07-20,1200450,202129,86758,86758,0
2021-07-20,1200179,202129,86758,86758,0
2021-07-21,1200351,202129,86756,86758,-2
2021-07-21,1200609,202129,86755,86756,-1
2021-07-21,1200138,202129,86755,86755,0
2021-07-21,1200179,202129,86756,86755,1
2021-07-21,1200203,202129,86757,86756,1
2021-07-21,1200252,202129,86757,86757,0
2021-07-21,1200302,202129,86755,86757,-2
2021-07-21,1200328,202129,86755,86755,0
2021-07-21,1200344,202129,86755,86755,0
2021-07-21,1200336,202129,86755,86755,0
2021-07-21,1200385,202129,86754,86755,-1
2021-07-21,1200013,202129,86754,86754,0
2021-07-21,1200393,202129,86754,86754,0
2021-07-21,1200401,202129,86760,86754,6
2021-07-21,1200427,202129,86770,86760,10
2021-07-21,1200435,202129,86770,86770,0
2021-07-21,1200500,202129,86771,86770,1
2021-07-21,1200450,202129,86771,86771,0
2021-07-21,1200708,202129,86770,86771,-1
2021-07-21,1200104,202129,86772,86770,2
2021-07-21,1200054,202129,86772,86772,0
2021-07-21,1200807,202129,86772,86772,0
2021-07-22,1200328,202129,86772,86772,0
2021-07-22,1200302,202129,86783,86772,11
2021-07-22,1200252,202129,86786,86783,3
2021-07-22,1200203,202129,86821,86786,35
2021-07-22,1200344,202129,86821,86821,0
2021-07-22,1200138,202129,86821,86821,0
2021-07-22,1200104,202129,86821,86821,0
2021-07-22,1200013,202129,86822,86821,1
2021-07-22,1200435,202129,86822,86822,0
2021-07-22,1200179,202129,86823,86822,1
2021-07-22,1200351,202129,86823,86823,0
2021-07-22,1200807,202129,86825,86823,2
2021-07-22,1200708,202129,86827,86825,2
2021-07-22,1200609,202129,86825,86827,-2
2021-07-22,1200450,202129,86827,86825,2
2021-07-22,1200500,202129,86828,86827,1
2021-07-22,1200385,202129,86830,86828,2
2021-07-22,1200427,202129,86835,86830,5
2021-07-22,1200401,202129,86850,86835,15
2021-07-22,1200054,202129,86850,86850,0
2021-07-22,1200393,202129,86850,86850,0
2021-07-22,1200336,202129,86859,86850,9
2021-07-23,1200302,202129,86859,86859,0
2021-07-23,1200252,202129,86861,86859,2
2021-07-23,1200203,202129,86861,86861,0
2021-07-23,1200179,202129,86861,86861,0
2021-07-23,1200344,202129,86861,86861,0
2021-07-23,1200104,202129,86861,86861,0
2021-07-23,1200054,202129,86863,86861,2
2021-07-23,1200013,202129,86863,86863,0
2021-07-23,1200328,202129,86863,86863,0
2021-07-23,1200138,202129,86863,86863,0
2021-07-23,1200385,202129,86863,86863,0
2021-07-23,1200336,202129,86863,86863,0
2021-07-23,1200807,202129,86863,86863,0
2021-07-23,1200401,202129,86868,86863,5
2021-07-23,1200708,202129,86870,86868,2
2021-07-23,1200609,202129,86870,86870,0
2021-07-23,1200450,202129,86870,86870,0
2021-07-23,1200351,202129,86870,86870,0
2021-07-23,1200435,202129,86870,86870,0
2021-07-23,1200427,202129,86870,86870,0
2021-07-23,1200393,202129,86870,86870,0
2021-07-23,1200500,202129,86870,86870,0
2021-07-24,1200252,202129,86877,86870,7
2021-07-24,1200609,202129,86883,86877,6
2021-07-24,1200450,202129,86887,86883,4
2021-07-24,1200500,202129,86890,86887,3
2021-07-24,1200435,202129,86892,86890,2
2021-07-24,1200427,202129,86904,86892,12
2021-07-24,1200401,202129,86912,86904,8
2021-07-24,1200393,202129,86912,86912,0
2021-07-24,1200807,202129,86912,86912,0
2021-07-24,1200708,202129,86913,86912,1
2021-07-24,1200351,202129,86915,86913,2
2021-07-24,1200138,202129,86915,86915,0
2021-07-24,1200344,202129,86915,86915,0
2021-07-24,1200013,202129,86919,86915,4
2021-07-24,1200054,202129,86922,86919,3
2021-07-24,1200104,202129,86923,86922,1
2021-07-24,1200385,202129,86923,86923,0
2021-07-24,1200179,202129,86923,86923,0
2021-07-24,1200302,202129,86932,86923,9
2021-07-24,1200328,202129,86932,86932,0
2021-07-24,1200203,202129,86945,86932,13
2021-07-24,1200336,202129,86951,86945,6
2021-07-25,1200807,202130,86953,86951,2
2021-07-25,1200393,202130,86953,86953,0
2021-07-25,1200401,202130,86963,86953,10
2021-07-25,1200427,202130,86963,86963,0
2021-07-25,1200385,202130,86963,86963,0
2021-07-25,1200500,202130,86964,86963,1
2021-07-25,1200450,202130,86964,86964,0
2021-07-25,1200708,202130,86968,86964,4
2021-07-25,1200203,202130,86967,86968,-1
2021-07-25,1200435,202130,86967,86967,0
2021-07-25,1200336,202130,86967,86967,0
2021-07-25,1200013,202130,86967,86967,0
2021-07-25,1200344,202130,86967,86967,0
2021-07-25,1200054,202130,86967,86967,0
2021-07-25,1200104,202130,86969,86967,2
2021-07-25,1200138,202130,86969,86969,0
2021-07-25,1200179,202130,86969,86969,0
2021-07-25,1200351,202130,86969,86969,0
2021-07-25,1200252,202130,86968,86969,-1
2021-07-25,1200302,202130,86967,86968,-1
2021-07-25,1200328,202130,86967,86967,0
2021-07-25,1200609,202130,86967,86967,0
2021-07-26,1200351,202130,86967,86967,0
2021-07-26,1200013,202130,86979,86967,12
2021-07-26,1200104,202130,86979,86979,0
2021-07-26,1200138,202130,86979,86979,0
2021-07-26,1200179,202130,86979,86979,0
2021-07-26,1200203,202130,86979,86979,0
2021-07-26,1200252,202130,86980,86979,1
2021-07-26,1200302,202130,86978,86980,-2
2021-07-26,1200344,202130,86978,86978,0
2021-07-26,1200427,202130,86985,86978,7
2021-07-26,1200328,202130,86985,86985,0
2021-07-26,1200385,202130,86985,86985,0
2021-07-26,1200500,202130,86986,86985,1
2021-07-26,1200054,202130,86986,86986,0
2021-07-26,1200708,202130,86983,86986,-3
2021-07-26,1200609,202130,86983,86983,0
2021-07-26,1200336,202130,86996,86983,13
2021-07-26,1200435,202130,86996,86996,0
2021-07-26,1200401,202130,87001,86996,5
2021-07-26,1200393,202130,87001,87001,0
2021-07-26,1200807,202130,87002,87001,1
2021-07-26,1200450,202130,87002,87002,0
2021-07-27,1200385,202130,87002,87002,0
2021-07-27,1200708,202130,87002,87002,0
2021-07-27,1200609,202130,87002,87002,0
2021-07-27,1200450,202130,87003,87002,1
2021-07-27,1200500,202130,87004,87003,1
2021-07-27,1200435,202130,87004,87004,0
2021-07-27,1200427,202130,87004,87004,0
2021-07-27,1200401,202130,87009,87004,5
2021-07-27,1200393,202130,87009,87009,0
2021-07-27,1200807,202130,87009,87009,0
2021-07-27,1200336,202130,87009,87009,0
2021-07-27,1200351,202130,87009,87009,0
2021-07-27,1200344,202130,87009,87009,0
2021-07-27,1200328,202130,87009,87009,0
2021-07-27,1200302,202130,87009,87009,0
2021-07-27,1200252,202130,87011,87009,2
2021-07-27,1200179,202130,87012,87011,1
2021-07-27,1200013,202130,87014,87012,2
2021-07-27,1200138,202130,87014,87014,0
2021-07-27,1200104,202130,87014,87014,0
2021-07-27,1200054,202130,87014,87014,0
2021-07-27,1200203,202130,87014,87014,0
2021-07-28,1200427,202130,87027,87014,13
2021-07-28,1200807,202130,87028,87027,1
2021-07-28,1200328,202130,87028,87028,0
2021-07-28,1200344,202130,87028,87028,0
2021-07-28,1200351,202130,87033,87028,5
2021-07-28,1200336,202130,87032,87033,-1
2021-07-28,1200385,202130,87037,87032,5
2021-07-28,1200393,202130,87037,87037,0
2021-07-28,1200252,202130,87043,87037,6
2021-07-28,1200401,202130,87053,87043,10
2021-07-28,1200609,202130,87053,87053,0
2021-07-28,1200435,202130,87053,87053,0
2021-07-28,1200450,202130,87054,87053,1
2021-07-28,1200302,202130,87054,87054,0
2021-07-28,1200203,202130,87065,87054,11
2021-07-28,1200179,202130,87065,87065,0
2021-07-28,1200138,202130,87065,87065,0
2021-07-28,1200104,202130,87065,87065,0
2021-07-28,1200054,202130,87065,87065,0
2021-07-28,1200013,202130,87068,87065,3
2021-07-28,1200708,202130,87068,87068,0
2021-07-28,1200500,202130,87068,87068,0
2021-07-29,1200401,202130,87073,87068,5
2021-07-29,1200427,202130,87080,87073,7
2021-07-29,1200435,202130,87080,87080,0
2021-07-29,1200500,202130,87082,87080,2
2021-07-29,1200138,202130,87082,87082,0
2021-07-29,1200450,202130,87083,87082,1
2021-07-29,1200609,202130,87083,87083,0
2021-07-29,1200708,202130,87084,87083,1
2021-07-29,1200393,202130,87085,87084,1
2021-07-29,1200203,202130,87086,87085,1
2021-07-29,1200807,202130,87086,87086,0
2021-07-29,1200385,202130,87087,87086,1
2021-07-29,1200336,202130,87087,87087,0
2021-07-29,1200054,202130,87087,87087,0
2021-07-29,1200104,202130,87087,87087,0
2021-07-29,1200179,202130,87087,87087,0
2021-07-29,1200252,202130,87087,87087,0
2021-07-29,1200013,202130,87087,87087,0
2021-07-29,1200328,202130,87087,87087,0
2021-07-29,1200344,202130,87087,87087,0
2021-07-29,1200351,202130,87087,87087,0
2021-07-29,1200302,202130,87088,87087,1
2021-07-30,1200807,202130,87089,87088,1
2021-07-30,1200336,202130,87090,87089,1
2021-07-30,1200708,202130,87091,87090,1
2021-07-30,1200609,202130,87119,87091,28
2021-07-30,1200450,202130,87119,87119,0
2021-07-30,1200500,202130,87122,87119,3
2021-07-30,1200435,202130,87126,87122,4
2021-07-30,1200427,202130,87126,87126,0
2021-07-30,1200401,202130,87131,87126,5
2021-07-30,1200393,202130,87131,87131,0
2021-07-30,1200385,202130,87131,87131,0
2021-07-30,1200013,202130,87135,87131,4
2021-07-30,1200344,202130,87135,87135,0
2021-07-30,1200328,202130,87135,87135,0
2021-07-30,1200302,202130,87135,87135,0
2021-07-30,1200252,202130,87136,87135,1
2021-07-30,1200203,202130,87139,87136,3
2021-07-30,1200179,202130,87139,87139,0
2021-07-30,1200138,202130,87139,87139,0
2021-07-30,1200104,202130,87140,87139,1
2021-07-30,1200054,202130,87140,87140,0
2021-07-30,1200351,202130,87143,87140,3
2021-07-31,1200393,202130,87143,87143,0
2021-07-31,1200401,202130,87148,87143,5
2021-07-31,1200427,202130,87148,87148,0
2021-07-31,1200435,202130,87148,87148,0
2021-07-31,1200807,202130,87148,87148,0
2021-07-31,1200450,202130,87148,87148,0
2021-07-31,1200609,202130,87148,87148,0
2021-07-31,1200302,202130,87148,87148,0
2021-07-31,1200252,202130,87149,87148,1
2021-07-31,1200500,202130,87149,87149,0
2021-07-31,1200385,202130,87149,87149,0
2021-07-31,1200336,202130,87149,87149,0
2021-07-31,1200351,202130,87149,87149,0
2021-07-31,1200344,202130,87149,87149,0
2021-07-31,1200328,202130,87149,87149,0
2021-07-31,1200708,202130,87149,87149,0
2021-07-31,1200203,202130,87149,87149,0
2021-07-31,1200179,202130,87149,87149,0
2021-07-31,1200138,202130,87149,87149,0
2021-07-31,1200104,202130,87156,87149,7
2021-07-31,1200054,202130,87156,87156,0
2021-07-31,1200013,202130,87156,87156,0
2021-08-01,1200302,202131,87156,87156,0
2021-08-01,1200252,202131,87156,87156,0
2021-08-01,1200203,202131,87156,87156,0
2021-08-01,1200179,202131,87156,87156,0
2021-08-01,1200344,202131,87156,87156,0
2021-08-01,1200104,202131,87158,87156,2
2021-08-01,1200054,202131,87158,87158,0
2021-08-01,1200013,202131,87158,87158,0
2021-08-01,1200328,202131,87158,87158,0
2021-08-01,1200138,202131,87158,87158,0
2021-08-01,1200336,202131,87158,87158,0
2021-08-01,1200351,202131,87158,87158,0
2021-08-01,1200385,202131,87158,87158,0
2021-08-01,1200393,202131,87158,87158,0
2021-08-01,1200708,202131,87160,87158,2
2021-08-01,1200609,202131,87160,87160,0
2021-08-01,1200450,202131,87160,87160,0
2021-08-01,1200435,202131,87160,87160,0
2021-08-01,1200427,202131,87160,87160,0
2021-08-01,1200401,202131,87161,87160,1
2021-08-01,1200807,202131,87162,87161,1
2021-08-01,1200500,202131,87162,87162,0
2021-08-02,1200385,202131,87163,87162,1
2021-08-02,1200609,202131,87196,87163,33
2021-08-02,1200450,202131,87196,87196,0
2021-08-02,1200500,202131,87196,87196,0
2021-08-02,1200435,202131,87197,87196,1
2021-08-02,1200427,202131,87196,87197,-1
2021-08-02,1200401,202131,87198,87196,2
2021-08-02,1200393,202131,87198,87198,0
2021-08-02,1200807,202131,87198,87198,0
2021-08-02,1200344,202131,87198,87198,0
2021-08-02,1200708,202131,87197,87198,-1
2021-08-02,1200138,202131,87197,87197,0
2021-08-02,1200203,202131,87199,87197,2
2021-08-02,1200302,202131,87203,87199,4
2021-08-02,1200252,202131,87201,87203,-2
2021-08-02,1200179,202131,87202,87201,1
2021-08-02,1200336,202131,87200,87202,-2
2021-08-02,1200104,202131,87200,87200,0
2021-08-02,1200054,202131,87200,87200,0
2021-08-02,1200013,202131,87203,87200,3
2021-08-02,1200328,202131,87203,87203,0
2021-08-02,1200351,202131,87201,87203,-2
2021-08-03,1200385,202131,87201,87201,0
2021-08-03,1200203,202131,87202,87201,1
2021-08-03,1200708,202131,87202,87202,0
2021-08-03,1200450,202131,87202,87202,0
2021-08-03,1200500,202131,87202,87202,0
2021-08-03,1200435,202131,87202,87202,0
2021-08-03,1200427,202131,87202,87202,0
2021-08-03,1200401,202131,87203,87202,1
2021-08-03,1200393,202131,87203,87203,0
2021-08-03,1200807,202131,87203,87203,0
2021-08-03,1200336,202131,87203,87203,0
2021-08-03,1200351,202131,87203,87203,0
2021-08-03,1200344,202131,87203,87203,0
2021-08-03,1200054,202131,87203,87203,0
2021-08-03,1200104,202131,87203,87203,0
2021-08-03,1200138,202131,87203,87203,0
2021-08-03,1200179,202131,87203,87203,0
2021-08-03,1200013,202131,87203,87203,0
2021-08-03,1200252,202131,87203,87203,0
2021-08-03,1200302,202131,87203,87203,0
2021-08-03,1200328,202131,87203,87203,0
2021-08-03,1200609,202131,87203,87203,0
2021-08-04,1200328,202131,87203,87203,0
2021-08-04,1200013,202131,87218,87203,15
2021-08-04,1200054,202131,87218,87218,0
2021-08-04,1200104,202131,87218,87218,0
2021-08-04,1200138,202131,87218,87218,0
2021-08-04,1200179,202131,87221,87218,3
2021-08-04,1200203,202131,87223,87221,2
2021-08-04,1200252,202131,87223,87223,0
2021-08-04,1200302,202131,87223,87223,0
2021-08-04,1200385,202131,87223,87223,0
2021-08-04,1200344,202131,87223,87223,0
2021-08-04,1200807,202131,87223,87223,0
2021-08-04,1200336,202131,87223,87223,0
2021-08-04,1200427,202131,87236,87223,13
2021-08-04,1200708,202131,87236,87236,0
2021-08-04,1200609,202131,87241,87236,5
2021-08-04,1200351,202131,87241,87241,0
2021-08-04,1200500,202131,87241,87241,0
2021-08-04,1200435,202131,87241,87241,0
2021-08-04,1200401,202131,87247,87241,6
2021-08-04,1200393,202131,87247,87247,0
2021-08-04,1200450,202131,87247,87247,0
2021-08-05,1200252,202131,87248,87247,1
2021-08-05,1200609,202131,87265,87248,17
2021-08-05,1200450,202131,87265,87265,0
2021-08-05,1200500,202131,87266,87265,1
2021-08-05,1200435,202131,87266,87266,0
2021-08-05,1200427,202131,87270,87266,4
2021-08-05,1200401,202131,87276,87270,6
2021-08-05,1200393,202131,87276,87276,0
2021-08-05,1200807,202131,87276,87276,0
2021-08-05,1200336,202131,87293,87276,17
2021-08-05,1200708,202131,87293,87293,0
2021-08-05,1200351,202131,87296,87293,3
2021-08-05,1200203,202131,87300,87296,4
2021-08-05,1200344,202131,87300,87300,0
2021-08-05,1200328,202131,87300,87300,0
2021-08-05,1200302,202131,87302,87300,2
2021-08-05,1200138,202131,87302,87302,0
2021-08-05,1200385,202131,87302,87302,0
2021-08-05,1200104,202131,87304,87302,2
2021-08-05,1200054,202131,87304,87304,0
2021-08-05,1200013,202131,87306,87304,2
2021-08-05,1200179,202131,87306,87306,0
2021-08-06,1200427,202131,87307,87306,1
2021-08-06,1200302,202131,87309,87307,2
2021-08-06,1200328,202131,87309,87309,0
2021-08-06,1200344,202131,87309,87309,0
2021-08-06,1200351,202131,87309,87309,0
2021-08-06,1200336,202131,87310,87309,1
2021-08-06,1200609,202131,87362,87310,52
2021-08-06,1200252,202131,87363,87362,1
2021-08-06,1200393,202131,87364,87363,1
2021-08-06,1200401,202131,87368,87364,4
2021-08-06,1200385,202131,87369,87368,1
2021-08-06,1200435,202131,87369,87369,0
2021-08-06,1200450,202131,87369,87369,0
2021-08-06,1200807,202131,87369,87369,0
2021-08-06,1200203,202131,87371,87369,2
2021-08-06,1200179,202131,87371,87371,0
2021-08-06,1200138,202131,87371,87371,0
2021-08-06,1200104,202131,87371,87371,0
2021-08-06,1200054,202131,87378,87371,7
2021-08-06,1200013,202131,87386,87378,8
2021-08-06,1200708,202131,87391,87386,5
2021-08-06,1200500,202131,87394,87391,3
2021-08-07,1200344,202131,87394,87394,0
2021-08-07,1200328,202131,87394,87394,0
2021-08-07,1200302,202131,87394,87394,0
2021-08-07,1200252,202131,87394,87394,0
2021-08-07,1200351,202131,87394,87394,0
2021-08-07,1200179,202131,87394,87394,0
2021-08-07,1200138,202131,87394,87394,0
2021-08-07,1200609,202131,87394,87394,0
2021-08-07,1200203,202131,87394,87394,0
2021-08-07,1200336,202131,87394,87394,0
2021-08-07,1200385,202131,87394,87394,0
2021-08-07,1200807,202131,87394,87394,0
2021-08-07,1200013,202131,87394,87394,0
2021-08-07,1200104,202131,87394,87394,0
2021-08-07,1200708,202131,87399,87394,5
2021-08-07,1200450,202131,87399,87399,0
2021-08-07,1200054,202131,87401,87399,2
2021-08-07,1200435,202131,87401,87401,0
2021-08-07,1200427,202131,87401,87401,0
2021-08-07,1200401,202131,87404,87401,3
2021-08-07,1200393,202131,87404,87404,0
2021-08-07,1200500,202131,87404,87404,0
2021-08-08,1200344,202132,87404,87404,0
2021-08-08,1200435,202132,87404,87404,0
2021-08-08,1200013,202132,87404,87404,0
2021-08-08,1200104,202132,87404,87404,0
2021-08-08,1200138,202132,87404,87404,0
2021-08-08,1200179,202132,87404,87404,0
2021-08-08,1200203,202132,87404,87404,0
2021-08-08,1200252,202132,87404,87404,0
2021-08-08,1200302,202132,87404,87404,0
2021-08-08,1200328,202132,87404,87404,0
2021-08-08,1200351,202132,87404,87404,0
2021-08-08,1200336,202132,87404,87404,0
2021-08-08,1200708,202132,87404,87404,0
2021-08-08,1200609,202132,87404,87404,0
2021-08-08,1200450,202132,87404,87404,0
2021-08-08,1200500,202132,87404,87404,0
2021-08-08,1200385,202132,87404,87404,0
2021-08-08,1200427,202132,87404,87404,0
2021-08-08,1200401,202132,87404,87404,0
2021-08-08,1200054,202132,87404,87404,0
2021-08-08,1200393,202132,87404,87404,0
2021-08-08,1200807,202132,87404,87404,0
2021-08-09,1200252,202132,87404,87404,0
2021-08-09,1200203,202132,87408,87404,4
2021-08-09,1200179,202132,87408,87408,0
2021-08-09,1200138,202132,87408,87408,0
2021-08-09,1200013,202132,87410,87408,2
2021-08-09,1200054,202132,87417,87410,7
2021-08-09,1200450,202132,87417,87417,0
2021-08-09,1200609,202132,87417,87417,0
2021-08-09,1200302,202132,87417,87417,0
2021-08-09,1200104,202132,87417,87417,0
2021-08-09,1200328,202132,87417,87417,0
2021-08-09,1200344,202132,87417,87417,0
2021-08-09,1200351,202132,87420,87417,3
2021-08-09,1200336,202132,87423,87420,3
2021-08-09,1200385,202132,87423,87423,0
2021-08-09,1200807,202132,87423,87423,0
2021-08-09,1200393,202132,87423,87423,0
2021-08-09,1200401,202132,87431,87423,8
2021-08-09,1200427,202132,87431,87431,0
2021-08-09,1200500,202132,87437,87431,6
2021-08-09,1200708,202132,87437,87437,0
2021-08-09,1200435,202132,87437,87437,0
2021-08-10,1200302,202132,87437,87437,0
2021-08-10,1200252,202132,87437,87437,0
2021-08-10,1200203,202132,87437,87437,0
2021-08-10,1200179,202132,87437,87437,0
2021-08-10,1200385,202132,87437,87437,0
2021-08-10,1200104,202132,87437,87437,0
2021-08-10,1200054,202132,87437,87437,0
2021-08-10,1200013,202132,87437,87437,0
2021-08-10,1200328,202132,87437,87437,0
2021-08-10,1200138,202132,87437,87437,0
2021-08-10,1200344,202132,87437,87437,0
2021-08-10,1200351,202132,87437,87437,0
2021-08-10,1200708,202132,87437,87437,0
2021-08-10,1200807,202132,87437,87437,0
2021-08-10,1200393,202132,87437,87437,0
2021-08-10,1200401,202132,87438,87437,1
2021-08-10,1200427,202132,87438,87438,0
2021-08-10,1200336,202132,87438,87438,0
2021-08-10,1200500,202132,87438,87438,0
2021-08-10,1200450,202132,87438,87438,0
2021-08-10,1200609,202132,87438,87438,0
2021-08-10,1200435,202132,87438,87438,0
2021-08-11,1200344,202132,87438,87438,0
2021-08-11,1200013,202132,87450,87438,12
2021-08-11,1200054,202132,87451,87450,1
2021-08-11,1200104,202132,87451,87451,0
2021-08-11,1200138,202132,87451,87451,0
2021-08-11,1200179,202132,87451,87451,0
2021-08-11,1200203,202132,87452,87451,1
2021-08-11,1200302,202132,87453,87452,1
2021-08-11,1200328,202132,87453,87453,0
2021-08-11,1200385,202132,87453,87453,0
2021-08-11,1200351,202132,87457,87453,4
2021-08-11,1200807,202132,87458,87457,1
2021-08-11,1200252,202132,87458,87458,0
2021-08-11,1200427,202132,87475,87458,17
2021-08-11,1200708,202132,87475,87475,0
2021-08-11,1200609,202132,87474,87475,-1
2021-08-11,1200336,202132,87476,87474,2
2021-08-11,1200500,202132,87478,87476,2
2021-08-11,1200435,202132,87478,87478,0
2021-08-11,1200401,202132,87483,87478,5
2021-08-11,1200393,202132,87483,87483,0
2021-08-11,1200450,202132,87483,87483,0
2021-08-12,1200054,202132,87483,87483,0
2021-08-12,1200807,202132,87483,87483,0
2021-08-12,1200708,202132,87483,87483,0
2021-08-12,1200609,202132,87483,87483,0
2021-08-12,1200450,202132,87483,87483,0
2021-08-12,1200500,202132,87483,87483,0
2021-08-12,1200435,202132,87483,87483,0
2021-08-12,1200427,202132,87483,87483,0
2021-08-12,1200401,202132,87486,87483,3
2021-08-12,1200393,202132,87486,87486,0
2021-08-12,1200336,202132,87487,87486,1
2021-08-12,1200179,202132,87487,87487,0
2021-08-12,1200351,202132,87488,87487,1
2021-08-12,1200344,202132,87488,87488,0
2021-08-12,1200328,202132,87488,87488,0
2021-08-12,1200302,202132,87488,87488,0
2021-08-12,1200203,202132,87488,87488,0
2021-08-12,1200252,202132,87491,87488,3
2021-08-12,1200138,202132,87491,87491,0
2021-08-12,1200104,202132,87491,87491,0
2021-08-12,1200013,202132,87491,87491,0
2021-08-12,1200385,202132,87491,87491,0
2021-08-13,1200401,202132,87493,87491,2
2021-08-13,1200807,202132,87493,87493,0
2021-08-13,1200328,202132,87493,87493,0
2021-08-13,1200344,202132,87493,87493,0
2021-08-13,1200351,202132,87493,87493,0
2021-08-13,1200336,202132,87493,87493,0
2021-08-13,1200385,202132,87493,87493,0
2021-08-13,1200393,202132,87493,87493,0
2021-08-13,1200252,202132,87493,87493,0
2021-08-13,1200427,202132,87493,87493,0
2021-08-13,1200609,202132,87493,87493,0
2021-08-13,1200500,202132,87495,87493,2
2021-08-13,1200708,202132,87499,87495,4
2021-08-13,1200013,202132,87499,87499,0
2021-08-13,1200054,202132,87499,87499,0
2021-08-13,1200104,202132,87499,87499,0
2021-08-13,1200435,202132,87499,87499,0
2021-08-13,1200179,202132,87499,87499,0
2021-08-13,1200203,202132,87500,87499,1
2021-08-13,1200302,202132,87500,87500,0
2021-08-13,1200450,202132,87500,87500,0
2021-08-13,1200138,202132,87500,87500,0
2021-08-14,1200336,202132,87500,87500,0
2021-08-14,1200401,202132,87502,87500,2
2021-08-14,1200179,202132,87502,87502,0
2021-08-14,1200203,202132,87502,87502,0
2021-08-14,1200252,202132,87502,87502,0
2021-08-14,1200302,202132,87502,87502,0
2021-08-14,1200328,202132,87502,87502,0
2021-08-14,1200344,202132,87502,87502,0
2021-08-14,1200351,202132,87502,87502,0
2021-08-14,1200385,202132,87502,87502,0
2021-08-14,1200393,202132,87502,87502,0
2021-08-14,1200708,202132,87502,87502,0
2021-08-14,1200013,202132,87502,87502,0
2021-08-14,1200054,202132,87502,87502,0
2021-08-14,1200104,202132,87502,87502,0
2021-08-14,1200435,202132,87502,87502,0
2021-08-14,1200807,202132,87502,87502,0
2021-08-14,1200138,202132,87502,87502,0
2021-08-14,1200500,202132,87502,87502,0
2021-08-14,1200450,202132,87502,87502,0
2021-08-14,1200609,202132,87502,87502,0
2021-08-14,1200427,202132,87502,87502,0
2021-08-15,1200344,202133,87502,87502,0
2021-08-15,1200401,202133,87503,87502,1
2021-08-15,1200435,202133,87503,87503,0
2021-08-15,1200708,202133,87503,87503,0
2021-08-15,1200427,202133,87503,87503,0
2021-08-15,1200609,202133,87503,87503,0
2021-08-15,1200500,202133,87503,87503,0
2021-08-15,1200336,202133,87503,87503,0
2021-08-15,1200351,202133,87503,87503,0
2021-08-15,1200013,202133,87503,87503,0
2021-08-15,1200450,202133,87503,87503,0
2021-08-15,1200328,202133,87503,87503,0
2021-08-15,1200252,202133,87503,87503,0
2021-08-15,1200203,202133,87504,87503,1
2021-08-15,1200179,202133,87504,87504,0
2021-08-15,1200138,202133,87504,87504,0
2021-08-15,1200807,202133,87504,87504,0
2021-08-15,1200104,202133,87504,87504,0
2021-08-15,1200054,202133,87504,87504,0
2021-08-15,1200393,202133,87504,87504,0
2021-08-15,1200385,202133,87504,87504,0
2021-08-15,1200302,202133,87504,87504,0
2021-08-16,1200401,202133,87506,87504,2
2021-08-16,1200427,202133,87506,87506,0
2021-08-16,1200435,202133,87506,87506,0
2021-08-16,1200500,202133,87506,87506,0
2021-08-16,1200344,202133,87506,87506,0
2021-08-16,1200609,202133,87506,87506,0
2021-08-16,1200708,202133,87506,87506,0
2021-08-16,1200351,202133,87506,87506,0
2021-08-16,1200393,202133,87506,87506,0
2021-08-16,1200450,202133,87506,87506,0
2021-08-16,1200807,202133,87506,87506,0
2021-08-16,1200385,202133,87506,87506,0
2021-08-16,1200336,202133,87506,87506,0
2021-08-16,1200054,202133,87506,87506,0
2021-08-16,1200104,202133,87506,87506,0
2021-08-16,1200138,202133,87506,87506,0
2021-08-16,1200179,202133,87506,87506,0
2021-08-16,1200013,202133,87506,87506,0
2021-08-16,1200252,202133,87506,87506,0
2021-08-16,1200328,202133,87506,87506,0
2021-08-16,1200302,202133,87506,87506,0
2021-08-16,1200203,202133,87507,87506,1
2021-08-17,1200385,202133,87508,87507,1
2021-08-17,1200609,202133,87516,87508,8
2021-08-17,1200336,202133,87521,87516,5
2021-08-17,1200203,202133,87530,87521,9
2021-08-17,1200252,202133,87536,87530,6
2021-08-17,1200302,202133,87538,87536,2
2021-08-17,1200328,202133,87538,87538,0
2021-08-17,1200344,202133,87538,87538,0
2021-08-17,1200351,202133,87568,87538,30
2021-08-17,1200450,202133,87569,87568,1
2021-08-17,1200708,202133,87569,87569,0
2021-08-17,1200179,202133,87569,87569,0
2021-08-17,1200401,202133,87580,87569,11
2021-08-17,1200427,202133,87588,87580,8
2021-08-17,1200435,202133,87588,87588,0
2021-08-17,1200500,202133,87593,87588,5
2021-08-17,1200807,202133,87593,87593,0
2021-08-17,1200054,202133,87607,87593,14
2021-08-17,1200013,202133,87615,87607,8
2021-08-17,1200104,202133,87617,87615,2
2021-08-17,1200138,202133,87617,87617,0
2021-08-17,1200393,202133,87617,87617,0
2021-08-18,1200344,202133,87617,87617,0
2021-08-18,1200328,202133,87617,87617,0
2021-08-18,1200302,202133,87618,87617,1
2021-08-18,1200252,202133,87619,87618,1
2021-08-18,1200336,202133,87620,87619,1
2021-08-18,1200179,202133,87620,87620,0
2021-08-18,1200138,202133,87620,87620,0
2021-08-18,1200351,202133,87620,87620,0
2021-08-18,1200500,202133,87620,87620,0
2021-08-18,1200203,202133,87621,87620,1
2021-08-18,1200054,202133,87621,87621,0
2021-08-18,1200427,202133,87621,87621,0
2021-08-18,1200807,202133,87621,87621,0
2021-08-18,1200708,202133,87621,87621,0
2021-08-18,1200609,202133,87621,87621,0
2021-08-18,1200450,202133,87621,87621,0
2021-08-18,1200393,202133,87621,87621,0
2021-08-18,1200435,202133,87621,87621,0
2021-08-18,1200104,202133,87621,87621,0
2021-08-18,1200013,202133,87621,87621,0
2021-08-18,1200401,202133,87622,87621,1
2021-08-18,1200385,202133,87622,87622,0
2021-08-19,1200302,202133,87624,87622,2
2021-08-19,1200252,202133,87625,87624,1
2021-08-19,1200203,202133,87633,87625,8
2021-08-19,1200179,202133,87633,87633,0
2021-08-19,1200344,202133,87633,87633,0
2021-08-19,1200104,202133,87633,87633,0
2021-08-19,1200054,202133,87633,87633,0
2021-08-19,1200013,202133,87631,87633,-2
2021-08-19,1200328,202133,87631,87631,0
2021-08-19,1200138,202133,87631,87631,0
2021-08-19,1200336,202133,87634,87631,3
2021-08-19,1200385,202133,87634,87634,0
2021-08-19,1200807,202133,87634,87634,0
2021-08-19,1200401,202133,87641,87634,7
2021-08-19,1200708,202133,87644,87641,3
2021-08-19,1200609,202133,87645,87644,1
2021-08-19,1200450,202133,87645,87645,0
2021-08-19,1200351,202133,87645,87645,0
2021-08-19,1200435,202133,87645,87645,0
2021-08-19,1200427,202133,87649,87645,4
2021-08-19,1200393,202133,87651,87649,2
2021-08-19,1200500,202133,87653,87651,2
2021-08-20,1200302,202133,87653,87653,0
2021-08-20,1200609,202133,87651,87653,-2
2021-08-20,1200450,202133,87651,87651,0
2021-08-20,1200500,202133,87657,87651,6
2021-08-20,1200435,202133,87657,87657,0
2021-08-20,1200427,202133,87668,87657,11
2021-08-20,1200401,202133,87670,87668,2
2021-08-20,1200393,202133,87669,87670,-1
2021-08-20,1200807,202133,87669,87669,0
2021-08-20,1200708,202133,87669,87669,0
2021-08-20,1200351,202133,87678,87669,9
2021-08-20,1200138,202133,87678,87678,0
2021-08-20,1200344,202133,87678,87678,0
2021-08-20,1200013,202133,87678,87678,0
2021-08-20,1200054,202133,87678,87678,0
2021-08-20,1200104,202133,87680,87678,2
2021-08-20,1200385,202133,87680,87680,0
2021-08-20,1200179,202133,87680,87680,0
2021-08-20,1200252,202133,87681,87680,1
2021-08-20,1200328,202133,87681,87681,0
2021-08-20,1200203,202133,87686,87681,5
2021-08-20,1200336,202133,87686,87686,0
2021-08-21,1200807,202133,87686,87686,0
2021-08-21,1200393,202133,87686,87686,0
2021-08-21,1200401,202133,87691,87686,5
2021-08-21,1200427,202133,87692,87691,1
2021-08-21,1200385,202133,87692,87692,0
2021-08-21,1200500,202133,87692,87692,0
2021-08-21,1200450,202133,87692,87692,0
2021-08-21,1200708,202133,87692,87692,0
2021-08-21,1200203,202133,87692,87692,0
2021-08-21,1200435,202133,87692,87692,0
2021-08-21,1200336,202133,87692,87692,0
2021-08-21,1200013,202133,87692,87692,0
2021-08-21,1200344,202133,87692,87692,0
2021-08-21,1200054,202133,87692,87692,0
2021-08-21,1200104,202133,87693,87692,1
2021-08-21,1200138,202133,87693,87693,0
2021-08-21,1200179,202133,87693,87693,0
2021-08-21,1200351,202133,87693,87693,0
2021-08-21,1200252,202133,87693,87693,0
2021-08-21,1200302,202133,87693,87693,0
2021-08-21,1200328,202133,87693,87693,0
2021-08-21,1200609,202133,87693,87693,0
2021-08-22,1200351,202134,87693,87693,0
2021-08-22,1200013,202134,87693,87693,0
2021-08-22,1200054,202134,87693,87693,0
2021-08-22,1200104,202134,87693,87693,0
2021-08-22,1200138,202134,87693,87693,0
2021-08-22,1200179,202134,87693,87693,0
2021-08-22,1200203,202134,87693,87693,0
2021-08-22,1200302,202134,87693,87693,0
2021-08-22,1200344,202134,87693,87693,0
2021-08-22,1200385,202134,87693,87693,0
2021-08-22,1200328,202134,87693,87693,0
2021-08-22,1200807,202134,87693,87693,0
2021-08-22,1200252,202134,87693,87693,0
2021-08-22,1200427,202134,87693,87693,0
2021-08-22,1200708,202134,87693,87693,0
2021-08-22,1200609,202134,87694,87693,1
2021-08-22,1200336,202134,87694,87694,0
2021-08-22,1200500,202134,87694,87694,0
2021-08-22,1200435,202134,87694,87694,0
2021-08-22,1200401,202134,87695,87694,1
2021-08-22,1200393,202134,87695,87695,0
2021-08-22,1200450,202134,87695,87695,0
2021-08-23,1200054,202134,87695,87695,0
2021-08-23,1200609,202134,87695,87695,0
2021-08-23,1200450,202134,87695,87695,0
2021-08-23,1200500,202134,87695,87695,0
2021-08-23,1200435,202134,87695,87695,0
2021-08-23,1200427,202134,87695,87695,0
2021-08-23,1200401,202134,87695,87695,0
2021-08-23,1200393,202134,87695,87695,0
2021-08-23,1200807,202134,87695,87695,0
2021-08-23,1200708,202134,87695,87695,0
2021-08-23,1200336,202134,87695,87695,0
2021-08-23,1200351,202134,87695,87695,0
2021-08-23,1200252,202134,87695,87695,0
2021-08-23,1200344,202134,87695,87695,0
2021-08-23,1200328,202134,87695,87695,0
2021-08-23,1200302,202134,87695,87695,0
2021-08-23,1200179,202134,87695,87695,0
2021-08-23,1200385,202134,87695,87695,0
2021-08-23,1200138,202134,87695,87695,0
2021-08-23,1200104,202134,87696,87695,1
2021-08-23,1200013,202134,87696,87696,0
2021-08-23,1200203,202134,87697,87696,1
2021-08-24,1200427,202134,87701,87697,4
2021-08-24,1200302,202134,87701,87701,0
2021-08-24,1200328,202134,87701,87701,0
2021-08-24,1200344,202134,87701,87701,0
2021-08-24,1200351,202134,87710,87701,9
2021-08-24,1200336,202134,87718,87710,8
2021-08-24,1200609,202134,87718,87718,0
2021-08-24,1200252,202134,87722,87718,4
2021-08-24,1200393,202134,87723,87722,1
2021-08-24,1200401,202134,87725,87723,2
2021-08-24,1200385,202134,87726,87725,1
2021-08-24,1200435,202134,87726,87726,0
2021-08-24,1200450,202134,87728,87726,2
2021-08-24,1200807,202134,87728,87728,0
2021-08-24,1200203,202134,87736,87728,8
2021-08-24,1200179,202134,87736,87736,0
2021-08-24,1200138,202134,87736,87736,0
2021-08-24,1200104,202134,87736,87736,0
2021-08-24,1200054,202134,87736,87736,0
2021-08-24,1200013,202134,87737,87736,1
2021-08-24,1200708,202134,87738,87737,1
2021-08-24,1200500,202134,87739,87738,1
2021-08-25,1200351,202134,87736,87739,-3
2021-08-25,1200344,202134,87736,87736,0
2021-08-25,1200328,202134,87735,87736,-1
2021-08-25,1200302,202134,87735,87735,0
2021-08-25,1200609,202134,87746,87735,11
2021-08-25,1200203,202134,87744,87746,-2
2021-08-25,1200179,202134,87744,87744,0
2021-08-25,1200138,202134,87744,87744,0
2021-08-25,1200336,202134,87744,87744,0
2021-08-25,1200252,202134,87741,87744,-3
2021-08-25,1200807,202134,87741,87741,0
2021-08-25,1200427,202134,87741,87741,0
2021-08-25,1200393,202134,87741,87741,0
2021-08-25,1200013,202134,87744,87741,3
2021-08-25,1200104,202134,87746,87744,2
2021-08-25,1200708,202134,87746,87746,0
2021-08-25,1200450,202134,87747,87746,1
2021-08-25,1200054,202134,87742,87747,-5
2021-08-25,1200435,202134,87742,87742,0
2021-08-25,1200385,202134,87741,87742,-1
2021-08-25,1200401,202134,87744,87741,3
2021-08-25,1200500,202134,87744,87744,0
2021-08-26,1200328,202134,87744,87744,0
2021-08-26,1200435,202134,87744,87744,0
2021-08-26,1200013,202134,87744,87744,0
2021-08-26,1200104,202134,87744,87744,0
2021-08-26,1200138,202134,87744,87744,0
2021-08-26,1200179,202134,87744,87744,0
2021-08-26,1200203,202134,87747,87744,3
2021-08-26,1200252,202134,87747,87747,0
2021-08-26,1200302,202134,87748,87747,1
2021-08-26,1200344,202134,87748,87748,0
2021-08-26,1200351,202134,87748,87748,0
2021-08-26,1200807,202134,87748,87748,0
2021-08-26,1200708,202134,87750,87748,2
2021-08-26,1200609,202134,87767,87750,17
2021-08-26,1200450,202134,87767,87767,0
2021-08-26,1200500,202134,87767,87767,0
2021-08-26,1200385,202134,87767,87767,0
2021-08-26,1200427,202134,87767,87767,0
2021-08-26,1200401,202134,87768,87767,1
2021-08-26,1200054,202134,87772,87768,4
2021-08-26,1200393,202134,87773,87772,1
2021-08-26,1200336,202134,87776,87773,3
2021-08-27,1200252,202134,87776,87776,0
2021-08-27,1200203,202134,87782,87776,6
2021-08-27,1200179,202134,87782,87782,0
2021-08-27,1200138,202134,87782,87782,0
2021-08-27,1200302,202134,87782,87782,0
2021-08-27,1200054,202134,87782,87782,0
2021-08-27,1200450,202134,87784,87782,2
2021-08-27,1200609,202134,87786,87784,2
2021-08-27,1200013,202134,87789,87786,3
2021-08-27,1200104,202134,87800,87789,11
2021-08-27,1200328,202134,87800,87800,0
2021-08-27,1200435,202134,87800,87800,0
2021-08-27,1200351,202134,87805,87800,5
2021-08-27,1200336,202134,87806,87805,1
2021-08-27,1200385,202134,87806,87806,0
2021-08-27,1200807,202134,87806,87806,0
2021-08-27,1200393,202134,87809,87806,3
2021-08-27,1200401,202134,87812,87809,3
2021-08-27,1200427,202134,87812,87812,0
2021-08-27,1200500,202134,87813,87812,1
2021-08-27,1200708,202134,87813,87813,0
2021-08-27,1200344,202134,87813,87813,0
2021-08-28,1200302,202134,87813,87813,0
2021-08-28,1200252,202134,87813,87813,0
2021-08-28,1200203,202134,87816,87813,3
2021-08-28,1200179,202134,87816,87816,0
2021-08-28,1200385,202134,87816,87816,0
2021-08-28,1200104,202134,87816,87816,0
2021-08-28,1200054,202134,87816,87816,0
2021-08-28,1200013,202134,87816,87816,0
2021-08-28,1200328,202134,87816,87816,0
2021-08-28,1200138,202134,87816,87816,0
2021-08-28,1200344,202134,87816,87816,0
2021-08-28,1200336,202134,87816,87816,0
2021-08-28,1200708,202134,87816,87816,0
2021-08-28,1200807,202134,87816,87816,0
2021-08-28,1200393,202134,87816,87816,0
2021-08-28,1200401,202134,87817,87816,1
2021-08-28,1200427,202134,87817,87817,0
2021-08-28,1200351,202134,87817,87817,0
2021-08-28,1200500,202134,87817,87817,0
2021-08-28,1200450,202134,87817,87817,0
2021-08-28,1200609,202134,87817,87817,0
2021-08-28,1200435,202134,87817,87817,0
2021-08-29,1200328,202135,87817,87817,0
2021-08-29,1200013,202135,87817,87817,0
2021-08-29,1200054,202135,87817,87817,0
2021-08-29,1200104,202135,87817,87817,0
2021-08-29,1200138,202135,87817,87817,0
2021-08-29,1200179,202135,87817,87817,0
2021-08-29,1200203,202135,87817,87817,0
2021-08-29,1200252,202135,87817,87817,0
2021-08-29,1200302,202135,87817,87817,0
2021-08-29,1200344,202135,87817,87817,0
2021-08-29,1200385,202135,87817,87817,0
2021-08-29,1200807,202135,87817,87817,0
2021-08-29,1200393,202135,87817,87817,0
2021-08-29,1200401,202135,87818,87817,1
2021-08-29,1200435,202135,87818,87818,0
2021-08-29,1200500,202135,87818,87818,0
2021-08-29,1200450,202135,87818,87818,0
2021-08-29,1200609,202135,87818,87818,0
2021-08-29,1200708,202135,87818,87818,0
2021-08-29,1200427,202135,87818,87818,0
2021-08-29,1200336,202135,87818,87818,0
2021-08-29,1200351,202135,87818,87818,0
2021-08-30,1200393,202135,87818,87818,0
2021-08-30,1200401,202135,87819,87818,1
2021-08-30,1200427,202135,87819,87819,0
2021-08-30,1200435,202135,87819,87819,0
2021-08-30,1200252,202135,87819,87819,0
2021-08-30,1200450,202135,87819,87819,0
2021-08-30,1200609,202135,87819,87819,0
2021-08-30,1200708,202135,87819,87819,0
2021-08-30,1200807,202135,87819,87819,0
2021-08-30,1200500,202135,87819,87819,0
2021-08-30,1200336,202135,87819,87819,0
2021-08-30,1200203,202135,87819,87819,0
2021-08-30,1200351,202135,87819,87819,0
2021-08-30,1200344,202135,87819,87819,0
2021-08-30,1200328,202135,87819,87819,0
2021-08-30,1200302,202135,87819,87819,0
2021-08-30,1200179,202135,87819,87819,0
2021-08-30,1200138,202135,87819,87819,0
2021-08-30,1200104,202135,87819,87819,0
2021-08-30,1200054,202135,87819,87819,0
2021-08-30,1200013,202135,87819,87819,0
2021-08-30,1200385,202135,87819,87819,0
2021-08-31,1200609,202135,87816,87819,-3
2021-08-31,1200807,202135,87816,87816,0
2021-08-31,1200328,202135,87816,87816,0
2021-08-31,1200344,202135,87816,87816,0
2021-08-31,1200351,202135,87817,87816,1
2021-08-31,1200336,202135,87821,87817,4
2021-08-31,1200385,202135,87821,87821,0
2021-08-31,1200393,202135,87821,87821,0
2021-08-31,1200401,202135,87823,87821,2
2021-08-31,1200427,202135,87827,87823,4
2021-08-31,1200252,202135,87827,87827,0
2021-08-31,1200500,202135,87827,87827,0
2021-08-31,1200708,202135,87827,87827,0
2021-08-31,1200013,202135,87824,87827,-3
2021-08-31,1200054,202135,87833,87824,9
2021-08-31,1200104,202135,87831,87833,-2
2021-08-31,1200435,202135,87832,87831,1
2021-08-31,1200179,202135,87832,87832,0
2021-08-31,1200203,202135,87838,87832,6
2021-08-31,1200302,202135,87838,87838,0
2021-08-31,1200450,202135,87838,87838,0
2021-08-31,1200138,202135,87838,87838,0
2021-09-01,1200393,202135,87838,87838,0
2021-09-01,1200708,202135,87838,87838,0
2021-09-01,1200609,202135,87838,87838,0
2021-09-01,1200450,202135,87838,87838,0
2021-09-01,1200203,202135,87841,87838,3
2021-09-01,1200500,202135,87841,87841,0
2021-09-01,1200435,202135,87841,87841,0
2021-09-01,1200427,202135,87841,87841,0
2021-09-01,1200401,202135,87843,87841,2
2021-09-01,1200138,202135,87843,87843,0
2021-09-01,1200807,202135,87843,87843,0
2021-09-01,1200336,202135,87843,87843,0
2021-09-01,1200013,202135,87843,87843,0
2021-09-01,1200054,202135,87843,87843,0
2021-09-01,1200104,202135,87843,87843,0
2021-09-01,1200179,202135,87843,87843,0
2021-09-01,1200385,202135,87843,87843,0
2021-09-01,1200302,202135,87843,87843,0
2021-09-01,1200328,202135,87843,87843,0
2021-09-01,1200344,202135,87843,87843,0
2021-09-01,1200351,202135,87845,87843,2
2021-09-01,1200252,202135,87846,87845,1
2021-09-02,1200385,202135,87846,87846,0
2021-09-02,1200708,202135,87846,87846,0
2021-09-02,1200609,202135,87845,87846,-1
2021-09-02,1200450,202135,87845,87845,0
2021-09-02,1200500,202135,87845,87845,0
2021-09-02,1200435,202135,87845,87845,0
2021-09-02,1200427,202135,87845,87845,0
2021-09-02,1200401,202135,87849,87845,4
2021-09-02,1200807,202135,87849,87849,0
2021-09-02,1200393,202135,87849,87849,0
2021-09-02,1200336,202135,87850,87849,1
2021-09-02,1200351,202135,87850,87850,0
2021-09-02,1200328,202135,87850,87850,0
2021-09-02,1200302,202135,87850,87850,0
2021-09-02,1200252,202135,87850,87850,0
2021-09-02,1200203,202135,87850,87850,0
2021-09-02,1200179,202135,87850,87850,0
2021-09-02,1200138,202135,87850,87850,0
2021-09-02,1200104,202135,87850,87850,0
2021-09-02,1200054,202135,87850,87850,0
2021-09-02,1200013,202135,87850,87850,0
2021-09-02,1200344,202135,87850,87850,0
2021-09-03,1200393,202135,87850,87850,0
2021-09-03,1200252,202135,87857,87850,7
2021-09-03,1200401,202135,87859,87857,2
2021-09-03,1200427,202135,87859,87859,0
2021-09-03,1200302,202135,87859,87859,0
2021-09-03,1200500,202135,87859,87859,0
2021-09-03,1200450,202135,87859,87859,0
2021-09-03,1200609,202135,87859,87859,0
2021-09-03,1200807,202135,87859,87859,0
2021-09-03,1200435,202135,87859,87859,0
2021-09-03,1200385,202135,87860,87859,1
2021-09-03,1200328,202135,87860,87860,0
2021-09-03,1200351,202135,87862,87860,2
2021-09-03,1200013,202135,87862,87862,0
2021-09-03,1200054,202135,87864,87862,2
2021-09-03,1200104,202135,87865,87864,1
2021-09-03,1200138,202135,87865,87865,0
2021-09-03,1200336,202135,87865,87865,0
2021-09-03,1200203,202135,87870,87865,5
2021-09-03,1200708,202135,87870,87870,0
2021-09-03,1200344,202135,87870,87870,0
2021-09-03,1200179,202135,87870,87870,0
2021-09-04,1200302,202135,87870,87870,0
2021-09-04,1200344,202135,87870,87870,0
2021-09-04,1200013,202135,87870,87870,0
2021-09-04,1200054,202135,87874,87870,4
2021-09-04,1200104,202135,87878,87874,4
2021-09-04,1200138,202135,87878,87878,0
2021-09-04,1200179,202135,87878,87878,0
2021-09-04,1200203,202135,87879,87878,1
2021-09-04,1200252,202135,87887,87879,8
2021-09-04,1200328,202135,87887,87887,0
2021-09-04,1200336,202135,87887,87887,0
2021-09-04,1200435,202135,87887,87887,0
2021-09-04,1200385,202135,87887,87887,0
2021-09-04,1200807,202135,87887,87887,0
2021-09-04,1200401,202135,87888,87887,1
2021-09-04,1200427,202135,87888,87888,0
2021-09-04,1200500,202135,87888,87888,0
2021-09-04,1200450,202135,87888,87888,0
2021-09-04,1200609,202135,87889,87888,1
2021-09-04,1200708,202135,87889,87889,0
2021-09-04,1200393,202135,87889,87889,0
2021-09-04,1200351,202135,87890,87889,1
2021-09-05,1200807,202136,87890,87890,0
2021-09-05,1200393,202136,87890,87890,0
2021-09-05,1200401,202136,87890,87890,0
2021-09-05,1200427,202136,87890,87890,0
2021-09-05,1200385,202136,87890,87890,0
2021-09-05,1200500,202136,87890,87890,0
2021-09-05,1200450,202136,87890,87890,0
2021-09-05,1200609,202136,87890,87890,0
2021-09-05,1200708,202136,87890,87890,0
2021-09-05,1200435,202136,87890,87890,0
2021-09-05,1200344,202136,87890,87890,0
2021-09-05,1200336,202136,87890,87890,0
2021-09-05,1200138,202136,87890,87890,0
2021-09-05,1200328,202136,87890,87890,0
2021-09-05,1200013,202136,87890,87890,0
2021-09-05,1200054,202136,87890,87890,0
2021-09-05,1200104,202136,87890,87890,0
2021-09-05,1200351,202136,87890,87890,0
2021-09-05,1200179,202136,87890,87890,0
2021-09-05,1200252,202136,87890,87890,0
2021-09-05,1200302,202136,87890,87890,0
2021-09-05,1200203,202136,87890,87890,0
2021-09-06,1200807,202136,87890,87890,0
2021-09-06,1200393,202136,87890,87890,0
2021-09-06,1200401,202136,87892,87890,2
2021-09-06,1200427,202136,87892,87892,0
2021-09-06,1200203,202136,87892,87892,0
2021-09-06,1200500,202136,87892,87892,0
2021-09-06,1200450,202136,87892,87892,0
2021-09-06,1200708,202136,87892,87892,0
2021-09-06,1200385,202136,87892,87892,0
2021-09-06,1200435,202136,87892,87892,0
2021-09-06,1200336,202136,87892,87892,0
2021-09-06,1200351,202136,87892,87892,0
2021-09-06,1200344,202136,87892,87892,0
2021-09-06,1200054,202136,87892,87892,0
2021-09-06,1200104,202136,87892,87892,0
2021-09-06,1200138,202136,87892,87892,0
2021-09-06,1200179,202136,87892,87892,0
2021-09-06,1200013,202136,87892,87892,0
2021-09-06,1200252,202136,87892,87892,0
2021-09-06,1200302,202136,87892,87892,0
2021-09-06,1200328,202136,87892,87892,0
2021-09-06,1200609,202136,87892,87892,0
2021-09-07,1200328,202136,87892,87892,0
2021-09-07,1200013,202136,87892,87892,0
2021-09-07,1200054,202136,87892,87892,0
2021-09-07,1200344,202136,87892,87892,0
2021-09-07,1200138,202136,87892,87892,0
2021-09-07,1200179,202136,87892,87892,0
2021-09-07,1200203,202136,87907,87892,15
2021-09-07,1200252,202136,87907,87907,0
2021-09-07,1200302,202136,87907,87907,0
2021-09-07,1200385,202136,87907,87907,0
2021-09-07,1200104,202136,87907,87907,0
2021-09-07,1200807,202136,87907,87907,0
2021-09-07,1200336,202136,87912,87907,5
2021-09-07,1200427,202136,87912,87912,0
2021-09-07,1200708,202136,87912,87912,0
2021-09-07,1200609,202136,87912,87912,0
2021-09-07,1200351,202136,87912,87912,0
2021-09-07,1200500,202136,87913,87912,1
2021-09-07,1200435,202136,87913,87913,0
2021-09-07,1200401,202136,87914,87913,1
2021-09-07,1200393,202136,87914,87914,0
2021-09-07,1200450,202136,87914,87914,0
2021-09-08,1200252,202136,87914,87914,0
2021-09-08,1200708,202136,87914,87914,0
2021-09-08,1200609,202136,87914,87914,0
2021-09-08,1200450,202136,87914,87914,0
2021-09-08,1200500,202136,87914,87914,0
2021-09-08,1200435,202136,87914,87914,0
2021-09-08,1200427,202136,87914,87914,0
2021-09-08,1200401,202136,87914,87914,0
2021-09-08,1200393,202136,87914,87914,0
2021-09-08,1200807,202136,87914,87914,0
2021-09-08,1200336,202136,87915,87914,1
2021-09-08,1200138,202136,87915,87915,0
2021-09-08,1200351,202136,87915,87915,0
2021-09-08,1200344,202136,87915,87915,0
2021-09-08,1200328,202136,87915,87915,0
2021-09-08,1200302,202136,87915,87915,0
2021-09-08,1200179,202136,87915,87915,0
2021-09-08,1200203,202136,87915,87915,0
2021-09-08,1200104,202136,87915,87915,0
2021-09-08,1200054,202136,87915,87915,0
2021-09-08,1200013,202136,87915,87915,0
2021-09-08,1200385,202136,87915,87915,0
2021-09-09,1200401,202136,87915,87915,0
2021-09-09,1200302,202136,87915,87915,0
2021-09-09,1200328,202136,87915,87915,0
2021-09-09,1200385,202136,87915,87915,0
2021-09-09,1200351,202136,87915,87915,0
2021-09-09,1200336,202136,87915,87915,0
2021-09-09,1200609,202136,87915,87915,0
2021-09-09,1200252,202136,87915,87915,0
2021-09-09,1200393,202136,87915,87915,0
2021-09-09,1200427,202136,87915,87915,0
2021-09-09,1200344,202136,87915,87915,0
2021-09-09,1200500,202136,87915,87915,0
2021-09-09,1200450,202136,87915,87915,0
2021-09-09,1200807,202136,87915,87915,0
2021-09-09,1200203,202136,87918,87915,3
2021-09-09,1200179,202136,87918,87918,0
2021-09-09,1200138,202136,87918,87918,0
2021-09-09,1200104,202136,87918,87918,0
2021-09-09,1200054,202136,87918,87918,0
2021-09-09,1200013,202136,87918,87918,0
2021-09-09,1200708,202136,87918,87918,0
2021-09-09,1200435,202136,87918,87918,0
2021-09-10,1200351,202136,87918,87918,0
2021-09-10,1200344,202136,87918,87918,0
2021-09-10,1200328,202136,87918,87918,0
2021-09-10,1200302,202136,87918,87918,0
2021-09-10,1200609,202136,87918,87918,0
2021-09-10,1200179,202136,87920,87918,2
2021-09-10,1200138,202136,87920,87920,0
2021-09-10,1200336,202136,87920,87920,0
2021-09-10,1200252,202136,87920,87920,0
2021-09-10,1200385,202136,87920,87920,0
2021-09-10,1200203,202136,87921,87920,1
2021-09-10,1200393,202136,87921,87921,0
2021-09-10,1200401,202136,87922,87921,1
2021-09-10,1200427,202136,87922,87922,0
2021-09-10,1200435,202136,87922,87922,0
2021-09-10,1200500,202136,87922,87922,0
2021-09-10,1200450,202136,87922,87922,0
2021-09-10,1200708,202136,87922,87922,0
2021-09-10,1200104,202136,87922,87922,0
2021-09-10,1200013,202136,87922,87922,0
2021-09-10,1200054,202136,87922,87922,0
2021-09-10,1200807,202136,87922,87922,0
2021-09-11,1200328,202136,87922,87922,0
2021-09-11,1200302,202136,87922,87922,0
2021-09-11,1200252,202136,87922,87922,0
2021-09-11,1200203,202136,87922,87922,0
2021-09-11,1200435,202136,87922,87922,0
2021-09-11,1200138,202136,87922,87922,0
2021-09-11,1200104,202136,87922,87922,0
2021-09-11,1200013,202136,87922,87922,0
2021-09-11,1200344,202136,87922,87922,0
2021-09-11,1200179,202136,87922,87922,0
2021-09-11,1200351,202136,87922,87922,0
2021-09-11,1200450,202136,87922,87922,0
2021-09-11,1200708,202136,87922,87922,0
2021-09-11,1200609,202136,87922,87922,0
2021-09-11,1200500,202136,87922,87922,0
2021-09-11,1200385,202136,87922,87922,0
2021-09-11,1200427,202136,87922,87922,0
2021-09-11,1200401,202136,87922,87922,0
2021-09-11,1200054,202136,87922,87922,0
2021-09-11,1200393,202136,87922,87922,0
2021-09-11,1200807,202136,87922,87922,0
2021-09-11,1200336,202136,87922,87922,0
2021-09-12,1200179,202137,87922,87922,0
2021-09-12,1200252,202137,87922,87922,0
2021-09-12,1200203,202137,87922,87922,0
2021-09-12,1200013,202137,87922,87922,0
2021-09-12,1200302,202137,87922,87922,0
2021-09-12,1200104,202137,87922,87922,0
2021-09-12,1200054,202137,87922,87922,0
2021-09-12,1200450,202137,87922,87922,0
2021-09-12,1200609,202137,87922,87922,0
2021-09-12,1200138,202137,87922,87922,0
2021-09-12,1200328,202137,87922,87922,0
2021-09-12,1200393,202137,87922,87922,0
2021-09-12,1200351,202137,87922,87922,0
2021-09-12,1200435,202137,87922,87922,0
2021-09-12,1200708,202137,87922,87922,0
2021-09-12,1200500,202137,87922,87922,0
2021-09-12,1200427,202137,87922,87922,0
2021-09-12,1200344,202137,87922,87922,0
2021-09-12,1200807,202137,87922,87922,0
2021-09-12,1200385,202137,87922,87922,0
2021-09-12,1200336,202137,87922,87922,0
2021-09-12,1200401,202137,87926,87922,4
2021-09-13,1200302,202137,87926,87926,0
2021-09-13,1200385,202137,87926,87926,0
2021-09-13,1200013,202137,87926,87926,0
2021-09-13,1200054,202137,87926,87926,0
2021-09-13,1200104,202137,87926,87926,0
2021-09-13,1200138,202137,87926,87926,0
2021-09-13,1200179,202137,87926,87926,0
2021-09-13,1200203,202137,87927,87926,1
2021-09-13,1200252,202137,87927,87927,0
2021-09-13,1200328,202137,87927,87927,0
2021-09-13,1200344,202137,87927,87927,0
2021-09-13,1200336,202137,87927,87927,0
2021-09-13,1200708,202137,87927,87927,0
2021-09-13,1200609,202137,87927,87927,0
2021-09-13,1200450,202137,87927,87927,0
2021-09-13,1200500,202137,87927,87927,0
2021-09-13,1200435,202137,87927,87927,0
2021-09-13,1200427,202137,87927,87927,0
2021-09-13,1200401,202137,87929,87927,2
2021-09-13,1200393,202137,87929,87929,0
2021-09-13,1200807,202137,87929,87929,0
2021-09-13,1200351,202137,87929,87929,0
2021-09-14,1200302,202137,87929,87929,0
2021-09-14,1200252,202137,87929,87929,0
2021-09-14,1200203,202137,87929,87929,0
2021-09-14,1200179,202137,87929,87929,0
2021-09-14,1200328,202137,87929,87929,0
2021-09-14,1200104,202137,87929,87929,0
2021-09-14,1200054,202137,87929,87929,0
2021-09-14,1200013,202137,87929,87929,0
2021-09-14,1200344,202137,87929,87929,0
2021-09-14,1200138,202137,87929,87929,0
2021-09-14,1200385,202137,87929,87929,0
2021-09-14,1200336,202137,87929,87929,0
2021-09-14,1200807,202137,87929,87929,0
2021-09-14,1200393,202137,87929,87929,0
2021-09-14,1200401,202137,87929,87929,0
2021-09-14,1200435,202137,87929,87929,0
2021-09-14,1200500,202137,87929,87929,0
2021-09-14,1200450,202137,87929,87929,0
2021-09-14,1200609,202137,87929,87929,0
2021-09-14,1200708,202137,87929,87929,0
2021-09-14,1200427,202137,87929,87929,0
2021-09-14,1200351,202137,87929,87929,0
2021-09-15,1200393,202137,87929,87929,0
2021-09-15,1200401,202137,87930,87929,1
2021-09-15,1200427,202137,87930,87930,0
2021-09-15,1200435,202137,87930,87930,0
2021-09-15,1200807,202137,87930,87930,0
2021-09-15,1200450,202137,87930,87930,0
2021-09-15,1200609,202137,87930,87930,0
2021-09-15,1200708,202137,87930,87930,0
2021-09-15,1200252,202137,87930,87930,0
2021-09-15,1200500,202137,87930,87930,0
2021-09-15,1200336,202137,87930,87930,0
2021-09-15,1200203,202137,87931,87930,1
2021-09-15,1200351,202137,87931,87931,0
2021-09-15,1200344,202137,87931,87931,0
2021-09-15,1200328,202137,87931,87931,0
2021-09-15,1200302,202137,87931,87931,0
2021-09-15,1200179,202137,87931,87931,0
2021-09-15,1200138,202137,87931,87931,0
2021-09-15,1200104,202137,87931,87931,0
2021-09-15,1200054,202137,87931,87931,0
2021-09-15,1200013,202137,87931,87931,0
2021-09-15,1200385,202137,87931,87931,0
2021-09-16,1200401,202137,87934,87931,3
2021-09-16,1200807,202137,87934,87934,0
2021-09-16,1200328,202137,87934,87934,0
2021-09-16,1200344,202137,87934,87934,0
2021-09-16,1200351,202137,87934,87934,0
2021-09-16,1200336,202137,87933,87934,-1
2021-09-16,1200385,202137,87934,87933,1
2021-09-16,1200393,202137,87934,87934,0
2021-09-16,1200252,202137,87933,87934,-1
2021-09-16,1200609,202137,87933,87933,0
2021-09-16,1200427,202137,87933,87933,0
2021-09-16,1200500,202137,87933,87933,0
2021-09-16,1200450,202137,87932,87933,-1
2021-09-16,1200302,202137,87933,87932,1
2021-09-16,1200203,202137,87938,87933,5
2021-09-16,1200179,202137,87937,87938,-1
2021-09-16,1200138,202137,87937,87937,0
2021-09-16,1200104,202137,87937,87937,0
2021-09-16,1200054,202137,87937,87937,0
2021-09-16,1200013,202137,87937,87937,0
2021-09-16,1200708,202137,87939,87937,2
2021-09-16,1200435,202137,87939,87939,0
2021-09-17,1200351,202137,87939,87939,0
2021-09-17,1200344,202137,87939,87939,0
2021-09-17,1200328,202137,87939,87939,0
2021-09-17,1200302,202137,87939,87939,0
2021-09-17,1200336,202137,87939,87939,0
2021-09-17,1200203,202137,87939,87939,0
2021-09-17,1200179,202137,87939,87939,0
2021-09-17,1200401,202137,87940,87939,1
2021-09-17,1200393,202137,87940,87940,0
2021-09-17,1200252,202137,87940,87940,0
2021-09-17,1200385,202137,87940,87940,0
2021-09-17,1200013,202137,87940,87940,0
2021-09-17,1200708,202137,87940,87940,0
2021-09-17,1200054,202137,87940,87940,0
2021-09-17,1200104,202137,87940,87940,0
2021-09-17,1200435,202137,87940,87940,0
2021-09-17,1200427,202137,87940,87940,0
2021-09-17,1200807,202137,87940,87940,0
2021-09-17,1200500,202137,87940,87940,0
2021-09-17,1200450,202137,87940,87940,0
2021-09-17,1200609,202137,87940,87940,0
2021-09-17,1200138,202137,87940,87940,0
2021-09-18,1200435,202137,87940,87940,0
2021-09-18,1200401,202137,87944,87940,4
2021-09-18,1200708,202137,87944,87944,0
2021-09-18,1200609,202137,87944,87944,0
2021-09-18,1200450,202137,87944,87944,0
2021-09-18,1200500,202137,87944,87944,0
2021-09-18,1200427,202137,87944,87944,0
2021-09-18,1200336,202137,87944,87944,0
2021-09-18,1200013,202137,87944,87944,0
2021-09-18,1200344,202137,87944,87944,0
2021-09-18,1200351,202137,87944,87944,0
2021-09-18,1200302,202137,87944,87944,0
2021-09-18,1200385,202137,87944,87944,0
2021-09-18,1200393,202137,87944,87944,0
2021-09-18,1200054,202137,87944,87944,0
2021-09-18,1200104,202137,87944,87944,0
2021-09-18,1200328,202137,87944,87944,0
2021-09-18,1200138,202137,87944,87944,0
2021-09-18,1200179,202137,87945,87944,1
2021-09-18,1200203,202137,87945,87945,0
2021-09-18,1200252,202137,87945,87945,0
2021-09-18,1200807,202137,87945,87945,0
2021-09-19,1200807,202138,87945,87945,0
2021-09-19,1200708,202138,87945,87945,0
2021-09-19,1200609,202138,87945,87945,0
2021-09-19,1200450,202138,87945,87945,0
2021-09-19,1200500,202138,87945,87945,0
2021-09-19,1200435,202138,87945,87945,0
2021-09-19,1200427,202138,87945,87945,0
2021-09-19,1200401,202138,87947,87945,2
2021-09-19,1200393,202138,87947,87947,0
2021-09-19,1200344,202138,87947,87947,0
2021-09-19,1200385,202138,87947,87947,0
2021-09-19,1200351,202138,87947,87947,0
2021-09-19,1200013,202138,87947,87947,0
2021-09-19,1200054,202138,87947,87947,0
2021-09-19,1200104,202138,87947,87947,0
2021-09-19,1200138,202138,87947,87947,0
2021-09-19,1200336,202138,87947,87947,0
2021-09-19,1200203,202138,87947,87947,0
2021-09-19,1200252,202138,87947,87947,0
2021-09-19,1200328,202138,87947,87947,0
2021-09-19,1200302,202138,87947,87947,0
2021-09-19,1200179,202138,87947,87947,0
2021-09-20,1200393,202138,87947,87947,0
2021-09-20,1200203,202138,87947,87947,0
2021-09-20,1200252,202138,87947,87947,0
2021-09-20,1200302,202138,87947,87947,0
2021-09-20,1200328,202138,87947,87947,0
2021-09-20,1200344,202138,87947,87947,0
2021-09-20,1200351,202138,87947,87947,0
2021-09-20,1200336,202138,87947,87947,0
2021-09-20,1200385,202138,87947,87947,0
2021-09-20,1200807,202138,87947,87947,0
2021-09-20,1200500,202138,87947,87947,0
2021-09-20,1200401,202138,87947,87947,0
2021-09-20,1200435,202138,87947,87947,0
2021-09-20,1200708,202138,87947,87947,0
2021-09-20,1200609,202138,87947,87947,0
2021-09-20,1200450,202138,87947,87947,0
2021-09-20,1200054,202138,87947,87947,0
2021-09-20,1200013,202138,87947,87947,0
2021-09-20,1200138,202138,87947,87947,0
2021-09-20,1200179,202138,87947,87947,0
2021-09-20,1200104,202138,87947,87947,0
2021-09-20,1200427,202138,87947,87947,0
2021-09-21,1200336,202138,87947,87947,0
2021-09-21,1200013,202138,87947,87947,0
2021-09-21,1200385,202138,87947,87947,0
2021-09-21,1200807,202138,87947,87947,0
2021-09-21,1200708,202138,87947,87947,0
2021-09-21,1200500,202138,87947,87947,0
2021-09-21,1200450,202138,87947,87947,0
2021-09-21,1200609,202138,87947,87947,0
2021-09-21,1200351,202138,87947,87947,0
2021-09-21,1200435,202138,87947,87947,0
2021-09-21,1200344,202138,87947,87947,0
2021-09-21,1200328,202138,87947,87947,0
2021-09-21,1200302,202138,87947,87947,0
2021-09-21,1200427,202138,87947,87947,0
2021-09-21,1200054,202138,87947,87947,0
2021-09-21,1200104,202138,87947,87947,0
2021-09-21,1200138,202138,87947,87947,0
2021-09-21,1200393,202138,87947,87947,0
2021-09-21,1200203,202138,87947,87947,0
2021-09-21,1200401,202138,87947,87947,0
2021-09-21,1200252,202138,87947,87947,0
2021-09-21,1200179,202138,87947,87947,0
2021-09-22,1200252,202138,87947,87947,0
2021-09-22,1200401,202138,87947,87947,0
2021-09-22,1200344,202138,87947,87947,0
2021-09-22,1200013,202138,87947,87947,0
2021-09-22,1200054,202138,87947,87947,0
2021-09-22,1200104,202138,87947,87947,0
2021-09-22,1200138,202138,87947,87947,0
2021-09-22,1200179,202138,87947,87947,0
2021-09-22,1200203,202138,87947,87947,0
2021-09-22,1200427,202138,87947,87947,0
2021-09-22,1200328,202138,87947,87947,0
2021-09-22,1200435,202138,87947,87947,0
2021-09-22,1200351,202138,87947,87947,0
2021-09-22,1200336,202138,87947,87947,0
2021-09-22,1200385,202138,87947,87947,0
2021-09-22,1200807,202138,87947,87947,0
2021-09-22,1200708,202138,87947,87947,0
2021-09-22,1200609,202138,87947,87947,0
2021-09-22,1200450,202138,87947,87947,0
2021-09-22,1200500,202138,87947,87947,0
2021-09-22,1200393,202138,87947,87947,0
2021-09-22,1200302,202138,87947,87947,0
2021-09-23,1200500,202138,87947,87947,0
2021-09-23,1200450,202138,87947,87947,0
2021-09-23,1200609,202138,87947,87947,0
2021-09-23,1200708,202138,87947,87947,0
2021-09-23,1200435,202138,87947,87947,0
2021-09-23,1200104,202138,87947,87947,0
2021-09-23,1200054,202138,87947,87947,0
2021-09-23,1200427,202138,87947,87947,0
2021-09-23,1200807,202138,87947,87947,0
2021-09-23,1200138,202138,87947,87947,0
2021-09-23,1200401,202138,87949,87947,2
2021-09-23,1200203,202138,87949,87949,0
2021-09-23,1200393,202138,87949,87949,0
2021-09-23,1200179,202138,87949,87949,0
2021-09-23,1200385,202138,87949,87949,0
2021-09-23,1200336,202138,87949,87949,0
2021-09-23,1200351,202138,87949,87949,0
2021-09-23,1200344,202138,87949,87949,0
2021-09-23,1200328,202138,87949,87949,0
2021-09-23,1200302,202138,87949,87949,0
2021-09-23,1200013,202138,87949,87949,0
2021-09-23,1200252,202138,87949,87949,0
2021-09-24,1200328,202138,87949,87949,0
2021-09-24,1200252,202138,87949,87949,0
2021-09-24,1200203,202138,87949,87949,0
2021-09-24,1200179,202138,87949,87949,0
2021-09-24,1200351,202138,87949,87949,0
2021-09-24,1200104,202138,87950,87949,1
2021-09-24,1200054,202138,87950,87950,0
2021-09-24,1200013,202138,87950,87950,0
2021-09-24,1200344,202138,87950,87950,0
2021-09-24,1200138,202138,87950,87950,0
2021-09-24,1200385,202138,87950,87950,0
2021-09-24,1200336,202138,87950,87950,0
2021-09-24,1200807,202138,87950,87950,0
2021-09-24,1200401,202138,87952,87950,2
2021-09-24,1200708,202138,87952,87952,0
2021-09-24,1200609,202138,87952,87952,0
2021-09-24,1200450,202138,87952,87952,0
2021-09-24,1200302,202138,87952,87952,0
2021-09-24,1200435,202138,87952,87952,0
2021-09-24,1200427,202138,87952,87952,0
2021-09-24,1200393,202138,87952,87952,0
2021-09-24,1200500,202138,87952,87952,0
2021-09-25,1200104,202138,87952,87952,0
2021-09-25,1200609,202138,87952,87952,0
2021-09-25,1200450,202138,87952,87952,0
2021-09-25,1200500,202138,87952,87952,0
2021-09-25,1200435,202138,87952,87952,0
2021-09-25,1200427,202138,87952,87952,0
2021-09-25,1200401,202138,87953,87952,1
2021-09-25,1200393,202138,87953,87953,0
2021-09-25,1200807,202138,87953,87953,0
2021-09-25,1200351,202138,87953,87953,0
2021-09-25,1200708,202138,87953,87953,0
2021-09-25,1200179,202138,87953,87953,0
2021-09-25,1200252,202138,87953,87953,0
2021-09-25,1200328,202138,87953,87953,0
2021-09-25,1200302,202138,87953,87953,0
2021-09-25,1200203,202138,87953,87953,0
2021-09-25,1200336,202138,87953,87953,0
2021-09-25,1200138,202138,87953,87953,0
2021-09-25,1200054,202138,87953,87953,0
2021-09-25,1200013,202138,87953,87953,0
2021-09-25,1200344,202138,87953,87953,0
2021-09-25,1200385,202138,87953,87953,0
2021-09-26,1200385,202139,87953,87953,0
2021-09-26,1200203,202139,87953,87953,0
2021-09-26,1200708,202139,87953,87953,0
2021-09-26,1200450,202139,87953,87953,0
2021-09-26,1200500,202139,87953,87953,0
2021-09-26,1200435,202139,87953,87953,0
2021-09-26,1200427,202139,87953,87953,0
2021-09-26,1200401,202139,87953,87953,0
2021-09-26,1200393,202139,87953,87953,0
2021-09-26,1200807,202139,87953,87953,0
2021-09-26,1200336,202139,87953,87953,0
2021-09-26,1200351,202139,87953,87953,0
2021-09-26,1200344,202139,87953,87953,0
2021-09-26,1200054,202139,87953,87953,0
2021-09-26,1200104,202139,87953,87953,0
2021-09-26,1200138,202139,87953,87953,0
2021-09-26,1200179,202139,87953,87953,0
2021-09-26,1200013,202139,87953,87953,0
2021-09-26,1200252,202139,87953,87953,0
2021-09-26,1200302,202139,87953,87953,0
2021-09-26,1200328,202139,87953,87953,0
2021-09-26,1200609,202139,87953,87953,0
2021-09-27,1200344,202139,87953,87953,0
2021-09-27,1200013,202139,87953,87953,0
2021-09-27,1200104,202139,87953,87953,0
2021-09-27,1200138,202139,87953,87953,0
2021-09-27,1200179,202139,87953,87953,0
2021-09-27,1200203,202139,87953,87953,0
2021-09-27,1200252,202139,87953,87953,0
2021-09-27,1200302,202139,87953,87953,0
2021-09-27,1200328,202139,87953,87953,0
2021-09-27,1200427,202139,87953,87953,0
2021-09-27,1200351,202139,87953,87953,0
2021-09-27,1200385,202139,87953,87953,0
2021-09-27,1200500,202139,87953,87953,0
2021-09-27,1200054,202139,87953,87953,0
2021-09-27,1200708,202139,87953,87953,0
2021-09-27,1200609,202139,87953,87953,0
2021-09-27,1200336,202139,87953,87953,0
2021-09-27,1200435,202139,87953,87953,0
2021-09-27,1200401,202139,87954,87953,1
2021-09-27,1200393,202139,87954,87954,0
2021-09-27,1200807,202139,87954,87954,0
2021-09-27,1200450,202139,87954,87954,0
2021-09-28,1200385,202139,87954,87954,0
2021-09-28,1200609,202139,87954,87954,0
2021-09-28,1200450,202139,87954,87954,0
2021-09-28,1200500,202139,87954,87954,0
2021-09-28,1200435,202139,87954,87954,0
2021-09-28,1200427,202139,87954,87954,0
2021-09-28,1200401,202139,87954,87954,0
2021-09-28,1200393,202139,87954,87954,0
2021-09-28,1200807,202139,87954,87954,0
2021-09-28,1200336,202139,87954,87954,0
2021-09-28,1200708,202139,87954,87954,0
2021-09-28,1200351,202139,87954,87954,0
2021-09-28,1200344,202139,87954,87954,0
2021-09-28,1200328,202139,87954,87954,0
2021-09-28,1200302,202139,87954,87954,0
2021-09-28,1200252,202139,87954,87954,0
2021-09-28,1200179,202139,87954,87954,0
2021-09-28,1200013,202139,87954,87954,0
2021-09-28,1200138,202139,87954,87954,0
2021-09-28,1200104,202139,87955,87954,1
2021-09-28,1200054,202139,87955,87955,0
2021-09-28,1200203,202139,87955,87955,0
2021-09-29,1200427,202139,87954,87955,-1
2021-09-29,1200302,202139,87954,87954,0
2021-09-29,1200328,202139,87954,87954,0
2021-09-29,1200344,202139,87954,87954,0
2021-09-29,1200351,202139,87953,87954,-1
2021-09-29,1200336,202139,87951,87953,-2
2021-09-29,1200609,202139,87949,87951,-2
2021-09-29,1200252,202139,87948,87949,-1
2021-09-29,1200393,202139,87948,87948,0
2021-09-29,1200401,202139,87946,87948,-2
2021-09-29,1200385,202139,87946,87946,0
2021-09-29,1200435,202139,87946,87946,0
2021-09-29,1200450,202139,87946,87946,0
2021-09-29,1200807,202139,87946,87946,0
2021-09-29,1200203,202139,87942,87946,-4
2021-09-29,1200179,202139,87941,87942,-1
2021-09-29,1200138,202139,87941,87941,0
2021-09-29,1200104,202139,87941,87941,0
2021-09-29,1200054,202139,87939,87941,-2
2021-09-29,1200013,202139,87939,87939,0
2021-09-29,1200708,202139,87938,87939,-1
2021-09-29,1200500,202139,87938,87938,0
2021-09-30,1200344,202139,87938,87938,0
2021-09-30,1200328,202139,87938,87938,0
2021-09-30,1200302,202139,87938,87938,0
2021-09-30,1200252,202139,87938,87938,0
2021-09-30,1200351,202139,87938,87938,0
2021-09-30,1200179,202139,87938,87938,0
2021-09-30,1200138,202139,87938,87938,0
2021-09-30,1200609,202139,87938,87938,0
2021-09-30,1200203,202139,87938,87938,0
2021-09-30,1200336,202139,87938,87938,0
2021-09-30,1200385,202139,87938,87938,0
2021-09-30,1200807,202139,87938,87938,0
2021-09-30,1200013,202139,87938,87938,0
2021-09-30,1200104,202139,87938,87938,0
2021-09-30,1200708,202139,87938,87938,0
2021-09-30,1200450,202139,87938,87938,0
2021-09-30,1200054,202139,87938,87938,0
2021-09-30,1200435,202139,87938,87938,0
2021-09-30,1200427,202139,87938,87938,0
2021-09-30,1200401,202139,87938,87938,0
2021-09-30,1200393,202139,87938,87938,0
2021-09-30,1200500,202139,87939,87938,1
2021-10-01,1200344,202139,87939,87939,0
2021-10-01,1200435,202139,87939,87939,0
2021-10-01,1200013,202139,87939,87939,0
2021-10-01,1200104,202139,87939,87939,0
2021-10-01,1200138,202139,87939,87939,0
2021-10-01,1200179,202139,87939,87939,0
2021-10-01,1200203,202139,87939,87939,0
2021-10-01,1200252,202139,87939,87939,0
2021-10-01,1200302,202139,87939,87939,0
2021-10-01,1200328,202139,87939,87939,0
2021-10-01,1200351,202139,87939,87939,0
2021-10-01,1200336,202139,87939,87939,0
2021-10-01,1200708,202139,87939,87939,0
2021-10-01,1200609,202139,87939,87939,0
2021-10-01,1200450,202139,87939,87939,0
2021-10-01,1200500,202139,87939,87939,0
2021-10-01,1200385,202139,87939,87939,0
2021-10-01,1200427,202139,87939,87939,0
2021-10-01,1200401,202139,87940,87939,1
2021-10-01,1200054,202139,87940,87940,0
2021-10-01,1200393,202139,87940,87940,0
2021-10-01,1200807,202139,87940,87940,0
2021-10-02,1200252,202139,87940,87940,0
2021-10-02,1200203,202139,87940,87940,0
2021-10-02,1200179,202139,87940,87940,0
2021-10-02,1200138,202139,87940,87940,0
2021-10-02,1200013,202139,87940,87940,0
2021-10-02,1200054,202139,87940,87940,0
2021-10-02,1200450,202139,87940,87940,0
2021-10-02,1200609,202139,87940,87940,0
2021-10-02,1200302,202139,87940,87940,0
2021-10-02,1200104,202139,87940,87940,0
2021-10-02,1200328,202139,87940,87940,0
2021-10-02,1200344,202139,87940,87940,0
2021-10-02,1200351,202139,87940,87940,0
2021-10-02,1200336,202139,87940,87940,0
2021-10-02,1200385,202139,87940,87940,0
2021-10-02,1200807,202139,87940,87940,0
2021-10-02,1200393,202139,87940,87940,0
2021-10-02,1200401,202139,87941,87940,1
2021-10-02,1200427,202139,87941,87941,0
2021-10-02,1200500,202139,87941,87941,0
2021-10-02,1200708,202139,87941,87941,0
2021-10-02,1200435,202139,87941,87941,0
2021-10-03,1200302,202140,87941,87941,0
2021-10-03,1200252,202140,87941,87941,0
2021-10-03,1200203,202140,87941,87941,0
2021-10-03,1200179,202140,87941,87941,0
2021-10-03,1200385,202140,87941,87941,0
2021-10-03,1200104,202140,87941,87941,0
2021-10-03,1200054,202140,87941,87941,0
2021-10-03,1200013,202140,87941,87941,0
2021-10-03,1200328,202140,87941,87941,0
2021-10-03,1200138,202140,87941,87941,0
2021-10-03,1200344,202140,87941,87941,0
2021-10-03,1200351,202140,87941,87941,0
2021-10-03,1200708,202140,87941,87941,0
2021-10-03,1200807,202140,87941,87941,0
2021-10-03,1200393,202140,87941,87941,0
2021-10-03,1200401,202140,87941,87941,0
2021-10-03,1200427,202140,87941,87941,0
2021-10-03,1200336,202140,87941,87941,0
2021-10-03,1200500,202140,87941,87941,0
2021-10-03,1200450,202140,87941,87941,0
2021-10-03,1200609,202140,87941,87941,0
2021-10-03,1200435,202140,87941,87941,0
2021-10-04,1200344,202140,87941,87941,0
2021-10-04,1200013,202140,87941,87941,0
2021-10-04,1200054,202140,87941,87941,0
2021-10-04,1200104,202140,87941,87941,0
2021-10-04,1200138,202140,87941,87941,0
2021-10-04,1200179,202140,87941,87941,0
2021-10-04,1200203,202140,87941,87941,0
2021-10-04,1200302,202140,87941,87941,0
2021-10-04,1200328,202140,87941,87941,0
2021-10-04,1200385,202140,87941,87941,0
2021-10-04,1200351,202140,87941,87941,0
2021-10-04,1200807,202140,87941,87941,0
2021-10-04,1200252,202140,87941,87941,0
2021-10-04,1200427,202140,87941,87941,0
2021-10-04,1200708,202140,87941,87941,0
2021-10-04,1200609,202140,87941,87941,0
2021-10-04,1200336,202140,87941,87941,0
2021-10-04,1200500,202140,87941,87941,0
2021-10-04,1200435,202140,87941,87941,0
2021-10-04,1200401,202140,87945,87941,4
2021-10-04,1200393,202140,87945,87945,0
2021-10-04,1200450,202140,87945,87945,0
2021-10-05,1200054,202140,87945,87945,0
2021-10-05,1200807,202140,87945,87945,0
2021-10-05,1200708,202140,87945,87945,0
2021-10-05,1200609,202140,87945,87945,0
2021-10-05,1200450,202140,87945,87945,0
2021-10-05,1200500,202140,87945,87945,0
2021-10-05,1200435,202140,87945,87945,0
2021-10-05,1200427,202140,87945,87945,0
2021-10-05,1200401,202140,87945,87945,0
2021-10-05,1200393,202140,87945,87945,0
2021-10-05,1200336,202140,87945,87945,0
2021-10-05,1200179,202140,87945,87945,0
2021-10-05,1200351,202140,87946,87945,1
2021-10-05,1200344,202140,87946,87946,0
2021-10-05,1200328,202140,87946,87946,0
2021-10-05,1200302,202140,87946,87946,0
2021-10-05,1200203,202140,87946,87946,0
2021-10-05,1200252,202140,87946,87946,0
2021-10-05,1200138,202140,87946,87946,0
2021-10-05,1200104,202140,87946,87946,0
2021-10-05,1200013,202140,87946,87946,0
2021-10-05,1200385,202140,87946,87946,0
2021-10-06,1200401,202140,87946,87946,0
2021-10-06,1200807,202140,87946,87946,0
2021-10-06,1200328,202140,87946,87946,0
2021-10-06,1200344,202140,87946,87946,0
2021-10-06,1200351,202140,87946,87946,0
2021-10-06,1200336,202140,87946,87946,0
2021-10-06,1200385,202140,87946,87946,0
2021-10-06,1200393,202140,87946,87946,0
2021-10-06,1200252,202140,87946,87946,0
2021-10-06,1200427,202140,87946,87946,0
2021-10-06,1200609,202140,87946,87946,0
2021-10-06,1200500,202140,87946,87946,0
2021-10-06,1200708,202140,87946,87946,0
2021-10-06,1200013,202140,87946,87946,0
2021-10-06,1200054,202140,87946,87946,0
2021-10-06,1200104,202140,87946,87946,0
2021-10-06,1200435,202140,87946,87946,0
2021-10-06,1200179,202140,87946,87946,0
2021-10-06,1200203,202140,87946,87946,0
2021-10-06,1200302,202140,87946,87946,0
2021-10-06,1200450,202140,87946,87946,0
2021-10-06,1200138,202140,87946,87946,0
2021-10-07,1200393,202140,87946,87946,0
2021-10-07,1200708,202140,87946,87946,0
2021-10-07,1200609,202140,87946,87946,0
2021-10-07,1200450,202140,87946,87946,0
2021-10-07,1200203,202140,87946,87946,0
2021-10-07,1200500,202140,87946,87946,0
2021-10-07,1200435,202140,87946,87946,0
2021-10-07,1200427,202140,87946,87946,0
2021-10-07,1200401,202140,87952,87946,6
2021-10-07,1200807,202140,87952,87952,0
2021-10-07,1200138,202140,87953,87952,1
2021-10-07,1200336,202140,87953,87953,0
2021-10-07,1200013,202140,87953,87953,0
2021-10-07,1200054,202140,87953,87953,0
2021-10-07,1200104,202140,87953,87953,0
2021-10-07,1200179,202140,87953,87953,0
2021-10-07,1200385,202140,87953,87953,0
2021-10-07,1200302,202140,87953,87953,0
2021-10-07,1200328,202140,87953,87953,0
2021-10-07,1200344,202140,87953,87953,0
2021-10-07,1200351,202140,87953,87953,0
2021-10-07,1200252,202140,87953,87953,0
2021-10-08,1200385,202140,87953,87953,0
2021-10-08,1200708,202140,87953,87953,0
2021-10-08,1200609,202140,87953,87953,0
2021-10-08,1200450,202140,87953,87953,0
2021-10-08,1200500,202140,87955,87953,2
2021-10-08,1200435,202140,87955,87955,0
2021-10-08,1200427,202140,87955,87955,0
2021-10-08,1200401,202140,87955,87955,0
2021-10-08,1200807,202140,87955,87955,0
2021-10-08,1200393,202140,87955,87955,0
2021-10-08,1200336,202140,87955,87955,0
2021-10-08,1200351,202140,87955,87955,0
2021-10-08,1200328,202140,87955,87955,0
2021-10-08,1200302,202140,87955,87955,0
2021-10-08,1200252,202140,87955,87955,0
2021-10-08,1200203,202140,87955,87955,0
2021-10-08,1200179,202140,87955,87955,0
2021-10-08,1200138,202140,87955,87955,0
2021-10-08,1200104,202140,87955,87955,0
2021-10-08,1200054,202140,87955,87955,0
2021-10-08,1200013,202140,87955,87955,0
2021-10-08,1200344,202140,87955,87955,0
2021-10-09,1200393,202140,87955,87955,0
2021-10-09,1200401,202140,87958,87955,3
2021-10-09,1200427,202140,87958,87958,0
2021-10-09,1200435,202140,87958,87958,0
2021-10-09,1200252,202140,87958,87958,0
2021-10-09,1200450,202140,87958,87958,0
2021-10-09,1200609,202140,87958,87958,0
2021-10-09,1200302,202140,87958,87958,0
2021-10-09,1200807,202140,87958,87958,0
2021-10-09,1200500,202140,87958,87958,0
2021-10-09,1200336,202140,87958,87958,0
2021-10-09,1200328,202140,87958,87958,0
2021-10-09,1200351,202140,87958,87958,0
2021-10-09,1200054,202140,87958,87958,0
2021-10-09,1200104,202140,87958,87958,0
2021-10-09,1200138,202140,87958,87958,0
2021-10-09,1200179,202140,87958,87958,0
2021-10-09,1200013,202140,87958,87958,0
2021-10-09,1200708,202140,87958,87958,0
2021-10-09,1200385,202140,87958,87958,0
2021-10-09,1200344,202140,87958,87958,0
2021-10-09,1200203,202140,87959,87958,1
2021-10-10,1200302,202141,87959,87959,0
2021-10-10,1200344,202141,87959,87959,0
2021-10-10,1200013,202141,87959,87959,0
2021-10-10,1200054,202141,87959,87959,0
2021-10-10,1200104,202141,87959,87959,0
2021-10-10,1200138,202141,87959,87959,0
2021-10-10,1200179,202141,87959,87959,0
2021-10-10,1200203,202141,87959,87959,0
2021-10-10,1200252,202141,87959,87959,0
2021-10-10,1200328,202141,87959,87959,0
2021-10-10,1200336,202141,87959,87959,0
2021-10-10,1200435,202141,87959,87959,0
2021-10-10,1200385,202141,87959,87959,0
2021-10-10,1200807,202141,87959,87959,0
2021-10-10,1200401,202141,87959,87959,0
2021-10-10,1200427,202141,87959,87959,0
2021-10-10,1200500,202141,87959,87959,0
2021-10-10,1200450,202141,87959,87959,0
2021-10-10,1200609,202141,87959,87959,0
2021-10-10,1200708,202141,87959,87959,0
2021-10-10,1200393,202141,87959,87959,0
2021-10-10,1200351,202141,87959,87959,0
2021-10-11,1200807,202141,87959,87959,0
2021-10-11,1200393,202141,87959,87959,0
2021-10-11,1200401,202141,87959,87959,0
2021-10-11,1200427,202141,87959,87959,0
2021-10-11,1200385,202141,87959,87959,0
2021-10-11,1200500,202141,87959,87959,0
2021-10-11,1200450,202141,87959,87959,0
2021-10-11,1200609,202141,87959,87959,0
2021-10-11,1200708,202141,87959,87959,0
2021-10-11,1200435,202141,87959,87959,0
2021-10-11,1200344,202141,87959,87959,0
2021-10-11,1200336,202141,87959,87959,0
2021-10-11,1200138,202141,87959,87959,0
2021-10-11,1200328,202141,87959,87959,0
2021-10-11,1200013,202141,87959,87959,0
2021-10-11,1200054,202141,87959,87959,0
2021-10-11,1200104,202141,87959,87959,0
2021-10-11,1200351,202141,87959,87959,0
2021-10-11,1200179,202141,87959,87959,0
2021-10-11,1200252,202141,87959,87959,0
2021-10-11,1200302,202141,87959,87959,0
2021-10-11,1200203,202141,87959,87959,0
2021-10-12,1200807,202141,87959,87959,0
2021-10-12,1200393,202141,87959,87959,0
2021-10-12,1200401,202141,87959,87959,0
2021-10-12,1200427,202141,87959,87959,0
2021-10-12,1200203,202141,87959,87959,0
2021-10-12,1200500,202141,87959,87959,0
2021-10-12,1200450,202141,87959,87959,0
2021-10-12,1200708,202141,87959,87959,0
2021-10-12,1200385,202141,87959,87959,0
2021-10-12,1200435,202141,87959,87959,0
2021-10-12,1200336,202141,87959,87959,0
2021-10-12,1200351,202141,87959,87959,0
2021-10-12,1200344,202141,87959,87959,0
2021-10-12,1200054,202141,87959,87959,0
2021-10-12,1200104,202141,87959,87959,0
2021-10-12,1200138,202141,87959,87959,0
2021-10-12,1200179,202141,87959,87959,0
2021-10-12,1200013,202141,87959,87959,0
2021-10-12,1200252,202141,87959,87959,0
2021-10-12,1200302,202141,87959,87959,0
2021-10-12,1200328,202141,87959,87959,0
2021-10-12,1200609,202141,87959,87959,0
2021-10-13,1200328,202141,87959,87959,0
2021-10-13,1200013,202141,87959,87959,0
2021-10-13,1200054,202141,87959,87959,0
2021-10-13,1200344,202141,87959,87959,0
2021-10-13,1200138,202141,87959,87959,0
2021-10-13,1200179,202141,87959,87959,0
2021-10-13,1200203,202141,87959,87959,0
2021-10-13,1200252,202141,87959,87959,0
2021-10-13,1200302,202141,87959,87959,0
2021-10-13,1200385,202141,87959,87959,0
2021-10-13,1200104,202141,87959,87959,0
2021-10-13,1200807,202141,87959,87959,0
2021-10-13,1200336,202141,87959,87959,0
2021-10-13,1200427,202141,87959,87959,0
2021-10-13,1200708,202141,87959,87959,0
2021-10-13,1200609,202141,87959,87959,0
2021-10-13,1200351,202141,87959,87959,0
2021-10-13,1200500,202141,87959,87959,0
2021-10-13,1200435,202141,87959,87959,0
2021-10-13,1200401,202141,87959,87959,0
2021-10-13,1200393,202141,87959,87959,0
2021-10-13,1200450,202141,87959,87959,0
2021-10-14,1200252,202141,87959,87959,0
2021-10-14,1200708,202141,87959,87959,0
2021-10-14,1200609,202141,87959,87959,0
2021-10-14,1200450,202141,87959,87959,0
2021-10-14,1200500,202141,87959,87959,0
2021-10-14,1200435,202141,87959,87959,0
2021-10-14,1200427,202141,87959,87959,0
2021-10-14,1200401,202141,87959,87959,0
2021-10-14,1200393,202141,87959,87959,0
2021-10-14,1200807,202141,87959,87959,0
2021-10-14,1200336,202141,87959,87959,0
2021-10-14,1200138,202141,87959,87959,0
2021-10-14,1200351,202141,87959,87959,0
2021-10-14,1200344,202141,87959,87959,0
2021-10-14,1200328,202141,87959,87959,0
2021-10-14,1200302,202141,87959,87959,0
2021-10-14,1200179,202141,87959,87959,0
2021-10-14,1200203,202141,87959,87959,0
2021-10-14,1200104,202141,87959,87959,0
2021-10-14,1200054,202141,87959,87959,0
2021-10-14,1200013,202141,87959,87959,0
2021-10-14,1200385,202141,87959,87959,0
2021-10-15,1200401,202141,88001,87959,42
2021-10-15,1200302,202141,88001,88001,0
2021-10-15,1200328,202141,88001,88001,0
2021-10-15,1200385,202141,88003,88001,2
2021-10-15,1200351,202141,88003,88003,0
2021-10-15,1200336,202141,88003,88003,0
2021-10-15,1200609,202141,88005,88003,2
2021-10-15,1200252,202141,88005,88005,0
2021-10-15,1200393,202141,88005,88005,0
2021-10-15,1200427,202141,88006,88005,1
2021-10-15,1200344,202141,88006,88006,0
2021-10-15,1200500,202141,88006,88006,0
2021-10-15,1200450,202141,88008,88006,2
2021-10-15,1200807,202141,88010,88008,2
2021-10-15,1200203,202141,88011,88010,1
2021-10-15,1200179,202141,88012,88011,1
2021-10-15,1200138,202141,88016,88012,4
2021-10-15,1200104,202141,88016,88016,0
2021-10-15,1200054,202141,88016,88016,0
2021-10-15,1200013,202141,88016,88016,0
2021-10-15,1200708,202141,88016,88016,0
2021-10-15,1200435,202141,88016,88016,0
2021-10-16,1200351,202141,88016,88016,0
2021-10-16,1200344,202141,88016,88016,0
2021-10-16,1200328,202141,88016,88016,0
2021-10-16,1200302,202141,88016,88016,0
2021-10-16,1200609,202141,88016,88016,0
2021-10-16,1200179,202141,88016,88016,0
2021-10-16,1200138,202141,88016,88016,0
2021-10-16,1200336,202141,88016,88016,0
2021-10-16,1200252,202141,88016,88016,0
2021-10-16,1200385,202141,88016,88016,0
2021-10-16,1200203,202141,88016,88016,0
2021-10-16,1200393,202141,88016,88016,0
2021-10-16,1200401,202141,88016,88016,0
2021-10-16,1200427,202141,88016,88016,0
2021-10-16,1200435,202141,88016,88016,0
2021-10-16,1200500,202141,88016,88016,0
2021-10-16,1200450,202141,88016,88016,0
2021-10-16,1200708,202141,88016,88016,0
2021-10-16,1200104,202141,88016,88016,0
2021-10-16,1200013,202141,88016,88016,0
2021-10-16,1200054,202141,88016,88016,0
2021-10-16,1200807,202141,88016,88016,0
2021-10-17,1200328,202142,88016,88016,0
2021-10-17,1200302,202142,88016,88016,0
2021-10-17,1200252,202142,88016,88016,0
2021-10-17,1200203,202142,88016,88016,0
2021-10-17,1200435,202142,88016,88016,0
2021-10-17,1200138,202142,88016,88016,0
2021-10-17,1200104,202142,88016,88016,0
2021-10-17,1200013,202142,88016,88016,0
2021-10-17,1200344,202142,88016,88016,0
2021-10-17,1200179,202142,88016,88016,0
2021-10-17,1200351,202142,88016,88016,0
2021-10-17,1200450,202142,88016,88016,0
2021-10-17,1200708,202142,88016,88016,0
2021-10-17,1200609,202142,88016,88016,0
2021-10-17,1200500,202142,88016,88016,0
2021-10-17,1200385,202142,88016,88016,0
2021-10-17,1200427,202142,88016,88016,0
2021-10-17,1200401,202142,88016,88016,0
2021-10-17,1200054,202142,88016,88016,0
2021-10-17,1200393,202142,88016,88016,0
2021-10-17,1200807,202142,88016,88016,0
2021-10-17,1200336,202142,88016,88016,0
2021-10-18,1200179,202142,88016,88016,0
2021-10-18,1200252,202142,88016,88016,0
2021-10-18,1200203,202142,88016,88016,0
2021-10-18,1200013,202142,88016,88016,0
2021-10-18,1200302,202142,88016,88016,0
2021-10-18,1200104,202142,88016,88016,0
2021-10-18,1200054,202142,88016,88016,0
2021-10-18,1200450,202142,88016,88016,0
2021-10-18,1200609,202142,88016,88016,0
2021-10-18,1200138,202142,88016,88016,0
2021-10-18,1200328,202142,88016,88016,0
2021-10-18,1200393,202142,88016,88016,0
2021-10-18,1200351,202142,88016,88016,0
2021-10-18,1200435,202142,88016,88016,0
2021-10-18,1200708,202142,88016,88016,0
2021-10-18,1200500,202142,88016,88016,0
2021-10-18,1200427,202142,88016,88016,0
2021-10-18,1200344,202142,88016,88016,0
2021-10-18,1200807,202142,88016,88016,0
2021-10-18,1200385,202142,88016,88016,0
2021-10-18,1200336,202142,88016,88016,0
2021-10-18,1200401,202142,88016,88016,0
2021-10-19,1200302,202142,88016,88016,0
2021-10-19,1200385,202142,88016,88016,0
2021-10-19,1200013,202142,88016,88016,0
2021-10-19,1200054,202142,88016,88016,0
2021-10-19,1200104,202142,88016,88016,0
2021-10-19,1200138,202142,88016,88016,0
2021-10-19,1200179,202142,88016,88016,0
2021-10-19,1200203,202142,88016,88016,0
2021-10-19,1200252,202142,88016,88016,0
2021-10-19,1200328,202142,88016,88016,0
2021-10-19,1200344,202142,88016,88016,0
2021-10-19,1200336,202142,88016,88016,0
2021-10-19,1200708,202142,88016,88016,0
2021-10-19,1200609,202142,88016,88016,0
2021-10-19,1200450,202142,88016,88016,0
2021-10-19,1200500,202142,88016,88016,0
2021-10-19,1200435,202142,88016,88016,0
2021-10-19,1200427,202142,88016,88016,0
2021-10-19,1200401,202142,88016,88016,0
2021-10-19,1200393,202142,88016,88016,0
2021-10-19,1200807,202142,88016,88016,0
2021-10-19,1200351,202142,88016,88016,0
2021-10-20,1200302,202142,88016,88016,0
2021-10-20,1200252,202142,88016,88016,0
2021-10-20,1200203,202142,88016,88016,0
2021-10-20,1200179,202142,88016,88016,0
2021-10-20,1200328,202142,88016,88016,0
2021-10-20,1200104,202142,88016,88016,0
2021-10-20,1200054,202142,88016,88016,0
2021-10-20,1200013,202142,88016,88016,0
2021-10-20,1200344,202142,88016,88016,0
2021-10-20,1200138,202142,88016,88016,0
2021-10-20,1200385,202142,88016,88016,0
2021-10-20,1200351,202142,88016,88016,0
2021-10-20,1200807,202142,88016,88016,0
2021-10-20,1200393,202142,88016,88016,0
2021-10-20,1200401,202142,88016,88016,0
2021-10-20,1200435,202142,88016,88016,0
2021-10-20,1200500,202142,88016,88016,0
2021-10-20,1200450,202142,88016,88016,0
2021-10-20,1200609,202142,88016,88016,0
2021-10-20,1200708,202142,88016,88016,0
2021-10-20,1200427,202142,88016,88016,0
2021-10-20,1200336,202142,88016,88016,0
2021-10-21,1200393,202142,88016,88016,0
2021-10-21,1200401,202142,88016,88016,0
2021-10-21,1200427,202142,88016,88016,0
2021-10-21,1200435,202142,88016,88016,0
2021-10-21,1200807,202142,88016,88016,0
2021-10-21,1200450,202142,88016,88016,0
2021-10-21,1200609,202142,88016,88016,0
2021-10-21,1200708,202142,88016,88016,0
2021-10-21,1200252,202142,88016,88016,0
2021-10-21,1200500,202142,88016,88016,0
2021-10-21,1200336,202142,88016,88016,0
2021-10-21,1200138,202142,88016,88016,0
2021-10-21,1200351,202142,88016,88016,0
2021-10-21,1200344,202142,88016,88016,0
2021-10-21,1200328,202142,88016,88016,0
2021-10-21,1200302,202142,88016,88016,0
2021-10-21,1200179,202142,88016,88016,0
2021-10-21,1200203,202142,88016,88016,0
2021-10-21,1200104,202142,88016,88016,0
2021-10-21,1200054,202142,88016,88016,0
2021-10-21,1200013,202142,88016,88016,0
2021-10-21,1200385,202142,88016,88016,0
2021-10-22,1200401,202142,88032,88016,16
2021-10-22,1200807,202142,88033,88032,1
2021-10-22,1200328,202142,88033,88033,0
2021-10-22,1200344,202142,88033,88033,0
2021-10-22,1200351,202142,88033,88033,0
2021-10-22,1200336,202142,88033,88033,0
2021-10-22,1200385,202142,88032,88033,-1
2021-10-22,1200393,202142,88032,88032,0
2021-10-22,1200252,202142,88032,88032,0
2021-10-22,1200427,202142,88032,88032,0
2021-10-22,1200609,202142,88032,88032,0
2021-10-22,1200500,202142,88032,88032,0
2021-10-22,1200708,202142,88033,88032,1
2021-10-22,1200013,202142,88033,88033,0
2021-10-22,1200054,202142,88033,88033,0
2021-10-22,1200104,202142,88033,88033,0
2021-10-22,1200435,202142,88033,88033,0
2021-10-22,1200179,202142,88033,88033,0
2021-10-22,1200203,202142,88037,88033,4
2021-10-22,1200302,202142,88037,88037,0
2021-10-22,1200450,202142,88038,88037,1
2021-10-22,1200138,202142,88038,88038,0
2021-10-23,1200336,202142,88038,88038,0
2021-10-23,1200393,202142,88038,88038,0
2021-10-23,1200401,202142,88038,88038,0
2021-10-23,1200179,202142,88038,88038,0
2021-10-23,1200203,202142,88038,88038,0
2021-10-23,1200252,202142,88038,88038,0
2021-10-23,1200302,202142,88038,88038,0
2021-10-23,1200328,202142,88038,88038,0
2021-10-23,1200344,202142,88038,88038,0
2021-10-23,1200351,202142,88038,88038,0
2021-10-23,1200385,202142,88038,88038,0
2021-10-23,1200807,202142,88038,88038,0
2021-10-23,1200708,202142,88038,88038,0
2021-10-23,1200054,202142,88038,88038,0
2021-10-23,1200104,202142,88038,88038,0
2021-10-23,1200435,202142,88038,88038,0
2021-10-23,1200427,202142,88038,88038,0
2021-10-23,1200013,202142,88038,88038,0
2021-10-23,1200500,202142,88038,88038,0
2021-10-23,1200450,202142,88038,88038,0
2021-10-23,1200609,202142,88038,88038,0
2021-10-23,1200138,202142,88038,88038,0
2021-10-24,1200013,202143,88038,88038,0
2021-10-24,1200401,202143,88038,88038,0
2021-10-24,1200435,202143,88038,88038,0
2021-10-24,1200708,202143,88038,88038,0
2021-10-24,1200427,202143,88038,88038,0
2021-10-24,1200609,202143,88038,88038,0
2021-10-24,1200500,202143,88038,88038,0
2021-10-24,1200336,202143,88038,88038,0
2021-10-24,1200351,202143,88038,88038,0
2021-10-24,1200344,202143,88038,88038,0
2021-10-24,1200450,202143,88038,88038,0
2021-10-24,1200302,202143,88038,88038,0
2021-10-24,1200385,202143,88038,88038,0
2021-10-24,1200393,202143,88038,88038,0
2021-10-24,1200054,202143,88038,88038,0
2021-10-24,1200104,202143,88038,88038,0
2021-10-24,1200328,202143,88038,88038,0
2021-10-24,1200138,202143,88038,88038,0
2021-10-24,1200179,202143,88038,88038,0
2021-10-24,1200203,202143,88038,88038,0
2021-10-24,1200252,202143,88038,88038,0
2021-10-24,1200807,202143,88038,88038,0
2021-10-25,1200393,202143,88038,88038,0
2021-10-25,1200351,202143,88038,88038,0
2021-10-25,1200708,202143,88038,88038,0
2021-10-25,1200609,202143,88038,88038,0
2021-10-25,1200450,202143,88038,88038,0
2021-10-25,1200500,202143,88038,88038,0
2021-10-25,1200435,202143,88038,88038,0
2021-10-25,1200427,202143,88038,88038,0
2021-10-25,1200401,202143,88038,88038,0
2021-10-25,1200807,202143,88038,88038,0
2021-10-25,1200344,202143,88038,88038,0
2021-10-25,1200336,202143,88038,88038,0
2021-10-25,1200013,202143,88038,88038,0
2021-10-25,1200054,202143,88038,88038,0
2021-10-25,1200104,202143,88038,88038,0
2021-10-25,1200138,202143,88038,88038,0
2021-10-25,1200385,202143,88038,88038,0
2021-10-25,1200203,202143,88038,88038,0
2021-10-25,1200252,202143,88038,88038,0
2021-10-25,1200328,202143,88038,88038,0
2021-10-25,1200302,202143,88038,88038,0
2021-10-25,1200179,202143,88038,88038,0
2021-10-26,1200708,202143,88038,88038,0
2021-10-26,1200336,202143,88038,88038,0
2021-10-26,1200203,202143,88038,88038,0
2021-10-26,1200252,202143,88038,88038,0
2021-10-26,1200302,202143,88038,88038,0
2021-10-26,1200328,202143,88038,88038,0
2021-10-26,1200344,202143,88038,88038,0
2021-10-26,1200351,202143,88038,88038,0
2021-10-26,1200385,202143,88038,88038,0
2021-10-26,1200450,202143,88038,88038,0
2021-10-26,1200609,202143,88038,88038,0
2021-10-26,1200393,202143,88038,88038,0
2021-10-26,1200427,202143,88038,88038,0
2021-10-26,1200435,202143,88038,88038,0
2021-10-26,1200500,202143,88038,88038,0
2021-10-26,1200807,202143,88038,88038,0
2021-10-26,1200054,202143,88038,88038,0
2021-10-26,1200013,202143,88038,88038,0
2021-10-26,1200104,202143,88038,88038,0
2021-10-26,1200138,202143,88038,88038,0
2021-10-26,1200179,202143,88038,88038,0
2021-10-26,1200401,202143,88038,88038,0
2021-10-27,1200328,202143,88038,88038,0
2021-10-27,1200302,202143,88038,88038,0
2021-10-27,1200252,202143,88038,88038,0
2021-10-27,1200203,202143,88038,88038,0
2021-10-27,1200344,202143,88038,88038,0
2021-10-27,1200138,202143,88038,88038,0
2021-10-27,1200351,202143,88038,88038,0
2021-10-27,1200500,202143,88038,88038,0
2021-10-27,1200179,202143,88038,88038,0
2021-10-27,1200336,202143,88038,88038,0
2021-10-27,1200054,202143,88038,88038,0
2021-10-27,1200427,202143,88038,88038,0
2021-10-27,1200807,202143,88038,88038,0
2021-10-27,1200708,202143,88038,88038,0
2021-10-27,1200609,202143,88038,88038,0
2021-10-27,1200450,202143,88038,88038,0
2021-10-27,1200393,202143,88038,88038,0
2021-10-27,1200435,202143,88038,88038,0
2021-10-27,1200104,202143,88038,88038,0
2021-10-27,1200013,202143,88038,88038,0
2021-10-27,1200401,202143,88038,88038,0
2021-10-27,1200385,202143,88038,88038,0
2021-10-28,1200252,202143,88038,88038,0
2021-10-28,1200203,202143,88038,88038,0
2021-10-28,1200179,202143,88038,88038,0
2021-10-28,1200138,202143,88038,88038,0
2021-10-28,1200351,202143,88038,88038,0
2021-10-28,1200054,202143,88038,88038,0
2021-10-28,1200013,202143,88038,88038,0
2021-10-28,1200344,202143,88038,88038,0
2021-10-28,1200302,202143,88038,88038,0
2021-10-28,1200104,202143,88038,88038,0
2021-10-28,1200328,202143,88038,88038,0
2021-10-28,1200427,202143,88038,88038,0
2021-10-28,1200807,202143,88038,88038,0
2021-10-28,1200393,202143,88038,88038,0
2021-10-28,1200435,202143,88038,88038,0
2021-10-28,1200500,202143,88038,88038,0
2021-10-28,1200450,202143,88038,88038,0
2021-10-28,1200609,202143,88038,88038,0
2021-10-28,1200708,202143,88038,88038,0
2021-10-28,1200401,202143,88038,88038,0
2021-10-28,1200385,202143,88038,88038,0
2021-10-28,1200336,202143,88038,88038,0
2021-10-29,1200393,202143,88038,88038,0
2021-10-29,1200427,202143,88039,88038,1
2021-10-29,1200401,202143,88064,88039,25
2021-10-29,1200435,202143,88064,88064,0
2021-10-29,1200336,202143,88064,88064,0
2021-10-29,1200450,202143,88065,88064,1
2021-10-29,1200609,202143,88065,88065,0
2021-10-29,1200708,202143,88065,88065,0
2021-10-29,1200807,202143,88065,88065,0
2021-10-29,1200500,202143,88065,88065,0
2021-10-29,1200302,202143,88065,88065,0
2021-10-29,1200013,202143,88065,88065,0
2021-10-29,1200203,202143,88065,88065,0
2021-10-29,1200351,202143,88065,88065,0
2021-10-29,1200252,202143,88065,88065,0
2021-10-29,1200179,202143,88065,88065,0
2021-10-29,1200385,202143,88065,88065,0
2021-10-29,1200328,202143,88065,88065,0
2021-10-29,1200054,202143,88065,88065,0
2021-10-29,1200344,202143,88065,88065,0
2021-10-29,1200138,202143,88065,88065,0
2021-10-29,1200104,202143,88065,88065,0
2021-10-30,1200708,202143,88065,88065,0
2021-10-30,1200385,202143,88065,88065,0
2021-10-30,1200450,202143,88065,88065,0
2021-10-30,1200500,202143,88065,88065,0
2021-10-30,1200435,202143,88065,88065,0
2021-10-30,1200427,202143,88065,88065,0
2021-10-30,1200401,202143,88065,88065,0
2021-10-30,1200393,202143,88065,88065,0
2021-10-30,1200807,202143,88065,88065,0
2021-10-30,1200336,202143,88065,88065,0
2021-10-30,1200302,202143,88065,88065,0
2021-10-30,1200344,202143,88065,88065,0
2021-10-30,1200328,202143,88065,88065,0
2021-10-30,1200203,202143,88065,88065,0
2021-10-30,1200609,202143,88065,88065,0
2021-10-30,1200179,202143,88065,88065,0
2021-10-30,1200138,202143,88065,88065,0
2021-10-30,1200104,202143,88065,88065,0
2021-10-30,1200054,202143,88065,88065,0
2021-10-30,1200013,202143,88065,88065,0
2021-10-30,1200351,202143,88065,88065,0
2021-10-30,1200252,202143,88065,88065,0
2021-10-31,1200302,202144,88065,88065,0
2021-10-31,1200328,202144,88065,88065,0
2021-10-31,1200203,202144,88065,88065,0
2021-10-31,1200179,202144,88065,88065,0
2021-10-31,1200351,202144,88065,88065,0
2021-10-31,1200054,202144,88065,88065,0
2021-10-31,1200013,202144,88065,88065,0
2021-10-31,1200344,202144,88065,88065,0
2021-10-31,1200138,202144,88065,88065,0
2021-10-31,1200385,202144,88065,88065,0
2021-10-31,1200104,202144,88065,88065,0
2021-10-31,1200807,202144,88065,88065,0
2021-10-31,1200427,202144,88065,88065,0
2021-10-31,1200708,202144,88065,88065,0
2021-10-31,1200336,202144,88065,88065,0
2021-10-31,1200609,202144,88065,88065,0
2021-10-31,1200252,202144,88065,88065,0
2021-10-31,1200500,202144,88065,88065,0
2021-10-31,1200435,202144,88065,88065,0
2021-10-31,1200401,202144,88065,88065,0
2021-10-31,1200393,202144,88065,88065,0
2021-10-31,1200450,202144,88065,88065,0
2021-11-01,1200054,202144,88065,88065,0
2021-11-01,1200708,202144,88065,88065,0
2021-11-01,1200609,202144,88065,88065,0
2021-11-01,1200450,202144,88065,88065,0
2021-11-01,1200500,202144,88065,88065,0
2021-11-01,1200435,202144,88065,88065,0
2021-11-01,1200427,202144,88065,88065,0
2021-11-01,1200401,202144,88065,88065,0
2021-11-01,1200393,202144,88065,88065,0
2021-11-01,1200807,202144,88065,88065,0
2021-11-01,1200336,202144,88065,88065,0
2021-11-01,1200179,202144,88065,88065,0
2021-11-01,1200351,202144,88065,88065,0
2021-11-01,1200344,202144,88065,88065,0
2021-11-01,1200328,202144,88065,88065,0
2021-11-01,1200302,202144,88065,88065,0
2021-11-01,1200203,202144,88065,88065,0
2021-11-01,1200252,202144,88065,88065,0
2021-11-01,1200138,202144,88065,88065,0
2021-11-01,1200104,202144,88065,88065,0
2021-11-01,1200013,202144,88065,88065,0
2021-11-01,1200385,202144,88065,88065,0
2021-11-02,1200401,202144,88065,88065,0
2021-11-02,1200302,202144,88065,88065,0
2021-11-02,1200328,202144,88065,88065,0
2021-11-02,1200385,202144,88065,88065,0
2021-11-02,1200351,202144,88065,88065,0
2021-11-02,1200336,202144,88065,88065,0
2021-11-02,1200609,202144,88065,88065,0
2021-11-02,1200252,202144,88065,88065,0
2021-11-02,1200393,202144,88065,88065,0
2021-11-02,1200427,202144,88065,88065,0
2021-11-02,1200344,202144,88065,88065,0
2021-11-02,1200500,202144,88065,88065,0
2021-11-02,1200450,202144,88065,88065,0
2021-11-02,1200807,202144,88065,88065,0
2021-11-02,1200203,202144,88065,88065,0
2021-11-02,1200179,202144,88065,88065,0
2021-11-02,1200138,202144,88065,88065,0
2021-11-02,1200104,202144,88065,88065,0
2021-11-02,1200054,202144,88065,88065,0
2021-11-02,1200013,202144,88065,88065,0
2021-11-02,1200708,202144,88065,88065,0
2021-11-02,1200435,202144,88065,88065,0
2021-11-03,1200351,202144,88065,88065,0
2021-11-03,1200344,202144,88065,88065,0
2021-11-03,1200328,202144,88065,88065,0
2021-11-03,1200302,202144,88065,88065,0
2021-11-03,1200609,202144,88065,88065,0
2021-11-03,1200179,202144,88065,88065,0
2021-11-03,1200138,202144,88065,88065,0
2021-11-03,1200336,202144,88065,88065,0
2021-11-03,1200252,202144,88065,88065,0
2021-11-03,1200385,202144,88065,88065,0
2021-11-03,1200203,202144,88065,88065,0
2021-11-03,1200393,202144,88065,88065,0
2021-11-03,1200401,202144,88065,88065,0
2021-11-03,1200427,202144,88065,88065,0
2021-11-03,1200435,202144,88065,88065,0
2021-11-03,1200500,202144,88065,88065,0
2021-11-03,1200450,202144,88065,88065,0
2021-11-03,1200708,202144,88065,88065,0
2021-11-03,1200104,202144,88065,88065,0
2021-11-03,1200013,202144,88065,88065,0
2021-11-03,1200054,202144,88065,88065,0
2021-11-03,1200807,202144,88065,88065,0
2021-11-04,1200328,202144,88065,88065,0
2021-11-04,1200302,202144,88065,88065,0
2021-11-04,1200252,202144,88065,88065,0
2021-11-04,1200203,202144,88065,88065,0
2021-11-04,1200435,202144,88065,88065,0
2021-11-04,1200138,202144,88065,88065,0
2021-11-04,1200104,202144,88065,88065,0
2021-11-04,1200013,202144,88065,88065,0
2021-11-04,1200344,202144,88065,88065,0
2021-11-04,1200179,202144,88065,88065,0
2021-11-04,1200351,202144,88065,88065,0
2021-11-04,1200450,202144,88065,88065,0
2021-11-04,1200708,202144,88065,88065,0
2021-11-04,1200609,202144,88065,88065,0
2021-11-04,1200500,202144,88065,88065,0
2021-11-04,1200385,202144,88065,88065,0
2021-11-04,1200427,202144,88065,88065,0
2021-11-04,1200401,202144,88065,88065,0
2021-11-04,1200054,202144,88065,88065,0
2021-11-04,1200393,202144,88065,88065,0
2021-11-04,1200807,202144,88065,88065,0
2021-11-04,1200336,202144,88065,88065,0
2021-11-05,1200179,202144,88065,88065,0
2021-11-05,1200252,202144,88065,88065,0
2021-11-05,1200203,202144,88066,88065,1
2021-11-05,1200013,202144,88066,88066,0
2021-11-05,1200302,202144,88066,88066,0
2021-11-05,1200104,202144,88067,88066,1
2021-11-05,1200054,202144,88067,88067,0
2021-11-05,1200450,202144,88067,88067,0
2021-11-05,1200609,202144,88067,88067,0
2021-11-05,1200138,202144,88067,88067,0
2021-11-05,1200328,202144,88067,88067,0
2021-11-05,1200393,202144,88067,88067,0
2021-11-05,1200351,202144,88068,88067,1
2021-11-05,1200435,202144,88068,88068,0
2021-11-05,1200708,202144,88068,88068,0
2021-11-05,1200500,202144,88070,88068,2
2021-11-05,1200427,202144,88070,88070,0
2021-11-05,1200344,202144,88070,88070,0
2021-11-05,1200807,202144,88070,88070,0
2021-11-05,1200385,202144,88072,88070,2
2021-11-05,1200336,202144,88072,88072,0
2021-11-05,1200401,202144,88075,88072,3
2021-11-06,1200302,202144,88075,88075,0
2021-11-06,1200385,202144,88075,88075,0
2021-11-06,1200013,202144,88075,88075,0
2021-11-06,1200054,202144,88075,88075,0
2021-11-06,1200104,202144,88075,88075,0
2021-11-06,1200138,202144,88075,88075,0
2021-11-06,1200179,202144,88075,88075,0
2021-11-06,1200203,202144,88075,88075,0
2021-11-06,1200252,202144,88075,88075,0
2021-11-06,1200328,202144,88075,88075,0
2021-11-06,1200344,202144,88075,88075,0
2021-11-06,1200336,202144,88075,88075,0
2021-11-06,1200708,202144,88075,88075,0
2021-11-06,1200609,202144,88075,88075,0
2021-11-06,1200450,202144,88075,88075,0
2021-11-06,1200500,202144,88075,88075,0
2021-11-06,1200435,202144,88075,88075,0
2021-11-06,1200427,202144,88075,88075,0
2021-11-06,1200401,202144,88075,88075,0
2021-11-06,1200393,202144,88075,88075,0
2021-11-06,1200807,202144,88075,88075,0
2021-11-06,1200351,202144,88075,88075,0
2021-11-07,1200302,202145,88075,88075,0
2021-11-07,1200252,202145,88075,88075,0
2021-11-07,1200203,202145,88075,88075,0
2021-11-07,1200179,202145,88075,88075,0
2021-11-07,1200328,202145,88075,88075,0
2021-11-07,1200104,202145,88075,88075,0
2021-11-07,1200054,202145,88075,88075,0
2021-11-07,1200013,202145,88075,88075,0
2021-11-07,1200344,202145,88075,88075,0
2021-11-07,1200138,202145,88075,88075,0
2021-11-07,1200385,202145,88075,88075,0
2021-11-07,1200336,202145,88075,88075,0
2021-11-07,1200807,202145,88075,88075,0
2021-11-07,1200393,202145,88075,88075,0
2021-11-07,1200401,202145,88075,88075,0
2021-11-07,1200435,202145,88075,88075,0
2021-11-07,1200500,202145,88075,88075,0
2021-11-07,1200450,202145,88075,88075,0
2021-11-07,1200609,202145,88075,88075,0
2021-11-07,1200708,202145,88075,88075,0
2021-11-07,1200427,202145,88075,88075,0
2021-11-07,1200351,202145,88075,88075,0
2021-11-08,1200393,202145,88075,88075,0
2021-11-08,1200401,202145,88075,88075,0
2021-11-08,1200427,202145,88075,88075,0
2021-11-08,1200435,202145,88075,88075,0
2021-11-08,1200807,202145,88075,88075,0
2021-11-08,1200450,202145,88075,88075,0
2021-11-08,1200609,202145,88075,88075,0
2021-11-08,1200708,202145,88075,88075,0
2021-11-08,1200252,202145,88075,88075,0
2021-11-08,1200500,202145,88075,88075,0
2021-11-08,1200336,202145,88075,88075,0
2021-11-08,1200203,202145,88075,88075,0
2021-11-08,1200351,202145,88075,88075,0
2021-11-08,1200344,202145,88075,88075,0
2021-11-08,1200328,202145,88075,88075,0
2021-11-08,1200302,202145,88075,88075,0
2021-11-08,1200179,202145,88075,88075,0
2021-11-08,1200138,202145,88075,88075,0
2021-11-08,1200104,202145,88075,88075,0
2021-11-08,1200054,202145,88075,88075,0
2021-11-08,1200013,202145,88075,88075,0
2021-11-08,1200385,202145,88075,88075,0
2021-11-09,1200401,202145,88075,88075,0
2021-11-09,1200807,202145,88075,88075,0
2021-11-09,1200328,202145,88075,88075,0
2021-11-09,1200344,202145,88075,88075,0
2021-11-09,1200351,202145,88075,88075,0
2021-11-09,1200336,202145,88075,88075,0
2021-11-09,1200385,202145,88075,88075,0
2021-11-09,1200393,202145,88075,88075,0
2021-11-09,1200252,202145,88075,88075,0
2021-11-09,1200609,202145,88075,88075,0
2021-11-09,1200427,202145,88075,88075,0
2021-11-09,1200500,202145,88075,88075,0
2021-11-09,1200450,202145,88075,88075,0
2021-11-09,1200302,202145,88075,88075,0
2021-11-09,1200203,202145,88075,88075,0
2021-11-09,1200179,202145,88075,88075,0
2021-11-09,1200138,202145,88075,88075,0
2021-11-09,1200104,202145,88075,88075,0
2021-11-09,1200054,202145,88075,88075,0
2021-11-09,1200013,202145,88075,88075,0
2021-11-09,1200708,202145,88075,88075,0
2021-11-09,1200435,202145,88075,88075,0
2021-11-10,1200401,202145,88075,88075,0
2021-11-10,1200427,202145,88075,88075,0
2021-11-10,1200435,202145,88075,88075,0
2021-11-10,1200500,202145,88075,88075,0
2021-11-10,1200393,202145,88075,88075,0
2021-11-10,1200450,202145,88075,88075,0
2021-11-10,1200609,202145,88075,88075,0
2021-11-10,1200708,202145,88075,88075,0
2021-11-10,1200138,202145,88075,88075,0
2021-11-10,1200203,202145,88075,88075,0
2021-11-10,1200807,202145,88075,88075,0
2021-11-10,1200013,202145,88075,88075,0
2021-11-10,1200336,202145,88075,88075,0
2021-11-10,1200054,202145,88075,88075,0
2021-11-10,1200104,202145,88075,88075,0
2021-11-10,1200179,202145,88075,88075,0
2021-11-10,1200252,202145,88075,88075,0
2021-11-10,1200385,202145,88075,88075,0
2021-11-10,1200328,202145,88075,88075,0
2021-11-10,1200344,202145,88075,88075,0
2021-11-10,1200351,202145,88075,88075,0
2021-11-10,1200302,202145,88075,88075,0
2021-11-11,1200336,202145,88075,88075,0
2021-11-11,1200708,202145,88075,88075,0
2021-11-11,1200609,202145,88075,88075,0
2021-11-11,1200450,202145,88075,88075,0
2021-11-11,1200500,202145,88075,88075,0
2021-11-11,1200435,202145,88075,88075,0
2021-11-11,1200427,202145,88075,88075,0
2021-11-11,1200401,202145,88075,88075,0
2021-11-11,1200393,202145,88075,88075,0
2021-11-11,1200385,202145,88075,88075,0
2021-11-11,1200807,202145,88075,88075,0
2021-11-11,1200344,202145,88075,88075,0
2021-11-11,1200013,202145,88075,88075,0
2021-11-11,1200054,202145,88075,88075,0
2021-11-11,1200104,202145,88075,88075,0
2021-11-11,1200138,202145,88075,88075,0
2021-11-11,1200351,202145,88075,88075,0
2021-11-11,1200203,202145,88075,88075,0
2021-11-11,1200252,202145,88075,88075,0
2021-11-11,1200302,202145,88075,88075,0
2021-11-11,1200328,202145,88075,88075,0
2021-11-11,1200179,202145,88075,88075,0
2021-11-12,1200807,202145,88075,88075,0
2021-11-12,1200302,202145,88075,88075,0
2021-11-12,1200609,202145,88075,88075,0
2021-11-12,1200450,202145,88075,88075,0
2021-11-12,1200500,202145,88075,88075,0
2021-11-12,1200435,202145,88075,88075,0
2021-11-12,1200427,202145,88075,88075,0
2021-11-12,1200401,202145,88075,88075,0
2021-11-12,1200393,202145,88075,88075,0
2021-11-12,1200252,202145,88075,88075,0
2021-11-12,1200385,202145,88075,88075,0
2021-11-12,1200351,202145,88075,88075,0
2021-11-12,1200013,202145,88075,88075,0
2021-11-12,1200054,202145,88075,88075,0
2021-11-12,1200104,202145,88075,88075,0
2021-11-12,1200138,202145,88075,88075,0
2021-11-12,1200336,202145,88075,88075,0
2021-11-12,1200203,202145,88075,88075,0
2021-11-12,1200708,202145,88075,88075,0
2021-11-12,1200328,202145,88075,88075,0
2021-11-12,1200344,202145,88075,88075,0
2021-11-12,1200179,202145,88075,88075,0
2021-11-13,1200336,202145,88075,88075,0
2021-11-13,1200013,202145,88075,88075,0
2021-11-13,1200054,202145,88075,88075,0
2021-11-13,1200104,202145,88075,88075,0
2021-11-13,1200138,202145,88075,88075,0
2021-11-13,1200179,202145,88075,88075,0
2021-11-13,1200203,202145,88075,88075,0
2021-11-13,1200252,202145,88075,88075,0
2021-11-13,1200302,202145,88075,88075,0
2021-11-13,1200328,202145,88075,88075,0
2021-11-13,1200344,202145,88075,88075,0
2021-11-13,1200351,202145,88075,88075,0
2021-11-13,1200807,202145,88075,88075,0
2021-11-13,1200401,202145,88075,88075,0
2021-11-13,1200427,202145,88075,88075,0
2021-11-13,1200500,202145,88075,88075,0
2021-11-13,1200450,202145,88075,88075,0
2021-11-13,1200609,202145,88075,88075,0
2021-11-13,1200708,202145,88075,88075,0
2021-11-13,1200393,202145,88075,88075,0
2021-11-13,1200435,202145,88075,88075,0
2021-11-13,1200385,202145,88075,88075,0
2021-11-14,1200807,202146,88075,88075,0
2021-11-14,1200393,202146,88075,88075,0
2021-11-14,1200401,202146,88075,88075,0
2021-11-14,1200708,202146,88075,88075,0
2021-11-14,1200609,202146,88075,88075,0
2021-11-14,1200435,202146,88075,88075,0
2021-11-14,1200500,202146,88075,88075,0
2021-11-14,1200450,202146,88075,88075,0
2021-11-14,1200385,202146,88075,88075,0
2021-11-14,1200427,202146,88075,88075,0
2021-11-14,1200344,202146,88075,88075,0
2021-11-14,1200104,202146,88075,88075,0
2021-11-14,1200138,202146,88075,88075,0
2021-11-14,1200203,202146,88075,88075,0
2021-11-14,1200302,202146,88075,88075,0
2021-11-14,1200252,202146,88075,88075,0
2021-11-14,1200179,202146,88075,88075,0
2021-11-14,1200336,202146,88075,88075,0
2021-11-14,1200054,202146,88075,88075,0
2021-11-14,1200013,202146,88075,88075,0
2021-11-14,1200328,202146,88075,88075,0
2021-11-14,1200351,202146,88075,88075,0
2021-11-15,1200807,202146,88075,88075,0
2021-11-15,1200203,202146,88075,88075,0
2021-11-15,1200708,202146,88075,88075,0
2021-11-15,1200450,202146,88075,88075,0
2021-11-15,1200500,202146,88075,88075,0
2021-11-15,1200435,202146,88075,88075,0
2021-11-15,1200427,202146,88075,88075,0
2021-11-15,1200401,202146,88075,88075,0
2021-11-15,1200393,202146,88075,88075,0
2021-11-15,1200385,202146,88075,88075,0
2021-11-15,1200336,202146,88075,88075,0
2021-11-15,1200013,202146,88075,88075,0
2021-11-15,1200344,202146,88075,88075,0
2021-11-15,1200328,202146,88075,88075,0
2021-11-15,1200302,202146,88075,88075,0
2021-11-15,1200252,202146,88075,88075,0
2021-11-15,1200609,202146,88075,88075,0
2021-11-15,1200179,202146,88075,88075,0
2021-11-15,1200138,202146,88075,88075,0
2021-11-15,1200104,202146,88075,88075,0
2021-11-15,1200054,202146,88075,88075,0
2021-11-15,1200351,202146,88075,88075,0
2021-11-16,1200302,202146,88075,88075,0
2021-11-16,1200252,202146,88075,88075,0
2021-11-16,1200203,202146,88075,88075,0
2021-11-16,1200179,202146,88075,88075,0
2021-11-16,1200328,202146,88075,88075,0
2021-11-16,1200104,202146,88075,88075,0
2021-11-16,1200054,202146,88075,88075,0
2021-11-16,1200013,202146,88075,88075,0
2021-11-16,1200344,202146,88075,88075,0
2021-11-16,1200138,202146,88075,88075,0
2021-11-16,1200385,202146,88075,88075,0
2021-11-16,1200351,202146,88075,88075,0
2021-11-16,1200807,202146,88075,88075,0
2021-11-16,1200393,202146,88075,88075,0
2021-11-16,1200401,202146,88075,88075,0
2021-11-16,1200435,202146,88075,88075,0
2021-11-16,1200500,202146,88075,88075,0
2021-11-16,1200450,202146,88075,88075,0
2021-11-16,1200609,202146,88075,88075,0
2021-11-16,1200708,202146,88075,88075,0
2021-11-16,1200427,202146,88075,88075,0
2021-11-16,1200336,202146,88075,88075,0
2021-11-17,1200807,202146,88075,88075,0
2021-11-17,1200393,202146,88075,88075,0
2021-11-17,1200401,202146,88075,88075,0
2021-11-17,1200427,202146,88075,88075,0
2021-11-17,1200708,202146,88075,88075,0
2021-11-17,1200500,202146,88075,88075,0
2021-11-17,1200450,202146,88075,88075,0
2021-11-17,1200609,202146,88075,88075,0
2021-11-17,1200252,202146,88075,88075,0
2021-11-17,1200435,202146,88075,88075,0
2021-11-17,1200336,202146,88075,88075,0
2021-11-17,1200138,202146,88075,88075,0
2021-11-17,1200351,202146,88075,88075,0
2021-11-17,1200344,202146,88075,88075,0
2021-11-17,1200328,202146,88075,88075,0
2021-11-17,1200302,202146,88075,88075,0
2021-11-17,1200179,202146,88075,88075,0
2021-11-17,1200203,202146,88075,88075,0
2021-11-17,1200104,202146,88075,88075,0
2021-11-17,1200054,202146,88075,88075,0
2021-11-17,1200013,202146,88075,88075,0
2021-11-17,1200385,202146,88075,88075,0
2021-11-18,1200401,202146,88075,88075,0
2021-11-18,1200302,202146,88075,88075,0
2021-11-18,1200328,202146,88075,88075,0
2021-11-18,1200344,202146,88075,88075,0
2021-11-18,1200351,202146,88075,88075,0
2021-11-18,1200385,202146,88075,88075,0
2021-11-18,1200609,202146,88075,88075,0
2021-11-18,1200252,202146,88075,88075,0
2021-11-18,1200393,202146,88075,88075,0
2021-11-18,1200427,202146,88075,88075,0
2021-11-18,1200336,202146,88075,88075,0
2021-11-18,1200500,202146,88075,88075,0
2021-11-18,1200708,202146,88075,88075,0
2021-11-18,1200013,202146,88075,88075,0
2021-11-18,1200054,202146,88075,88075,0
2021-11-18,1200104,202146,88075,88075,0
2021-11-18,1200435,202146,88075,88075,0
2021-11-18,1200179,202146,88075,88075,0
2021-11-18,1200203,202146,88075,88075,0
2021-11-18,1200807,202146,88075,88075,0
2021-11-18,1200450,202146,88075,88075,0
2021-11-18,1200138,202146,88075,88075,0
2021-11-19,1200336,202146,88075,88075,0
2021-11-19,1200609,202146,88075,88075,0
2021-11-19,1200138,202146,88075,88075,0
2021-11-19,1200179,202146,88075,88075,0
2021-11-19,1200203,202146,88075,88075,0
2021-11-19,1200252,202146,88075,88075,0
2021-11-19,1200302,202146,88075,88075,0
2021-11-19,1200328,202146,88075,88075,0
2021-11-19,1200344,202146,88075,88075,0
2021-11-19,1200351,202146,88075,88075,0
2021-11-19,1200385,202146,88075,88075,0
2021-11-19,1200807,202146,88075,88075,0
2021-11-19,1200393,202146,88075,88075,0
2021-11-19,1200013,202146,88075,88075,0
2021-11-19,1200104,202146,88075,88075,0
2021-11-19,1200708,202146,88075,88075,0
2021-11-19,1200450,202146,88075,88075,0
2021-11-19,1200054,202146,88075,88075,0
2021-11-19,1200435,202146,88075,88075,0
2021-11-19,1200427,202146,88075,88075,0
2021-11-19,1200401,202146,88075,88075,0
2021-11-19,1200500,202146,88075,88075,0
2021-11-20,1200344,202146,88075,88075,0
2021-11-20,1200013,202146,88075,88075,0
2021-11-20,1200104,202146,88075,88075,0
2021-11-20,1200138,202146,88075,88075,0
2021-11-20,1200179,202146,88075,88075,0
2021-11-20,1200435,202146,88075,88075,0
2021-11-20,1200252,202146,88075,88075,0
2021-11-20,1200302,202146,88075,88075,0
2021-11-20,1200328,202146,88075,88075,0
2021-11-20,1200351,202146,88075,88075,0
2021-11-20,1200203,202146,88075,88075,0
2021-11-20,1200708,202146,88075,88075,0
2021-11-20,1200609,202146,88075,88075,0
2021-11-20,1200450,202146,88075,88075,0
2021-11-20,1200500,202146,88075,88075,0
2021-11-20,1200385,202146,88075,88075,0
2021-11-20,1200427,202146,88075,88075,0
2021-11-20,1200401,202146,88075,88075,0
2021-11-20,1200054,202146,88075,88075,0
2021-11-20,1200393,202146,88075,88075,0
2021-11-20,1200807,202146,88075,88075,0
2021-11-20,1200336,202146,88075,88075,0
2021-11-21,1200252,202147,88075,88075,0
2021-11-21,1200203,202147,88075,88075,0
2021-11-21,1200179,202147,88075,88075,0
2021-11-21,1200013,202147,88075,88075,0
2021-11-21,1200054,202147,88075,88075,0
2021-11-21,1200450,202147,88075,88075,0
2021-11-21,1200609,202147,88075,88075,0
2021-11-21,1200302,202147,88075,88075,0
2021-11-21,1200104,202147,88075,88075,0
2021-11-21,1200328,202147,88075,88075,0
2021-11-21,1200138,202147,88075,88075,0
2021-11-21,1200351,202147,88075,88075,0
2021-11-21,1200336,202147,88075,88075,0
2021-11-21,1200385,202147,88075,88075,0
2021-11-21,1200807,202147,88075,88075,0
2021-11-21,1200393,202147,88075,88075,0
2021-11-21,1200401,202147,88075,88075,0
2021-11-21,1200427,202147,88075,88075,0
2021-11-21,1200500,202147,88075,88075,0
2021-11-21,1200708,202147,88075,88075,0
2021-11-21,1200435,202147,88075,88075,0
2021-11-21,1200344,202147,88075,88075,0
2021-11-22,1200328,202147,88075,88075,0
2021-11-22,1200302,202147,88075,88075,0
2021-11-22,1200252,202147,88075,88075,0
2021-11-22,1200054,202147,88075,88075,0
2021-11-22,1200179,202147,88075,88075,0
2021-11-22,1200138,202147,88075,88075,0
2021-11-22,1200104,202147,88075,88075,0
2021-11-22,1200344,202147,88075,88075,0
2021-11-22,1200203,202147,88075,88075,0
2021-11-22,1200351,202147,88075,88075,0
2021-11-22,1200435,202147,88075,88075,0
2021-11-22,1200609,202147,88075,88075,0
2021-11-22,1200450,202147,88075,88075,0
2021-11-22,1200500,202147,88075,88075,0
2021-11-22,1200427,202147,88075,88075,0
2021-11-22,1200401,202147,88075,88075,0
2021-11-22,1200393,202147,88075,88075,0
2021-11-22,1200807,202147,88075,88075,0
2021-11-22,1200336,202147,88075,88075,0
2021-11-22,1200013,202147,88075,88075,0
2021-11-22,1200708,202147,88075,88075,0
2021-11-22,1200385,202147,88075,88075,0
